transaction_id,date,Transaction_Type,transaction_desc,credit_amt,debit_amt,Balance
ba225880-1776-4412-a62b-0a9b1bb4c497-20230101-1,2023-01-01,credit,Salary,4160,0,28131
ba225880-1776-4412-a62b-0a9b1bb4c497-20230101-2,2023-01-01,debit,Amenities,0,624,27507
ba225880-1776-4412-a62b-0a9b1bb4c497-20230101-3,2023-01-01,debit,Late Fee,0,914,26593
ba225880-1776-4412-a62b-0a9b1bb4c497-20230102-4,2023-01-02,debit,Amenities,0,624,25969
ba225880-1776-4412-a62b-0a9b1bb4c497-20230102-5,2023-01-02,debit,Late Fee,0,587,25382
ba225880-1776-4412-a62b-0a9b1bb4c497-20230103-6,2023-01-03,debit,Amenities,0,624,24758
ba225880-1776-4412-a62b-0a9b1bb4c497-20230103-7,2023-01-03,debit,Late Fee,0,862,23896
ba225880-1776-4412-a62b-0a9b1bb4c497-20230104-8,2023-01-04,debit,Amenities,0,624,23272
ba225880-1776-4412-a62b-0a9b1bb4c497-20230104-9,2023-01-04,debit,Late Fee,0,340,22932
ba225880-1776-4412-a62b-0a9b1bb4c497-20230105-10,2023-01-05,debit,Amenities,0,624,22308
ba225880-1776-4412-a62b-0a9b1bb4c497-20230105-11,2023-01-05,debit,Late Fee,0,889,21419
ba225880-1776-4412-a62b-0a9b1bb4c497-20230106-12,2023-01-06,debit,Amenities,0,624,20795
ba225880-1776-4412-a62b-0a9b1bb4c497-20230106-13,2023-01-06,debit,Late Fee,0,409,20386
ba225880-1776-4412-a62b-0a9b1bb4c497-20230107-14,2023-01-07,debit,Amenities,0,624,19762
ba225880-1776-4412-a62b-0a9b1bb4c497-20230107-15,2023-01-07,debit,Late Fee,0,639,19123
ba225880-1776-4412-a62b-0a9b1bb4c497-20230108-16,2023-01-08,debit,Amenities,0,624,18499
ba225880-1776-4412-a62b-0a9b1bb4c497-20230108-17,2023-01-08,debit,Late Fee,0,655,17844
ba225880-1776-4412-a62b-0a9b1bb4c497-20230109-18,2023-01-09,debit,Amenities,0,624,17220
ba225880-1776-4412-a62b-0a9b1bb4c497-20230109-19,2023-01-09,debit,Late Fee,0,556,16664
ba225880-1776-4412-a62b-0a9b1bb4c497-20230110-20,2023-01-10,debit,Amenities,0,624,16040
ba225880-1776-4412-a62b-0a9b1bb4c497-20230110-21,2023-01-10,debit,Late Fee,0,888,15152
ba225880-1776-4412-a62b-0a9b1bb4c497-20230111-22,2023-01-11,debit,Amenities,0,624,14528
ba225880-1776-4412-a62b-0a9b1bb4c497-20230111-23,2023-01-11,debit,Late Fee,0,669,13859
ba225880-1776-4412-a62b-0a9b1bb4c497-20230112-24,2023-01-12,debit,Amenities,0,624,13235
ba225880-1776-4412-a62b-0a9b1bb4c497-20230112-25,2023-01-12,debit,Late Fee,0,670,12565
ba225880-1776-4412-a62b-0a9b1bb4c497-20230113-26,2023-01-13,debit,Amenities,0,624,11941
ba225880-1776-4412-a62b-0a9b1bb4c497-20230113-27,2023-01-13,debit,Late Fee,0,780,11161
ba225880-1776-4412-a62b-0a9b1bb4c497-20230114-28,2023-01-14,debit,Amenities,0,624,10537
ba225880-1776-4412-a62b-0a9b1bb4c497-20230114-29,2023-01-14,debit,Late Fee,0,634,9903
ba225880-1776-4412-a62b-0a9b1bb4c497-20230115-30,2023-01-15,debit,Amenities,0,624,9279
ba225880-1776-4412-a62b-0a9b1bb4c497-20230115-31,2023-01-15,debit,Late Fee,0,320,8959
ba225880-1776-4412-a62b-0a9b1bb4c497-20230116-32,2023-01-16,debit,Amenities,0,624,8335
ba225880-1776-4412-a62b-0a9b1bb4c497-20230116-33,2023-01-16,debit,Late Fee,0,864,7471
ba225880-1776-4412-a62b-0a9b1bb4c497-20230117-34,2023-01-17,debit,Amenities,0,624,6847
ba225880-1776-4412-a62b-0a9b1bb4c497-20230117-35,2023-01-17,debit,Late Fee,0,938,5909
ba225880-1776-4412-a62b-0a9b1bb4c497-20230118-36,2023-01-18,debit,Amenities,0,624,5285
ba225880-1776-4412-a62b-0a9b1bb4c497-20230118-37,2023-01-18,debit,Late Fee,0,646,4639
ba225880-1776-4412-a62b-0a9b1bb4c497-20230119-38,2023-01-19,debit,Amenities,0,624,4015
ba225880-1776-4412-a62b-0a9b1bb4c497-20230119-39,2023-01-19,debit,Late Fee,0,436,3579
ba225880-1776-4412-a62b-0a9b1bb4c497-20230120-40,2023-01-20,debit,Amenities,0,624,2955
ba225880-1776-4412-a62b-0a9b1bb4c497-20230120-41,2023-01-20,debit,Late Fee,0,925,2030
ba225880-1776-4412-a62b-0a9b1bb4c497-20230121-42,2023-01-21,debit,Groceries,0,1248,782
ba225880-1776-4412-a62b-0a9b1bb4c497-20230121-43,2023-01-21,debit,Amenities,0,624,158
ba225880-1776-4412-a62b-0a9b1bb4c497-20230121-44,2023-01-21,debit,Late Fee,0,744,-586
ba225880-1776-4412-a62b-0a9b1bb4c497-20230122-45,2023-01-22,debit,Amenities,0,624,-1210
ba225880-1776-4412-a62b-0a9b1bb4c497-20230122-46,2023-01-22,debit,Late Fee,0,755,-1965
ba225880-1776-4412-a62b-0a9b1bb4c497-20230123-47,2023-01-23,debit,Amenities,0,624,-2589
ba225880-1776-4412-a62b-0a9b1bb4c497-20230123-48,2023-01-23,debit,Late Fee,0,581,-3170
ba225880-1776-4412-a62b-0a9b1bb4c497-20230124-49,2023-01-24,debit,Amenities,0,624,-3794
ba225880-1776-4412-a62b-0a9b1bb4c497-20230124-50,2023-01-24,debit,Late Fee,0,397,-4191
ba225880-1776-4412-a62b-0a9b1bb4c497-20230125-51,2023-01-25,debit,Amenities,0,624,-4815
ba225880-1776-4412-a62b-0a9b1bb4c497-20230125-52,2023-01-25,debit,Late Fee,0,583,-5398
ba225880-1776-4412-a62b-0a9b1bb4c497-20230126-53,2023-01-26,debit,Amenities,0,624,-6022
ba225880-1776-4412-a62b-0a9b1bb4c497-20230126-54,2023-01-26,debit,Late Fee,0,363,-6385
ba225880-1776-4412-a62b-0a9b1bb4c497-20230127-55,2023-01-27,debit,Amenities,0,624,-7009
ba225880-1776-4412-a62b-0a9b1bb4c497-20230127-56,2023-01-27,debit,Late Fee,0,700,-7709
ba225880-1776-4412-a62b-0a9b1bb4c497-20230128-57,2023-01-28,debit,Amenities,0,624,-8333
ba225880-1776-4412-a62b-0a9b1bb4c497-20230128-58,2023-01-28,debit,Late Fee,0,652,-8985
ba225880-1776-4412-a62b-0a9b1bb4c497-20230129-59,2023-01-29,debit,Amenities,0,624,-9609
ba225880-1776-4412-a62b-0a9b1bb4c497-20230129-60,2023-01-29,debit,Late Fee,0,681,-10290
ba225880-1776-4412-a62b-0a9b1bb4c497-20230130-61,2023-01-30,debit,Amenities,0,624,-10914
ba225880-1776-4412-a62b-0a9b1bb4c497-20230130-62,2023-01-30,debit,Late Fee,0,461,-11375
ba225880-1776-4412-a62b-0a9b1bb4c497-20230131-63,2023-01-31,debit,Amenities,0,624,-11999
ba225880-1776-4412-a62b-0a9b1bb4c497-20230131-64,2023-01-31,debit,Late Fee,0,615,-12614
ba225880-1776-4412-a62b-0a9b1bb4c497-20230201-65,2023-02-01,credit,Salary,4160,0,-8454
ba225880-1776-4412-a62b-0a9b1bb4c497-20230201-66,2023-02-01,debit,Amenities,0,624,-9078
ba225880-1776-4412-a62b-0a9b1bb4c497-20230201-67,2023-02-01,debit,Late Fee,0,797,-9875
ba225880-1776-4412-a62b-0a9b1bb4c497-20230202-68,2023-02-02,debit,Amenities,0,624,-10499
ba225880-1776-4412-a62b-0a9b1bb4c497-20230202-69,2023-02-02,debit,Late Fee,0,903,-11402
ba225880-1776-4412-a62b-0a9b1bb4c497-20230203-70,2023-02-03,debit,Amenities,0,624,-12026
ba225880-1776-4412-a62b-0a9b1bb4c497-20230203-71,2023-02-03,debit,Late Fee,0,417,-12443
ba225880-1776-4412-a62b-0a9b1bb4c497-20230204-72,2023-02-04,debit,Amenities,0,624,-13067
ba225880-1776-4412-a62b-0a9b1bb4c497-20230204-73,2023-02-04,debit,Late Fee,0,670,-13737
ba225880-1776-4412-a62b-0a9b1bb4c497-20230205-74,2023-02-05,debit,Amenities,0,624,-14361
ba225880-1776-4412-a62b-0a9b1bb4c497-20230205-75,2023-02-05,debit,Late Fee,0,828,-15189
ba225880-1776-4412-a62b-0a9b1bb4c497-20230206-76,2023-02-06,debit,Amenities,0,624,-15813
ba225880-1776-4412-a62b-0a9b1bb4c497-20230206-77,2023-02-06,debit,Late Fee,0,669,-16482
ba225880-1776-4412-a62b-0a9b1bb4c497-20230207-78,2023-02-07,debit,Amenities,0,624,-17106
ba225880-1776-4412-a62b-0a9b1bb4c497-20230207-79,2023-02-07,debit,Late Fee,0,690,-17796
ba225880-1776-4412-a62b-0a9b1bb4c497-20230208-80,2023-02-08,debit,Amenities,0,624,-18420
ba225880-1776-4412-a62b-0a9b1bb4c497-20230208-81,2023-02-08,debit,Late Fee,0,359,-18779
ba225880-1776-4412-a62b-0a9b1bb4c497-20230209-82,2023-02-09,debit,Amenities,0,624,-19403
ba225880-1776-4412-a62b-0a9b1bb4c497-20230209-83,2023-02-09,debit,Late Fee,0,876,-20279
ba225880-1776-4412-a62b-0a9b1bb4c497-20230210-84,2023-02-10,debit,Amenities,0,624,-20903
ba225880-1776-4412-a62b-0a9b1bb4c497-20230210-85,2023-02-10,debit,Late Fee,0,455,-21358
ba225880-1776-4412-a62b-0a9b1bb4c497-20230211-86,2023-02-11,debit,Amenities,0,624,-21982
ba225880-1776-4412-a62b-0a9b1bb4c497-20230211-87,2023-02-11,debit,Late Fee,0,474,-22456
ba225880-1776-4412-a62b-0a9b1bb4c497-20230212-88,2023-02-12,debit,Amenities,0,624,-23080
ba225880-1776-4412-a62b-0a9b1bb4c497-20230212-89,2023-02-12,debit,Late Fee,0,714,-23794
ba225880-1776-4412-a62b-0a9b1bb4c497-20230213-90,2023-02-13,debit,Amenities,0,624,-24418
ba225880-1776-4412-a62b-0a9b1bb4c497-20230213-91,2023-02-13,debit,Late Fee,0,902,-25320
ba225880-1776-4412-a62b-0a9b1bb4c497-20230214-92,2023-02-14,debit,Amenities,0,624,-25944
ba225880-1776-4412-a62b-0a9b1bb4c497-20230214-93,2023-02-14,debit,Late Fee,0,388,-26332
ba225880-1776-4412-a62b-0a9b1bb4c497-20230215-94,2023-02-15,debit,Amenities,0,624,-26956
ba225880-1776-4412-a62b-0a9b1bb4c497-20230215-95,2023-02-15,debit,Late Fee,0,773,-27729
ba225880-1776-4412-a62b-0a9b1bb4c497-20230216-96,2023-02-16,debit,Amenities,0,624,-28353
ba225880-1776-4412-a62b-0a9b1bb4c497-20230216-97,2023-02-16,debit,Late Fee,0,724,-29077
ba225880-1776-4412-a62b-0a9b1bb4c497-20230217-98,2023-02-17,debit,Amenities,0,624,-29701
ba225880-1776-4412-a62b-0a9b1bb4c497-20230217-99,2023-02-17,debit,Late Fee,0,731,-30432
ba225880-1776-4412-a62b-0a9b1bb4c497-20230218-100,2023-02-18,debit,Amenities,0,624,-31056
ba225880-1776-4412-a62b-0a9b1bb4c497-20230218-101,2023-02-18,debit,Late Fee,0,684,-31740
ba225880-1776-4412-a62b-0a9b1bb4c497-20230219-102,2023-02-19,debit,Amenities,0,624,-32364
ba225880-1776-4412-a62b-0a9b1bb4c497-20230219-103,2023-02-19,debit,Late Fee,0,802,-33166
ba225880-1776-4412-a62b-0a9b1bb4c497-20230220-104,2023-02-20,debit,Amenities,0,624,-33790
ba225880-1776-4412-a62b-0a9b1bb4c497-20230220-105,2023-02-20,debit,Late Fee,0,747,-34537
ba225880-1776-4412-a62b-0a9b1bb4c497-20230221-106,2023-02-21,debit,Groceries,0,1248,-35785
ba225880-1776-4412-a62b-0a9b1bb4c497-20230221-107,2023-02-21,debit,Amenities,0,624,-36409
ba225880-1776-4412-a62b-0a9b1bb4c497-20230221-108,2023-02-21,debit,Late Fee,0,980,-37389
ba225880-1776-4412-a62b-0a9b1bb4c497-20230222-109,2023-02-22,debit,Amenities,0,624,-38013
ba225880-1776-4412-a62b-0a9b1bb4c497-20230222-110,2023-02-22,debit,Late Fee,0,981,-38994
ba225880-1776-4412-a62b-0a9b1bb4c497-20230223-111,2023-02-23,debit,Amenities,0,624,-39618
ba225880-1776-4412-a62b-0a9b1bb4c497-20230223-112,2023-02-23,debit,Late Fee,0,517,-40135
ba225880-1776-4412-a62b-0a9b1bb4c497-20230224-113,2023-02-24,debit,Amenities,0,624,-40759
ba225880-1776-4412-a62b-0a9b1bb4c497-20230224-114,2023-02-24,debit,Late Fee,0,952,-41711
ba225880-1776-4412-a62b-0a9b1bb4c497-20230225-115,2023-02-25,debit,Amenities,0,624,-42335
ba225880-1776-4412-a62b-0a9b1bb4c497-20230225-116,2023-02-25,debit,Late Fee,0,300,-42635
ba225880-1776-4412-a62b-0a9b1bb4c497-20230226-117,2023-02-26,debit,Amenities,0,624,-43259
ba225880-1776-4412-a62b-0a9b1bb4c497-20230226-118,2023-02-26,debit,Late Fee,0,863,-44122
ba225880-1776-4412-a62b-0a9b1bb4c497-20230227-119,2023-02-27,debit,Amenities,0,624,-44746
ba225880-1776-4412-a62b-0a9b1bb4c497-20230227-120,2023-02-27,debit,Late Fee,0,941,-45687
ba225880-1776-4412-a62b-0a9b1bb4c497-20230228-121,2023-02-28,debit,Amenities,0,624,-46311
ba225880-1776-4412-a62b-0a9b1bb4c497-20230228-122,2023-02-28,debit,Late Fee,0,919,-47230
ba225880-1776-4412-a62b-0a9b1bb4c497-20230301-123,2023-03-01,credit,Salary,4160,0,-43070
ba225880-1776-4412-a62b-0a9b1bb4c497-20230301-124,2023-03-01,debit,Amenities,0,624,-43694
ba225880-1776-4412-a62b-0a9b1bb4c497-20230301-125,2023-03-01,debit,Late Fee,0,897,-44591
ba225880-1776-4412-a62b-0a9b1bb4c497-20230302-126,2023-03-02,debit,Amenities,0,624,-45215
ba225880-1776-4412-a62b-0a9b1bb4c497-20230302-127,2023-03-02,debit,Late Fee,0,431,-45646
ba225880-1776-4412-a62b-0a9b1bb4c497-20230303-128,2023-03-03,debit,Amenities,0,624,-46270
ba225880-1776-4412-a62b-0a9b1bb4c497-20230303-129,2023-03-03,debit,Late Fee,0,790,-47060
ba225880-1776-4412-a62b-0a9b1bb4c497-20230304-130,2023-03-04,debit,Amenities,0,624,-47684
ba225880-1776-4412-a62b-0a9b1bb4c497-20230304-131,2023-03-04,debit,Late Fee,0,919,-48603
ba225880-1776-4412-a62b-0a9b1bb4c497-20230305-132,2023-03-05,debit,Amenities,0,624,-49227
ba225880-1776-4412-a62b-0a9b1bb4c497-20230305-133,2023-03-05,debit,Late Fee,0,713,-49940
ba225880-1776-4412-a62b-0a9b1bb4c497-20230306-134,2023-03-06,debit,Amenities,0,624,-50564
ba225880-1776-4412-a62b-0a9b1bb4c497-20230306-135,2023-03-06,debit,Late Fee,0,730,-51294
ba225880-1776-4412-a62b-0a9b1bb4c497-20230307-136,2023-03-07,debit,Amenities,0,624,-51918
ba225880-1776-4412-a62b-0a9b1bb4c497-20230307-137,2023-03-07,debit,Late Fee,0,600,-52518
ba225880-1776-4412-a62b-0a9b1bb4c497-20230308-138,2023-03-08,debit,Amenities,0,624,-53142
ba225880-1776-4412-a62b-0a9b1bb4c497-20230308-139,2023-03-08,debit,Late Fee,0,563,-53705
ba225880-1776-4412-a62b-0a9b1bb4c497-20230309-140,2023-03-09,debit,Amenities,0,624,-54329
ba225880-1776-4412-a62b-0a9b1bb4c497-20230309-141,2023-03-09,debit,Late Fee,0,455,-54784
ba225880-1776-4412-a62b-0a9b1bb4c497-20230310-142,2023-03-10,debit,Amenities,0,624,-55408
ba225880-1776-4412-a62b-0a9b1bb4c497-20230310-143,2023-03-10,debit,Late Fee,0,406,-55814
ba225880-1776-4412-a62b-0a9b1bb4c497-20230311-144,2023-03-11,debit,Amenities,0,624,-56438
ba225880-1776-4412-a62b-0a9b1bb4c497-20230311-145,2023-03-11,debit,Late Fee,0,476,-56914
ba225880-1776-4412-a62b-0a9b1bb4c497-20230312-146,2023-03-12,debit,Amenities,0,624,-57538
ba225880-1776-4412-a62b-0a9b1bb4c497-20230312-147,2023-03-12,debit,Late Fee,0,589,-58127
ba225880-1776-4412-a62b-0a9b1bb4c497-20230313-148,2023-03-13,debit,Amenities,0,624,-58751
ba225880-1776-4412-a62b-0a9b1bb4c497-20230313-149,2023-03-13,debit,Late Fee,0,786,-59537
ba225880-1776-4412-a62b-0a9b1bb4c497-20230314-150,2023-03-14,debit,Amenities,0,624,-60161
ba225880-1776-4412-a62b-0a9b1bb4c497-20230314-151,2023-03-14,debit,Late Fee,0,636,-60797
ba225880-1776-4412-a62b-0a9b1bb4c497-20230315-152,2023-03-15,debit,Amenities,0,624,-61421
ba225880-1776-4412-a62b-0a9b1bb4c497-20230315-153,2023-03-15,debit,Late Fee,0,919,-62340
ba225880-1776-4412-a62b-0a9b1bb4c497-20230316-154,2023-03-16,debit,Amenities,0,624,-62964
ba225880-1776-4412-a62b-0a9b1bb4c497-20230316-155,2023-03-16,debit,Late Fee,0,537,-63501
ba225880-1776-4412-a62b-0a9b1bb4c497-20230317-156,2023-03-17,debit,Amenities,0,624,-64125
ba225880-1776-4412-a62b-0a9b1bb4c497-20230317-157,2023-03-17,debit,Late Fee,0,483,-64608
ba225880-1776-4412-a62b-0a9b1bb4c497-20230318-158,2023-03-18,debit,Amenities,0,624,-65232
ba225880-1776-4412-a62b-0a9b1bb4c497-20230318-159,2023-03-18,debit,Late Fee,0,904,-66136
ba225880-1776-4412-a62b-0a9b1bb4c497-20230319-160,2023-03-19,debit,Amenities,0,624,-66760
ba225880-1776-4412-a62b-0a9b1bb4c497-20230319-161,2023-03-19,debit,Late Fee,0,487,-67247
ba225880-1776-4412-a62b-0a9b1bb4c497-20230320-162,2023-03-20,debit,Amenities,0,624,-67871
ba225880-1776-4412-a62b-0a9b1bb4c497-20230320-163,2023-03-20,debit,Late Fee,0,439,-68310
ba225880-1776-4412-a62b-0a9b1bb4c497-20230321-164,2023-03-21,debit,Groceries,0,1248,-69558
ba225880-1776-4412-a62b-0a9b1bb4c497-20230321-165,2023-03-21,debit,Amenities,0,624,-70182
ba225880-1776-4412-a62b-0a9b1bb4c497-20230321-166,2023-03-21,debit,Late Fee,0,643,-70825
ba225880-1776-4412-a62b-0a9b1bb4c497-20230322-167,2023-03-22,debit,Amenities,0,624,-71449
ba225880-1776-4412-a62b-0a9b1bb4c497-20230322-168,2023-03-22,debit,Late Fee,0,352,-71801
ba225880-1776-4412-a62b-0a9b1bb4c497-20230323-169,2023-03-23,debit,Amenities,0,624,-72425
ba225880-1776-4412-a62b-0a9b1bb4c497-20230323-170,2023-03-23,debit,Late Fee,0,788,-73213
ba225880-1776-4412-a62b-0a9b1bb4c497-20230324-171,2023-03-24,debit,Amenities,0,624,-73837
ba225880-1776-4412-a62b-0a9b1bb4c497-20230324-172,2023-03-24,debit,Late Fee,0,682,-74519
ba225880-1776-4412-a62b-0a9b1bb4c497-20230325-173,2023-03-25,debit,Amenities,0,624,-75143
ba225880-1776-4412-a62b-0a9b1bb4c497-20230325-174,2023-03-25,debit,Late Fee,0,996,-76139
ba225880-1776-4412-a62b-0a9b1bb4c497-20230326-175,2023-03-26,debit,Amenities,0,624,-76763
ba225880-1776-4412-a62b-0a9b1bb4c497-20230326-176,2023-03-26,debit,Late Fee,0,660,-77423
ba225880-1776-4412-a62b-0a9b1bb4c497-20230327-177,2023-03-27,debit,Amenities,0,624,-78047
ba225880-1776-4412-a62b-0a9b1bb4c497-20230327-178,2023-03-27,debit,Late Fee,0,714,-78761
ba225880-1776-4412-a62b-0a9b1bb4c497-20230328-179,2023-03-28,debit,Amenities,0,624,-79385
ba225880-1776-4412-a62b-0a9b1bb4c497-20230328-180,2023-03-28,debit,Late Fee,0,943,-80328
ba225880-1776-4412-a62b-0a9b1bb4c497-20230329-181,2023-03-29,debit,Amenities,0,624,-80952
ba225880-1776-4412-a62b-0a9b1bb4c497-20230329-182,2023-03-29,debit,Late Fee,0,678,-81630
ba225880-1776-4412-a62b-0a9b1bb4c497-20230330-183,2023-03-30,debit,Amenities,0,624,-82254
ba225880-1776-4412-a62b-0a9b1bb4c497-20230330-184,2023-03-30,debit,Late Fee,0,859,-83113
ba225880-1776-4412-a62b-0a9b1bb4c497-20230331-185,2023-03-31,debit,Amenities,0,624,-83737
ba225880-1776-4412-a62b-0a9b1bb4c497-20230331-186,2023-03-31,debit,Late Fee,0,475,-84212
ba225880-1776-4412-a62b-0a9b1bb4c497-20230401-187,2023-04-01,credit,Salary,4160,0,-80052
ba225880-1776-4412-a62b-0a9b1bb4c497-20230401-188,2023-04-01,debit,Amenities,0,624,-80676
ba225880-1776-4412-a62b-0a9b1bb4c497-20230401-189,2023-04-01,debit,Late Fee,0,420,-81096
ba225880-1776-4412-a62b-0a9b1bb4c497-20230402-190,2023-04-02,debit,Amenities,0,624,-81720
ba225880-1776-4412-a62b-0a9b1bb4c497-20230402-191,2023-04-02,debit,Late Fee,0,420,-82140
ba225880-1776-4412-a62b-0a9b1bb4c497-20230403-192,2023-04-03,debit,Amenities,0,624,-82764
ba225880-1776-4412-a62b-0a9b1bb4c497-20230403-193,2023-04-03,debit,Late Fee,0,966,-83730
ba225880-1776-4412-a62b-0a9b1bb4c497-20230404-194,2023-04-04,debit,Amenities,0,624,-84354
ba225880-1776-4412-a62b-0a9b1bb4c497-20230404-195,2023-04-04,debit,Late Fee,0,857,-85211
ba225880-1776-4412-a62b-0a9b1bb4c497-20230405-196,2023-04-05,debit,Amenities,0,624,-85835
ba225880-1776-4412-a62b-0a9b1bb4c497-20230405-197,2023-04-05,debit,Late Fee,0,934,-86769
ba225880-1776-4412-a62b-0a9b1bb4c497-20230406-198,2023-04-06,debit,Amenities,0,624,-87393
ba225880-1776-4412-a62b-0a9b1bb4c497-20230406-199,2023-04-06,debit,Late Fee,0,364,-87757
ba225880-1776-4412-a62b-0a9b1bb4c497-20230407-200,2023-04-07,debit,Amenities,0,624,-88381
ba225880-1776-4412-a62b-0a9b1bb4c497-20230407-201,2023-04-07,debit,Late Fee,0,367,-88748
ba225880-1776-4412-a62b-0a9b1bb4c497-20230408-202,2023-04-08,debit,Amenities,0,624,-89372
ba225880-1776-4412-a62b-0a9b1bb4c497-20230408-203,2023-04-08,debit,Late Fee,0,418,-89790
ba225880-1776-4412-a62b-0a9b1bb4c497-20230409-204,2023-04-09,debit,Amenities,0,624,-90414
ba225880-1776-4412-a62b-0a9b1bb4c497-20230409-205,2023-04-09,debit,Late Fee,0,982,-91396
ba225880-1776-4412-a62b-0a9b1bb4c497-20230410-206,2023-04-10,debit,Amenities,0,624,-92020
ba225880-1776-4412-a62b-0a9b1bb4c497-20230410-207,2023-04-10,debit,Late Fee,0,416,-92436
ba225880-1776-4412-a62b-0a9b1bb4c497-20230411-208,2023-04-11,debit,Amenities,0,624,-93060
ba225880-1776-4412-a62b-0a9b1bb4c497-20230411-209,2023-04-11,debit,Late Fee,0,892,-93952
ba225880-1776-4412-a62b-0a9b1bb4c497-20230412-210,2023-04-12,debit,Amenities,0,624,-94576
ba225880-1776-4412-a62b-0a9b1bb4c497-20230412-211,2023-04-12,debit,Late Fee,0,976,-95552
ba225880-1776-4412-a62b-0a9b1bb4c497-20230413-212,2023-04-13,debit,Amenities,0,624,-96176
ba225880-1776-4412-a62b-0a9b1bb4c497-20230413-213,2023-04-13,debit,Late Fee,0,756,-96932
ba225880-1776-4412-a62b-0a9b1bb4c497-20230414-214,2023-04-14,debit,Amenities,0,624,-97556
ba225880-1776-4412-a62b-0a9b1bb4c497-20230414-215,2023-04-14,debit,Late Fee,0,661,-98217
ba225880-1776-4412-a62b-0a9b1bb4c497-20230415-216,2023-04-15,debit,Amenities,0,624,-98841
ba225880-1776-4412-a62b-0a9b1bb4c497-20230415-217,2023-04-15,debit,Late Fee,0,385,-99226
ba225880-1776-4412-a62b-0a9b1bb4c497-20230416-218,2023-04-16,debit,Amenities,0,624,-99850
ba225880-1776-4412-a62b-0a9b1bb4c497-20230416-219,2023-04-16,debit,Late Fee,0,916,-100766
ba225880-1776-4412-a62b-0a9b1bb4c497-20230417-220,2023-04-17,debit,Amenities,0,624,-101390
ba225880-1776-4412-a62b-0a9b1bb4c497-20230417-221,2023-04-17,debit,Late Fee,0,775,-102165
ba225880-1776-4412-a62b-0a9b1bb4c497-20230418-222,2023-04-18,debit,Amenities,0,624,-102789
ba225880-1776-4412-a62b-0a9b1bb4c497-20230418-223,2023-04-18,debit,Late Fee,0,583,-103372
ba225880-1776-4412-a62b-0a9b1bb4c497-20230419-224,2023-04-19,debit,Amenities,0,624,-103996
ba225880-1776-4412-a62b-0a9b1bb4c497-20230419-225,2023-04-19,debit,Late Fee,0,344,-104340
ba225880-1776-4412-a62b-0a9b1bb4c497-20230420-226,2023-04-20,debit,Amenities,0,624,-104964
ba225880-1776-4412-a62b-0a9b1bb4c497-20230420-227,2023-04-20,debit,Late Fee,0,728,-105692
ba225880-1776-4412-a62b-0a9b1bb4c497-20230421-228,2023-04-21,debit,Groceries,0,1248,-106940
ba225880-1776-4412-a62b-0a9b1bb4c497-20230421-229,2023-04-21,debit,Amenities,0,624,-107564
ba225880-1776-4412-a62b-0a9b1bb4c497-20230421-230,2023-04-21,debit,Late Fee,0,920,-108484
ba225880-1776-4412-a62b-0a9b1bb4c497-20230422-231,2023-04-22,debit,Amenities,0,624,-109108
ba225880-1776-4412-a62b-0a9b1bb4c497-20230422-232,2023-04-22,debit,Late Fee,0,798,-109906
ba225880-1776-4412-a62b-0a9b1bb4c497-20230423-233,2023-04-23,debit,Amenities,0,624,-110530
ba225880-1776-4412-a62b-0a9b1bb4c497-20230423-234,2023-04-23,debit,Late Fee,0,678,-111208
ba225880-1776-4412-a62b-0a9b1bb4c497-20230424-235,2023-04-24,debit,Amenities,0,624,-111832
ba225880-1776-4412-a62b-0a9b1bb4c497-20230424-236,2023-04-24,debit,Late Fee,0,706,-112538
ba225880-1776-4412-a62b-0a9b1bb4c497-20230425-237,2023-04-25,debit,Amenities,0,624,-113162
ba225880-1776-4412-a62b-0a9b1bb4c497-20230425-238,2023-04-25,debit,Late Fee,0,315,-113477
ba225880-1776-4412-a62b-0a9b1bb4c497-20230426-239,2023-04-26,debit,Amenities,0,624,-114101
ba225880-1776-4412-a62b-0a9b1bb4c497-20230426-240,2023-04-26,debit,Late Fee,0,753,-114854
ba225880-1776-4412-a62b-0a9b1bb4c497-20230427-241,2023-04-27,debit,Amenities,0,624,-115478
ba225880-1776-4412-a62b-0a9b1bb4c497-20230427-242,2023-04-27,debit,Late Fee,0,868,-116346
ba225880-1776-4412-a62b-0a9b1bb4c497-20230428-243,2023-04-28,debit,Amenities,0,624,-116970
ba225880-1776-4412-a62b-0a9b1bb4c497-20230428-244,2023-04-28,debit,Late Fee,0,940,-117910
ba225880-1776-4412-a62b-0a9b1bb4c497-20230429-245,2023-04-29,debit,Amenities,0,624,-118534
ba225880-1776-4412-a62b-0a9b1bb4c497-20230429-246,2023-04-29,debit,Late Fee,0,790,-119324
ba225880-1776-4412-a62b-0a9b1bb4c497-20230430-247,2023-04-30,debit,Amenities,0,624,-119948
ba225880-1776-4412-a62b-0a9b1bb4c497-20230430-248,2023-04-30,debit,Late Fee,0,548,-120496
ba225880-1776-4412-a62b-0a9b1bb4c497-20230501-249,2023-05-01,credit,Salary,4160,0,-116336
ba225880-1776-4412-a62b-0a9b1bb4c497-20230501-250,2023-05-01,debit,Amenities,0,624,-116960
ba225880-1776-4412-a62b-0a9b1bb4c497-20230501-251,2023-05-01,debit,Late Fee,0,470,-117430
ba225880-1776-4412-a62b-0a9b1bb4c497-20230502-252,2023-05-02,debit,Amenities,0,624,-118054
ba225880-1776-4412-a62b-0a9b1bb4c497-20230502-253,2023-05-02,debit,Late Fee,0,614,-118668
ba225880-1776-4412-a62b-0a9b1bb4c497-20230503-254,2023-05-03,debit,Amenities,0,624,-119292
ba225880-1776-4412-a62b-0a9b1bb4c497-20230503-255,2023-05-03,debit,Late Fee,0,801,-120093
ba225880-1776-4412-a62b-0a9b1bb4c497-20230504-256,2023-05-04,debit,Amenities,0,624,-120717
ba225880-1776-4412-a62b-0a9b1bb4c497-20230504-257,2023-05-04,debit,Late Fee,0,940,-121657
ba225880-1776-4412-a62b-0a9b1bb4c497-20230505-258,2023-05-05,debit,Amenities,0,624,-122281
ba225880-1776-4412-a62b-0a9b1bb4c497-20230505-259,2023-05-05,debit,Late Fee,0,971,-123252
ba225880-1776-4412-a62b-0a9b1bb4c497-20230506-260,2023-05-06,debit,Amenities,0,624,-123876
ba225880-1776-4412-a62b-0a9b1bb4c497-20230506-261,2023-05-06,debit,Late Fee,0,950,-124826
ba225880-1776-4412-a62b-0a9b1bb4c497-20230507-262,2023-05-07,debit,Amenities,0,624,-125450
ba225880-1776-4412-a62b-0a9b1bb4c497-20230507-263,2023-05-07,debit,Late Fee,0,811,-126261
ba225880-1776-4412-a62b-0a9b1bb4c497-20230508-264,2023-05-08,debit,Amenities,0,624,-126885
ba225880-1776-4412-a62b-0a9b1bb4c497-20230508-265,2023-05-08,debit,Late Fee,0,720,-127605
ba225880-1776-4412-a62b-0a9b1bb4c497-20230509-266,2023-05-09,debit,Amenities,0,624,-128229
ba225880-1776-4412-a62b-0a9b1bb4c497-20230509-267,2023-05-09,debit,Late Fee,0,712,-128941
ba225880-1776-4412-a62b-0a9b1bb4c497-20230510-268,2023-05-10,debit,Amenities,0,624,-129565
ba225880-1776-4412-a62b-0a9b1bb4c497-20230510-269,2023-05-10,debit,Late Fee,0,513,-130078
ba225880-1776-4412-a62b-0a9b1bb4c497-20230511-270,2023-05-11,debit,Amenities,0,624,-130702
ba225880-1776-4412-a62b-0a9b1bb4c497-20230511-271,2023-05-11,debit,Late Fee,0,966,-131668
ba225880-1776-4412-a62b-0a9b1bb4c497-20230512-272,2023-05-12,debit,Amenities,0,624,-132292
ba225880-1776-4412-a62b-0a9b1bb4c497-20230512-273,2023-05-12,debit,Late Fee,0,956,-133248
ba225880-1776-4412-a62b-0a9b1bb4c497-20230513-274,2023-05-13,debit,Amenities,0,624,-133872
ba225880-1776-4412-a62b-0a9b1bb4c497-20230513-275,2023-05-13,debit,Late Fee,0,364,-134236
ba225880-1776-4412-a62b-0a9b1bb4c497-20230514-276,2023-05-14,debit,Amenities,0,624,-134860
ba225880-1776-4412-a62b-0a9b1bb4c497-20230514-277,2023-05-14,debit,Late Fee,0,877,-135737
ba225880-1776-4412-a62b-0a9b1bb4c497-20230515-278,2023-05-15,debit,Amenities,0,624,-136361
ba225880-1776-4412-a62b-0a9b1bb4c497-20230515-279,2023-05-15,debit,Late Fee,0,774,-137135
ba225880-1776-4412-a62b-0a9b1bb4c497-20230516-280,2023-05-16,debit,Amenities,0,624,-137759
ba225880-1776-4412-a62b-0a9b1bb4c497-20230516-281,2023-05-16,debit,Late Fee,0,564,-138323
ba225880-1776-4412-a62b-0a9b1bb4c497-20230517-282,2023-05-17,debit,Amenities,0,624,-138947
ba225880-1776-4412-a62b-0a9b1bb4c497-20230517-283,2023-05-17,debit,Late Fee,0,443,-139390
ba225880-1776-4412-a62b-0a9b1bb4c497-20230518-284,2023-05-18,debit,Amenities,0,624,-140014
ba225880-1776-4412-a62b-0a9b1bb4c497-20230518-285,2023-05-18,debit,Late Fee,0,326,-140340
ba225880-1776-4412-a62b-0a9b1bb4c497-20230519-286,2023-05-19,debit,Amenities,0,624,-140964
ba225880-1776-4412-a62b-0a9b1bb4c497-20230519-287,2023-05-19,debit,Late Fee,0,824,-141788
ba225880-1776-4412-a62b-0a9b1bb4c497-20230520-288,2023-05-20,debit,Amenities,0,624,-142412
ba225880-1776-4412-a62b-0a9b1bb4c497-20230520-289,2023-05-20,debit,Late Fee,0,420,-142832
ba225880-1776-4412-a62b-0a9b1bb4c497-20230521-290,2023-05-21,debit,Groceries,0,1248,-144080
ba225880-1776-4412-a62b-0a9b1bb4c497-20230521-291,2023-05-21,debit,Amenities,0,624,-144704
ba225880-1776-4412-a62b-0a9b1bb4c497-20230521-292,2023-05-21,debit,Late Fee,0,976,-145680
ba225880-1776-4412-a62b-0a9b1bb4c497-20230522-293,2023-05-22,debit,Amenities,0,624,-146304
ba225880-1776-4412-a62b-0a9b1bb4c497-20230522-294,2023-05-22,debit,Late Fee,0,952,-147256
ba225880-1776-4412-a62b-0a9b1bb4c497-20230523-295,2023-05-23,debit,Amenities,0,624,-147880
ba225880-1776-4412-a62b-0a9b1bb4c497-20230523-296,2023-05-23,debit,Late Fee,0,761,-148641
ba225880-1776-4412-a62b-0a9b1bb4c497-20230524-297,2023-05-24,debit,Amenities,0,624,-149265
ba225880-1776-4412-a62b-0a9b1bb4c497-20230524-298,2023-05-24,debit,Late Fee,0,564,-149829
ba225880-1776-4412-a62b-0a9b1bb4c497-20230525-299,2023-05-25,debit,Amenities,0,624,-150453
ba225880-1776-4412-a62b-0a9b1bb4c497-20230525-300,2023-05-25,debit,Late Fee,0,346,-150799
ba225880-1776-4412-a62b-0a9b1bb4c497-20230526-301,2023-05-26,debit,Amenities,0,624,-151423
ba225880-1776-4412-a62b-0a9b1bb4c497-20230526-302,2023-05-26,debit,Late Fee,0,870,-152293
ba225880-1776-4412-a62b-0a9b1bb4c497-20230527-303,2023-05-27,debit,Amenities,0,624,-152917
ba225880-1776-4412-a62b-0a9b1bb4c497-20230527-304,2023-05-27,debit,Late Fee,0,901,-153818
ba225880-1776-4412-a62b-0a9b1bb4c497-20230528-305,2023-05-28,debit,Amenities,0,624,-154442
ba225880-1776-4412-a62b-0a9b1bb4c497-20230528-306,2023-05-28,debit,Late Fee,0,868,-155310
ba225880-1776-4412-a62b-0a9b1bb4c497-20230529-307,2023-05-29,debit,Amenities,0,624,-155934
ba225880-1776-4412-a62b-0a9b1bb4c497-20230529-308,2023-05-29,debit,Late Fee,0,730,-156664
ba225880-1776-4412-a62b-0a9b1bb4c497-20230530-309,2023-05-30,debit,Amenities,0,624,-157288
ba225880-1776-4412-a62b-0a9b1bb4c497-20230530-310,2023-05-30,debit,Late Fee,0,710,-157998
ba225880-1776-4412-a62b-0a9b1bb4c497-20230531-311,2023-05-31,debit,Amenities,0,624,-158622
ba225880-1776-4412-a62b-0a9b1bb4c497-20230531-312,2023-05-31,debit,Late Fee,0,805,-159427
ba225880-1776-4412-a62b-0a9b1bb4c497-20230601-313,2023-06-01,credit,Salary,4160,0,-155267
ba225880-1776-4412-a62b-0a9b1bb4c497-20230601-314,2023-06-01,debit,Amenities,0,624,-155891
ba225880-1776-4412-a62b-0a9b1bb4c497-20230601-315,2023-06-01,debit,Late Fee,0,472,-156363
ba225880-1776-4412-a62b-0a9b1bb4c497-20230602-316,2023-06-02,debit,Amenities,0,624,-156987
ba225880-1776-4412-a62b-0a9b1bb4c497-20230602-317,2023-06-02,debit,Late Fee,0,885,-157872
ba225880-1776-4412-a62b-0a9b1bb4c497-20230603-318,2023-06-03,debit,Amenities,0,624,-158496
ba225880-1776-4412-a62b-0a9b1bb4c497-20230603-319,2023-06-03,debit,Late Fee,0,456,-158952
ba225880-1776-4412-a62b-0a9b1bb4c497-20230604-320,2023-06-04,debit,Amenities,0,624,-159576
ba225880-1776-4412-a62b-0a9b1bb4c497-20230604-321,2023-06-04,debit,Late Fee,0,558,-160134
ba225880-1776-4412-a62b-0a9b1bb4c497-20230605-322,2023-06-05,debit,Amenities,0,624,-160758
ba225880-1776-4412-a62b-0a9b1bb4c497-20230605-323,2023-06-05,debit,Late Fee,0,367,-161125
ba225880-1776-4412-a62b-0a9b1bb4c497-20230606-324,2023-06-06,debit,Amenities,0,624,-161749
ba225880-1776-4412-a62b-0a9b1bb4c497-20230606-325,2023-06-06,debit,Late Fee,0,921,-162670
ba225880-1776-4412-a62b-0a9b1bb4c497-20230607-326,2023-06-07,debit,Amenities,0,624,-163294
ba225880-1776-4412-a62b-0a9b1bb4c497-20230607-327,2023-06-07,debit,Late Fee,0,503,-163797
ba225880-1776-4412-a62b-0a9b1bb4c497-20230608-328,2023-06-08,debit,Amenities,0,624,-164421
ba225880-1776-4412-a62b-0a9b1bb4c497-20230608-329,2023-06-08,debit,Late Fee,0,741,-165162
ba225880-1776-4412-a62b-0a9b1bb4c497-20230609-330,2023-06-09,debit,Amenities,0,624,-165786
ba225880-1776-4412-a62b-0a9b1bb4c497-20230609-331,2023-06-09,debit,Late Fee,0,307,-166093
ba225880-1776-4412-a62b-0a9b1bb4c497-20230610-332,2023-06-10,debit,Amenities,0,624,-166717
ba225880-1776-4412-a62b-0a9b1bb4c497-20230610-333,2023-06-10,debit,Late Fee,0,824,-167541
ba225880-1776-4412-a62b-0a9b1bb4c497-20230611-334,2023-06-11,debit,Amenities,0,624,-168165
ba225880-1776-4412-a62b-0a9b1bb4c497-20230611-335,2023-06-11,debit,Late Fee,0,593,-168758
ba225880-1776-4412-a62b-0a9b1bb4c497-20230612-336,2023-06-12,debit,Amenities,0,624,-169382
ba225880-1776-4412-a62b-0a9b1bb4c497-20230612-337,2023-06-12,debit,Late Fee,0,535,-169917
ba225880-1776-4412-a62b-0a9b1bb4c497-20230613-338,2023-06-13,debit,Amenities,0,624,-170541
ba225880-1776-4412-a62b-0a9b1bb4c497-20230613-339,2023-06-13,debit,Late Fee,0,620,-171161
ba225880-1776-4412-a62b-0a9b1bb4c497-20230614-340,2023-06-14,debit,Amenities,0,624,-171785
ba225880-1776-4412-a62b-0a9b1bb4c497-20230614-341,2023-06-14,debit,Late Fee,0,396,-172181
ba225880-1776-4412-a62b-0a9b1bb4c497-20230615-342,2023-06-15,debit,Amenities,0,624,-172805
ba225880-1776-4412-a62b-0a9b1bb4c497-20230615-343,2023-06-15,debit,Late Fee,0,486,-173291
ba225880-1776-4412-a62b-0a9b1bb4c497-20230616-344,2023-06-16,debit,Amenities,0,624,-173915
ba225880-1776-4412-a62b-0a9b1bb4c497-20230616-345,2023-06-16,debit,Late Fee,0,495,-174410
ba225880-1776-4412-a62b-0a9b1bb4c497-20230617-346,2023-06-17,debit,Amenities,0,624,-175034
ba225880-1776-4412-a62b-0a9b1bb4c497-20230617-347,2023-06-17,debit,Late Fee,0,871,-175905
ba225880-1776-4412-a62b-0a9b1bb4c497-20230618-348,2023-06-18,debit,Amenities,0,624,-176529
ba225880-1776-4412-a62b-0a9b1bb4c497-20230618-349,2023-06-18,debit,Late Fee,0,846,-177375
ba225880-1776-4412-a62b-0a9b1bb4c497-20230619-350,2023-06-19,debit,Amenities,0,624,-177999
ba225880-1776-4412-a62b-0a9b1bb4c497-20230619-351,2023-06-19,debit,Late Fee,0,862,-178861
ba225880-1776-4412-a62b-0a9b1bb4c497-20230620-352,2023-06-20,debit,Amenities,0,624,-179485
ba225880-1776-4412-a62b-0a9b1bb4c497-20230620-353,2023-06-20,debit,Late Fee,0,722,-180207
ba225880-1776-4412-a62b-0a9b1bb4c497-20230621-354,2023-06-21,debit,Groceries,0,1248,-181455
ba225880-1776-4412-a62b-0a9b1bb4c497-20230621-355,2023-06-21,debit,Amenities,0,624,-182079
ba225880-1776-4412-a62b-0a9b1bb4c497-20230621-356,2023-06-21,debit,Late Fee,0,865,-182944
ba225880-1776-4412-a62b-0a9b1bb4c497-20230622-357,2023-06-22,debit,Amenities,0,624,-183568
ba225880-1776-4412-a62b-0a9b1bb4c497-20230622-358,2023-06-22,debit,Late Fee,0,438,-184006
ba225880-1776-4412-a62b-0a9b1bb4c497-20230623-359,2023-06-23,debit,Amenities,0,624,-184630
ba225880-1776-4412-a62b-0a9b1bb4c497-20230623-360,2023-06-23,debit,Late Fee,0,309,-184939
ba225880-1776-4412-a62b-0a9b1bb4c497-20230624-361,2023-06-24,debit,Amenities,0,624,-185563
ba225880-1776-4412-a62b-0a9b1bb4c497-20230624-362,2023-06-24,debit,Late Fee,0,993,-186556
ba225880-1776-4412-a62b-0a9b1bb4c497-20230625-363,2023-06-25,debit,Amenities,0,624,-187180
ba225880-1776-4412-a62b-0a9b1bb4c497-20230625-364,2023-06-25,debit,Late Fee,0,707,-187887
ba225880-1776-4412-a62b-0a9b1bb4c497-20230626-365,2023-06-26,debit,Amenities,0,624,-188511
ba225880-1776-4412-a62b-0a9b1bb4c497-20230626-366,2023-06-26,debit,Late Fee,0,713,-189224
ba225880-1776-4412-a62b-0a9b1bb4c497-20230627-367,2023-06-27,debit,Amenities,0,624,-189848
ba225880-1776-4412-a62b-0a9b1bb4c497-20230627-368,2023-06-27,debit,Late Fee,0,761,-190609
ba225880-1776-4412-a62b-0a9b1bb4c497-20230628-369,2023-06-28,debit,Amenities,0,624,-191233
ba225880-1776-4412-a62b-0a9b1bb4c497-20230628-370,2023-06-28,debit,Late Fee,0,564,-191797
ba225880-1776-4412-a62b-0a9b1bb4c497-20230629-371,2023-06-29,debit,Amenities,0,624,-192421
ba225880-1776-4412-a62b-0a9b1bb4c497-20230629-372,2023-06-29,debit,Late Fee,0,904,-193325
ba225880-1776-4412-a62b-0a9b1bb4c497-20230630-373,2023-06-30,debit,Amenities,0,624,-193949
ba225880-1776-4412-a62b-0a9b1bb4c497-20230630-374,2023-06-30,debit,Late Fee,0,491,-194440
ba225880-1776-4412-a62b-0a9b1bb4c497-20230701-375,2023-07-01,credit,Salary,4160,0,-190280
ba225880-1776-4412-a62b-0a9b1bb4c497-20230701-376,2023-07-01,debit,Amenities,0,624,-190904
ba225880-1776-4412-a62b-0a9b1bb4c497-20230701-377,2023-07-01,debit,Late Fee,0,796,-191700
ba225880-1776-4412-a62b-0a9b1bb4c497-20230702-378,2023-07-02,debit,Amenities,0,624,-192324
ba225880-1776-4412-a62b-0a9b1bb4c497-20230702-379,2023-07-02,debit,Late Fee,0,755,-193079
ba225880-1776-4412-a62b-0a9b1bb4c497-20230703-380,2023-07-03,debit,Amenities,0,624,-193703
ba225880-1776-4412-a62b-0a9b1bb4c497-20230703-381,2023-07-03,debit,Late Fee,0,739,-194442
ba225880-1776-4412-a62b-0a9b1bb4c497-20230704-382,2023-07-04,debit,Amenities,0,624,-195066
ba225880-1776-4412-a62b-0a9b1bb4c497-20230704-383,2023-07-04,debit,Late Fee,0,707,-195773
ba225880-1776-4412-a62b-0a9b1bb4c497-20230705-384,2023-07-05,debit,Amenities,0,624,-196397
ba225880-1776-4412-a62b-0a9b1bb4c497-20230705-385,2023-07-05,debit,Late Fee,0,583,-196980
ba225880-1776-4412-a62b-0a9b1bb4c497-20230706-386,2023-07-06,debit,Amenities,0,624,-197604
ba225880-1776-4412-a62b-0a9b1bb4c497-20230706-387,2023-07-06,debit,Late Fee,0,941,-198545
ba225880-1776-4412-a62b-0a9b1bb4c497-20230707-388,2023-07-07,debit,Amenities,0,624,-199169
ba225880-1776-4412-a62b-0a9b1bb4c497-20230707-389,2023-07-07,debit,Late Fee,0,371,-199540
ba225880-1776-4412-a62b-0a9b1bb4c497-20230708-390,2023-07-08,debit,Amenities,0,624,-200164
ba225880-1776-4412-a62b-0a9b1bb4c497-20230708-391,2023-07-08,debit,Late Fee,0,463,-200627
ba225880-1776-4412-a62b-0a9b1bb4c497-20230709-392,2023-07-09,debit,Amenities,0,624,-201251
ba225880-1776-4412-a62b-0a9b1bb4c497-20230709-393,2023-07-09,debit,Late Fee,0,451,-201702
ba225880-1776-4412-a62b-0a9b1bb4c497-20230710-394,2023-07-10,debit,Amenities,0,624,-202326
ba225880-1776-4412-a62b-0a9b1bb4c497-20230710-395,2023-07-10,debit,Late Fee,0,602,-202928
ba225880-1776-4412-a62b-0a9b1bb4c497-20230711-396,2023-07-11,debit,Amenities,0,624,-203552
ba225880-1776-4412-a62b-0a9b1bb4c497-20230711-397,2023-07-11,debit,Late Fee,0,630,-204182
ba225880-1776-4412-a62b-0a9b1bb4c497-20230712-398,2023-07-12,debit,Amenities,0,624,-204806
ba225880-1776-4412-a62b-0a9b1bb4c497-20230712-399,2023-07-12,debit,Late Fee,0,565,-205371
ba225880-1776-4412-a62b-0a9b1bb4c497-20230713-400,2023-07-13,debit,Amenities,0,624,-205995
ba225880-1776-4412-a62b-0a9b1bb4c497-20230713-401,2023-07-13,debit,Late Fee,0,819,-206814
ba225880-1776-4412-a62b-0a9b1bb4c497-20230714-402,2023-07-14,debit,Amenities,0,624,-207438
ba225880-1776-4412-a62b-0a9b1bb4c497-20230714-403,2023-07-14,debit,Late Fee,0,469,-207907
ba225880-1776-4412-a62b-0a9b1bb4c497-20230715-404,2023-07-15,debit,Amenities,0,624,-208531
ba225880-1776-4412-a62b-0a9b1bb4c497-20230715-405,2023-07-15,debit,Late Fee,0,333,-208864
ba225880-1776-4412-a62b-0a9b1bb4c497-20230716-406,2023-07-16,debit,Amenities,0,624,-209488
ba225880-1776-4412-a62b-0a9b1bb4c497-20230716-407,2023-07-16,debit,Late Fee,0,596,-210084
ba225880-1776-4412-a62b-0a9b1bb4c497-20230717-408,2023-07-17,debit,Amenities,0,624,-210708
ba225880-1776-4412-a62b-0a9b1bb4c497-20230717-409,2023-07-17,debit,Late Fee,0,795,-211503
ba225880-1776-4412-a62b-0a9b1bb4c497-20230718-410,2023-07-18,debit,Amenities,0,624,-212127
ba225880-1776-4412-a62b-0a9b1bb4c497-20230718-411,2023-07-18,debit,Late Fee,0,736,-212863
ba225880-1776-4412-a62b-0a9b1bb4c497-20230719-412,2023-07-19,debit,Amenities,0,624,-213487
ba225880-1776-4412-a62b-0a9b1bb4c497-20230719-413,2023-07-19,debit,Late Fee,0,912,-214399
ba225880-1776-4412-a62b-0a9b1bb4c497-20230720-414,2023-07-20,debit,Amenities,0,624,-215023
ba225880-1776-4412-a62b-0a9b1bb4c497-20230720-415,2023-07-20,debit,Late Fee,0,815,-215838
ba225880-1776-4412-a62b-0a9b1bb4c497-20230721-416,2023-07-21,debit,Groceries,0,1248,-217086
ba225880-1776-4412-a62b-0a9b1bb4c497-20230721-417,2023-07-21,debit,Amenities,0,624,-217710
ba225880-1776-4412-a62b-0a9b1bb4c497-20230721-418,2023-07-21,debit,Late Fee,0,509,-218219
ba225880-1776-4412-a62b-0a9b1bb4c497-20230722-419,2023-07-22,debit,Amenities,0,624,-218843
ba225880-1776-4412-a62b-0a9b1bb4c497-20230722-420,2023-07-22,debit,Late Fee,0,520,-219363
ba225880-1776-4412-a62b-0a9b1bb4c497-20230723-421,2023-07-23,debit,Amenities,0,624,-219987
ba225880-1776-4412-a62b-0a9b1bb4c497-20230723-422,2023-07-23,debit,Late Fee,0,726,-220713
ba225880-1776-4412-a62b-0a9b1bb4c497-20230724-423,2023-07-24,debit,Amenities,0,624,-221337
ba225880-1776-4412-a62b-0a9b1bb4c497-20230724-424,2023-07-24,debit,Late Fee,0,500,-221837
ba225880-1776-4412-a62b-0a9b1bb4c497-20230725-425,2023-07-25,debit,Amenities,0,624,-222461
ba225880-1776-4412-a62b-0a9b1bb4c497-20230725-426,2023-07-25,debit,Late Fee,0,434,-222895
ba225880-1776-4412-a62b-0a9b1bb4c497-20230726-427,2023-07-26,debit,Amenities,0,624,-223519
ba225880-1776-4412-a62b-0a9b1bb4c497-20230726-428,2023-07-26,debit,Late Fee,0,647,-224166
ba225880-1776-4412-a62b-0a9b1bb4c497-20230727-429,2023-07-27,debit,Amenities,0,624,-224790
ba225880-1776-4412-a62b-0a9b1bb4c497-20230727-430,2023-07-27,debit,Late Fee,0,458,-225248
ba225880-1776-4412-a62b-0a9b1bb4c497-20230728-431,2023-07-28,debit,Amenities,0,624,-225872
ba225880-1776-4412-a62b-0a9b1bb4c497-20230728-432,2023-07-28,debit,Late Fee,0,881,-226753
ba225880-1776-4412-a62b-0a9b1bb4c497-20230729-433,2023-07-29,debit,Amenities,0,624,-227377
ba225880-1776-4412-a62b-0a9b1bb4c497-20230729-434,2023-07-29,debit,Late Fee,0,841,-228218
ba225880-1776-4412-a62b-0a9b1bb4c497-20230730-435,2023-07-30,debit,Amenities,0,624,-228842
ba225880-1776-4412-a62b-0a9b1bb4c497-20230730-436,2023-07-30,debit,Late Fee,0,827,-229669
ba225880-1776-4412-a62b-0a9b1bb4c497-20230731-437,2023-07-31,debit,Amenities,0,624,-230293
ba225880-1776-4412-a62b-0a9b1bb4c497-20230731-438,2023-07-31,debit,Late Fee,0,821,-231114
ba225880-1776-4412-a62b-0a9b1bb4c497-20230801-439,2023-08-01,credit,Salary,4160,0,-226954
ba225880-1776-4412-a62b-0a9b1bb4c497-20230801-440,2023-08-01,debit,Amenities,0,624,-227578
ba225880-1776-4412-a62b-0a9b1bb4c497-20230801-441,2023-08-01,debit,Late Fee,0,862,-228440
ba225880-1776-4412-a62b-0a9b1bb4c497-20230802-442,2023-08-02,debit,Amenities,0,624,-229064
ba225880-1776-4412-a62b-0a9b1bb4c497-20230802-443,2023-08-02,debit,Late Fee,0,978,-230042
ba225880-1776-4412-a62b-0a9b1bb4c497-20230803-444,2023-08-03,debit,Amenities,0,624,-230666
ba225880-1776-4412-a62b-0a9b1bb4c497-20230803-445,2023-08-03,debit,Late Fee,0,684,-231350
ba225880-1776-4412-a62b-0a9b1bb4c497-20230804-446,2023-08-04,debit,Amenities,0,624,-231974
ba225880-1776-4412-a62b-0a9b1bb4c497-20230804-447,2023-08-04,debit,Late Fee,0,761,-232735
ba225880-1776-4412-a62b-0a9b1bb4c497-20230805-448,2023-08-05,debit,Amenities,0,624,-233359
ba225880-1776-4412-a62b-0a9b1bb4c497-20230805-449,2023-08-05,debit,Late Fee,0,452,-233811
ba225880-1776-4412-a62b-0a9b1bb4c497-20230806-450,2023-08-06,debit,Amenities,0,624,-234435
ba225880-1776-4412-a62b-0a9b1bb4c497-20230806-451,2023-08-06,debit,Late Fee,0,631,-235066
ba225880-1776-4412-a62b-0a9b1bb4c497-20230807-452,2023-08-07,debit,Amenities,0,624,-235690
ba225880-1776-4412-a62b-0a9b1bb4c497-20230807-453,2023-08-07,debit,Late Fee,0,927,-236617
ba225880-1776-4412-a62b-0a9b1bb4c497-20230808-454,2023-08-08,debit,Amenities,0,624,-237241
ba225880-1776-4412-a62b-0a9b1bb4c497-20230808-455,2023-08-08,debit,Late Fee,0,838,-238079
ba225880-1776-4412-a62b-0a9b1bb4c497-20230809-456,2023-08-09,debit,Amenities,0,624,-238703
ba225880-1776-4412-a62b-0a9b1bb4c497-20230809-457,2023-08-09,debit,Late Fee,0,434,-239137
ba225880-1776-4412-a62b-0a9b1bb4c497-20230810-458,2023-08-10,debit,Amenities,0,624,-239761
ba225880-1776-4412-a62b-0a9b1bb4c497-20230810-459,2023-08-10,debit,Late Fee,0,343,-240104
ba225880-1776-4412-a62b-0a9b1bb4c497-20230811-460,2023-08-11,debit,Amenities,0,624,-240728
ba225880-1776-4412-a62b-0a9b1bb4c497-20230811-461,2023-08-11,debit,Late Fee,0,612,-241340
ba225880-1776-4412-a62b-0a9b1bb4c497-20230812-462,2023-08-12,debit,Amenities,0,624,-241964
ba225880-1776-4412-a62b-0a9b1bb4c497-20230812-463,2023-08-12,debit,Late Fee,0,591,-242555
ba225880-1776-4412-a62b-0a9b1bb4c497-20230813-464,2023-08-13,debit,Amenities,0,624,-243179
ba225880-1776-4412-a62b-0a9b1bb4c497-20230813-465,2023-08-13,debit,Late Fee,0,903,-244082
ba225880-1776-4412-a62b-0a9b1bb4c497-20230814-466,2023-08-14,debit,Amenities,0,624,-244706
ba225880-1776-4412-a62b-0a9b1bb4c497-20230814-467,2023-08-14,debit,Late Fee,0,701,-245407
ba225880-1776-4412-a62b-0a9b1bb4c497-20230815-468,2023-08-15,debit,Amenities,0,624,-246031
ba225880-1776-4412-a62b-0a9b1bb4c497-20230815-469,2023-08-15,debit,Late Fee,0,420,-246451
ba225880-1776-4412-a62b-0a9b1bb4c497-20230816-470,2023-08-16,debit,Amenities,0,624,-247075
ba225880-1776-4412-a62b-0a9b1bb4c497-20230816-471,2023-08-16,debit,Late Fee,0,835,-247910
ba225880-1776-4412-a62b-0a9b1bb4c497-20230817-472,2023-08-17,debit,Amenities,0,624,-248534
ba225880-1776-4412-a62b-0a9b1bb4c497-20230817-473,2023-08-17,debit,Late Fee,0,463,-248997
ba225880-1776-4412-a62b-0a9b1bb4c497-20230818-474,2023-08-18,debit,Amenities,0,624,-249621
ba225880-1776-4412-a62b-0a9b1bb4c497-20230818-475,2023-08-18,debit,Late Fee,0,343,-249964
ba225880-1776-4412-a62b-0a9b1bb4c497-20230819-476,2023-08-19,debit,Amenities,0,624,-250588
ba225880-1776-4412-a62b-0a9b1bb4c497-20230819-477,2023-08-19,debit,Late Fee,0,964,-251552
ba225880-1776-4412-a62b-0a9b1bb4c497-20230820-478,2023-08-20,debit,Amenities,0,624,-252176
ba225880-1776-4412-a62b-0a9b1bb4c497-20230820-479,2023-08-20,debit,Late Fee,0,754,-252930
ba225880-1776-4412-a62b-0a9b1bb4c497-20230821-480,2023-08-21,debit,Groceries,0,1248,-254178
ba225880-1776-4412-a62b-0a9b1bb4c497-20230821-481,2023-08-21,debit,Amenities,0,624,-254802
ba225880-1776-4412-a62b-0a9b1bb4c497-20230821-482,2023-08-21,debit,Late Fee,0,861,-255663
ba225880-1776-4412-a62b-0a9b1bb4c497-20230822-483,2023-08-22,debit,Amenities,0,624,-256287
ba225880-1776-4412-a62b-0a9b1bb4c497-20230822-484,2023-08-22,debit,Late Fee,0,712,-256999
ba225880-1776-4412-a62b-0a9b1bb4c497-20230823-485,2023-08-23,debit,Amenities,0,624,-257623
ba225880-1776-4412-a62b-0a9b1bb4c497-20230823-486,2023-08-23,debit,Late Fee,0,449,-258072
ba225880-1776-4412-a62b-0a9b1bb4c497-20230824-487,2023-08-24,debit,Amenities,0,624,-258696
ba225880-1776-4412-a62b-0a9b1bb4c497-20230824-488,2023-08-24,debit,Late Fee,0,999,-259695
ba225880-1776-4412-a62b-0a9b1bb4c497-20230825-489,2023-08-25,debit,Amenities,0,624,-260319
ba225880-1776-4412-a62b-0a9b1bb4c497-20230825-490,2023-08-25,debit,Late Fee,0,978,-261297
ba225880-1776-4412-a62b-0a9b1bb4c497-20230826-491,2023-08-26,debit,Amenities,0,624,-261921
ba225880-1776-4412-a62b-0a9b1bb4c497-20230826-492,2023-08-26,debit,Late Fee,0,821,-262742
ba225880-1776-4412-a62b-0a9b1bb4c497-20230827-493,2023-08-27,debit,Amenities,0,624,-263366
ba225880-1776-4412-a62b-0a9b1bb4c497-20230827-494,2023-08-27,debit,Late Fee,0,507,-263873
ba225880-1776-4412-a62b-0a9b1bb4c497-20230828-495,2023-08-28,debit,Amenities,0,624,-264497
ba225880-1776-4412-a62b-0a9b1bb4c497-20230828-496,2023-08-28,debit,Late Fee,0,797,-265294
ba225880-1776-4412-a62b-0a9b1bb4c497-20230829-497,2023-08-29,debit,Amenities,0,624,-265918
ba225880-1776-4412-a62b-0a9b1bb4c497-20230829-498,2023-08-29,debit,Late Fee,0,685,-266603
ba225880-1776-4412-a62b-0a9b1bb4c497-20230830-499,2023-08-30,debit,Amenities,0,624,-267227
ba225880-1776-4412-a62b-0a9b1bb4c497-20230830-500,2023-08-30,debit,Late Fee,0,507,-267734
ba225880-1776-4412-a62b-0a9b1bb4c497-20230831-501,2023-08-31,debit,Amenities,0,624,-268358
ba225880-1776-4412-a62b-0a9b1bb4c497-20230831-502,2023-08-31,debit,Late Fee,0,438,-268796
ba225880-1776-4412-a62b-0a9b1bb4c497-20230901-503,2023-09-01,credit,Salary,4160,0,-264636
ba225880-1776-4412-a62b-0a9b1bb4c497-20230901-504,2023-09-01,debit,Amenities,0,624,-265260
ba225880-1776-4412-a62b-0a9b1bb4c497-20230901-505,2023-09-01,debit,Late Fee,0,906,-266166
ba225880-1776-4412-a62b-0a9b1bb4c497-20230902-506,2023-09-02,debit,Amenities,0,624,-266790
ba225880-1776-4412-a62b-0a9b1bb4c497-20230902-507,2023-09-02,debit,Late Fee,0,328,-267118
ba225880-1776-4412-a62b-0a9b1bb4c497-20230903-508,2023-09-03,debit,Amenities,0,624,-267742
ba225880-1776-4412-a62b-0a9b1bb4c497-20230903-509,2023-09-03,debit,Late Fee,0,358,-268100
ba225880-1776-4412-a62b-0a9b1bb4c497-20230904-510,2023-09-04,debit,Amenities,0,624,-268724
ba225880-1776-4412-a62b-0a9b1bb4c497-20230904-511,2023-09-04,debit,Late Fee,0,779,-269503
ba225880-1776-4412-a62b-0a9b1bb4c497-20230905-512,2023-09-05,debit,Amenities,0,624,-270127
ba225880-1776-4412-a62b-0a9b1bb4c497-20230905-513,2023-09-05,debit,Late Fee,0,779,-270906
ba225880-1776-4412-a62b-0a9b1bb4c497-20230906-514,2023-09-06,debit,Amenities,0,624,-271530
ba225880-1776-4412-a62b-0a9b1bb4c497-20230906-515,2023-09-06,debit,Late Fee,0,987,-272517
ba225880-1776-4412-a62b-0a9b1bb4c497-20230907-516,2023-09-07,debit,Amenities,0,624,-273141
ba225880-1776-4412-a62b-0a9b1bb4c497-20230907-517,2023-09-07,debit,Late Fee,0,352,-273493
ba225880-1776-4412-a62b-0a9b1bb4c497-20230908-518,2023-09-08,debit,Amenities,0,624,-274117
ba225880-1776-4412-a62b-0a9b1bb4c497-20230908-519,2023-09-08,debit,Late Fee,0,952,-275069
ba225880-1776-4412-a62b-0a9b1bb4c497-20230909-520,2023-09-09,debit,Amenities,0,624,-275693
ba225880-1776-4412-a62b-0a9b1bb4c497-20230909-521,2023-09-09,debit,Late Fee,0,336,-276029
ba225880-1776-4412-a62b-0a9b1bb4c497-20230910-522,2023-09-10,debit,Amenities,0,624,-276653
ba225880-1776-4412-a62b-0a9b1bb4c497-20230910-523,2023-09-10,debit,Late Fee,0,415,-277068
ba225880-1776-4412-a62b-0a9b1bb4c497-20230911-524,2023-09-11,debit,Amenities,0,624,-277692
ba225880-1776-4412-a62b-0a9b1bb4c497-20230911-525,2023-09-11,debit,Late Fee,0,401,-278093
ba225880-1776-4412-a62b-0a9b1bb4c497-20230912-526,2023-09-12,debit,Amenities,0,624,-278717
ba225880-1776-4412-a62b-0a9b1bb4c497-20230912-527,2023-09-12,debit,Late Fee,0,356,-279073
ba225880-1776-4412-a62b-0a9b1bb4c497-20230913-528,2023-09-13,debit,Amenities,0,624,-279697
ba225880-1776-4412-a62b-0a9b1bb4c497-20230913-529,2023-09-13,debit,Late Fee,0,375,-280072
ba225880-1776-4412-a62b-0a9b1bb4c497-20230914-530,2023-09-14,debit,Amenities,0,624,-280696
ba225880-1776-4412-a62b-0a9b1bb4c497-20230914-531,2023-09-14,debit,Late Fee,0,458,-281154
ba225880-1776-4412-a62b-0a9b1bb4c497-20230915-532,2023-09-15,debit,Amenities,0,624,-281778
ba225880-1776-4412-a62b-0a9b1bb4c497-20230915-533,2023-09-15,debit,Late Fee,0,774,-282552
ba225880-1776-4412-a62b-0a9b1bb4c497-20230916-534,2023-09-16,debit,Amenities,0,624,-283176
ba225880-1776-4412-a62b-0a9b1bb4c497-20230916-535,2023-09-16,debit,Late Fee,0,659,-283835
ba225880-1776-4412-a62b-0a9b1bb4c497-20230917-536,2023-09-17,debit,Amenities,0,624,-284459
ba225880-1776-4412-a62b-0a9b1bb4c497-20230917-537,2023-09-17,debit,Late Fee,0,496,-284955
ba225880-1776-4412-a62b-0a9b1bb4c497-20230918-538,2023-09-18,debit,Amenities,0,624,-285579
ba225880-1776-4412-a62b-0a9b1bb4c497-20230918-539,2023-09-18,debit,Late Fee,0,990,-286569
ba225880-1776-4412-a62b-0a9b1bb4c497-20230919-540,2023-09-19,debit,Amenities,0,624,-287193
ba225880-1776-4412-a62b-0a9b1bb4c497-20230919-541,2023-09-19,debit,Late Fee,0,517,-287710
ba225880-1776-4412-a62b-0a9b1bb4c497-20230920-542,2023-09-20,debit,Amenities,0,624,-288334
ba225880-1776-4412-a62b-0a9b1bb4c497-20230920-543,2023-09-20,debit,Late Fee,0,957,-289291
ba225880-1776-4412-a62b-0a9b1bb4c497-20230921-544,2023-09-21,debit,Groceries,0,1248,-290539
ba225880-1776-4412-a62b-0a9b1bb4c497-20230921-545,2023-09-21,debit,Amenities,0,624,-291163
ba225880-1776-4412-a62b-0a9b1bb4c497-20230921-546,2023-09-21,debit,Late Fee,0,687,-291850
ba225880-1776-4412-a62b-0a9b1bb4c497-20230922-547,2023-09-22,debit,Amenities,0,624,-292474
ba225880-1776-4412-a62b-0a9b1bb4c497-20230922-548,2023-09-22,debit,Late Fee,0,662,-293136
ba225880-1776-4412-a62b-0a9b1bb4c497-20230923-549,2023-09-23,debit,Amenities,0,624,-293760
ba225880-1776-4412-a62b-0a9b1bb4c497-20230923-550,2023-09-23,debit,Late Fee,0,877,-294637
ba225880-1776-4412-a62b-0a9b1bb4c497-20230924-551,2023-09-24,debit,Amenities,0,624,-295261
ba225880-1776-4412-a62b-0a9b1bb4c497-20230924-552,2023-09-24,debit,Late Fee,0,868,-296129
ba225880-1776-4412-a62b-0a9b1bb4c497-20230925-553,2023-09-25,debit,Amenities,0,624,-296753
ba225880-1776-4412-a62b-0a9b1bb4c497-20230925-554,2023-09-25,debit,Late Fee,0,792,-297545
ba225880-1776-4412-a62b-0a9b1bb4c497-20230926-555,2023-09-26,debit,Amenities,0,624,-298169
ba225880-1776-4412-a62b-0a9b1bb4c497-20230926-556,2023-09-26,debit,Late Fee,0,700,-298869
ba225880-1776-4412-a62b-0a9b1bb4c497-20230927-557,2023-09-27,debit,Amenities,0,624,-299493
ba225880-1776-4412-a62b-0a9b1bb4c497-20230927-558,2023-09-27,debit,Late Fee,0,958,-300451
ba225880-1776-4412-a62b-0a9b1bb4c497-20230928-559,2023-09-28,debit,Amenities,0,624,-301075
ba225880-1776-4412-a62b-0a9b1bb4c497-20230928-560,2023-09-28,debit,Late Fee,0,573,-301648
ba225880-1776-4412-a62b-0a9b1bb4c497-20230929-561,2023-09-29,debit,Amenities,0,624,-302272
ba225880-1776-4412-a62b-0a9b1bb4c497-20230929-562,2023-09-29,debit,Late Fee,0,392,-302664
ba225880-1776-4412-a62b-0a9b1bb4c497-20230930-563,2023-09-30,debit,Amenities,0,624,-303288
ba225880-1776-4412-a62b-0a9b1bb4c497-20230930-564,2023-09-30,debit,Late Fee,0,577,-303865
ba225880-1776-4412-a62b-0a9b1bb4c497-20231001-565,2023-10-01,credit,Salary,4160,0,-299705
ba225880-1776-4412-a62b-0a9b1bb4c497-20231001-566,2023-10-01,debit,Amenities,0,624,-300329
ba225880-1776-4412-a62b-0a9b1bb4c497-20231001-567,2023-10-01,debit,Late Fee,0,729,-301058
ba225880-1776-4412-a62b-0a9b1bb4c497-20231002-568,2023-10-02,debit,Amenities,0,624,-301682
ba225880-1776-4412-a62b-0a9b1bb4c497-20231002-569,2023-10-02,debit,Late Fee,0,810,-302492
ba225880-1776-4412-a62b-0a9b1bb4c497-20231003-570,2023-10-03,debit,Amenities,0,624,-303116
ba225880-1776-4412-a62b-0a9b1bb4c497-20231003-571,2023-10-03,debit,Late Fee,0,577,-303693
ba225880-1776-4412-a62b-0a9b1bb4c497-20231004-572,2023-10-04,debit,Amenities,0,624,-304317
ba225880-1776-4412-a62b-0a9b1bb4c497-20231004-573,2023-10-04,debit,Late Fee,0,331,-304648
ba225880-1776-4412-a62b-0a9b1bb4c497-20231005-574,2023-10-05,debit,Amenities,0,624,-305272
ba225880-1776-4412-a62b-0a9b1bb4c497-20231005-575,2023-10-05,debit,Late Fee,0,504,-305776
ba225880-1776-4412-a62b-0a9b1bb4c497-20231006-576,2023-10-06,debit,Amenities,0,624,-306400
ba225880-1776-4412-a62b-0a9b1bb4c497-20231006-577,2023-10-06,debit,Late Fee,0,730,-307130
ba225880-1776-4412-a62b-0a9b1bb4c497-20231007-578,2023-10-07,debit,Amenities,0,624,-307754
ba225880-1776-4412-a62b-0a9b1bb4c497-20231007-579,2023-10-07,debit,Late Fee,0,953,-308707
ba225880-1776-4412-a62b-0a9b1bb4c497-20231008-580,2023-10-08,debit,Amenities,0,624,-309331
ba225880-1776-4412-a62b-0a9b1bb4c497-20231008-581,2023-10-08,debit,Late Fee,0,923,-310254
ba225880-1776-4412-a62b-0a9b1bb4c497-20231009-582,2023-10-09,debit,Amenities,0,624,-310878
ba225880-1776-4412-a62b-0a9b1bb4c497-20231009-583,2023-10-09,debit,Late Fee,0,789,-311667
ba225880-1776-4412-a62b-0a9b1bb4c497-20231010-584,2023-10-10,debit,Amenities,0,624,-312291
ba225880-1776-4412-a62b-0a9b1bb4c497-20231010-585,2023-10-10,debit,Late Fee,0,490,-312781
ba225880-1776-4412-a62b-0a9b1bb4c497-20231011-586,2023-10-11,debit,Amenities,0,624,-313405
ba225880-1776-4412-a62b-0a9b1bb4c497-20231011-587,2023-10-11,debit,Late Fee,0,981,-314386
ba225880-1776-4412-a62b-0a9b1bb4c497-20231012-588,2023-10-12,debit,Amenities,0,624,-315010
ba225880-1776-4412-a62b-0a9b1bb4c497-20231012-589,2023-10-12,debit,Late Fee,0,937,-315947
ba225880-1776-4412-a62b-0a9b1bb4c497-20231013-590,2023-10-13,debit,Amenities,0,624,-316571
ba225880-1776-4412-a62b-0a9b1bb4c497-20231013-591,2023-10-13,debit,Late Fee,0,947,-317518
ba225880-1776-4412-a62b-0a9b1bb4c497-20231014-592,2023-10-14,debit,Amenities,0,624,-318142
ba225880-1776-4412-a62b-0a9b1bb4c497-20231014-593,2023-10-14,debit,Late Fee,0,433,-318575
ba225880-1776-4412-a62b-0a9b1bb4c497-20231015-594,2023-10-15,debit,Amenities,0,624,-319199
ba225880-1776-4412-a62b-0a9b1bb4c497-20231015-595,2023-10-15,debit,Late Fee,0,701,-319900
ba225880-1776-4412-a62b-0a9b1bb4c497-20231016-596,2023-10-16,debit,Amenities,0,624,-320524
ba225880-1776-4412-a62b-0a9b1bb4c497-20231016-597,2023-10-16,debit,Late Fee,0,470,-320994
ba225880-1776-4412-a62b-0a9b1bb4c497-20231017-598,2023-10-17,debit,Amenities,0,624,-321618
ba225880-1776-4412-a62b-0a9b1bb4c497-20231017-599,2023-10-17,debit,Late Fee,0,981,-322599
ba225880-1776-4412-a62b-0a9b1bb4c497-20231018-600,2023-10-18,debit,Amenities,0,624,-323223
ba225880-1776-4412-a62b-0a9b1bb4c497-20231018-601,2023-10-18,debit,Late Fee,0,633,-323856
ba225880-1776-4412-a62b-0a9b1bb4c497-20231019-602,2023-10-19,debit,Amenities,0,624,-324480
ba225880-1776-4412-a62b-0a9b1bb4c497-20231019-603,2023-10-19,debit,Late Fee,0,398,-324878
ba225880-1776-4412-a62b-0a9b1bb4c497-20231020-604,2023-10-20,debit,Amenities,0,624,-325502
ba225880-1776-4412-a62b-0a9b1bb4c497-20231020-605,2023-10-20,debit,Late Fee,0,612,-326114
ba225880-1776-4412-a62b-0a9b1bb4c497-20231021-606,2023-10-21,debit,Groceries,0,1248,-327362
ba225880-1776-4412-a62b-0a9b1bb4c497-20231021-607,2023-10-21,debit,Amenities,0,624,-327986
ba225880-1776-4412-a62b-0a9b1bb4c497-20231021-608,2023-10-21,debit,Late Fee,0,500,-328486
ba225880-1776-4412-a62b-0a9b1bb4c497-20231022-609,2023-10-22,debit,Amenities,0,624,-329110
ba225880-1776-4412-a62b-0a9b1bb4c497-20231022-610,2023-10-22,debit,Late Fee,0,834,-329944
ba225880-1776-4412-a62b-0a9b1bb4c497-20231023-611,2023-10-23,debit,Amenities,0,624,-330568
ba225880-1776-4412-a62b-0a9b1bb4c497-20231023-612,2023-10-23,debit,Late Fee,0,827,-331395
ba225880-1776-4412-a62b-0a9b1bb4c497-20231024-613,2023-10-24,debit,Amenities,0,624,-332019
ba225880-1776-4412-a62b-0a9b1bb4c497-20231024-614,2023-10-24,debit,Late Fee,0,601,-332620
ba225880-1776-4412-a62b-0a9b1bb4c497-20231025-615,2023-10-25,debit,Amenities,0,624,-333244
ba225880-1776-4412-a62b-0a9b1bb4c497-20231025-616,2023-10-25,debit,Late Fee,0,424,-333668
ba225880-1776-4412-a62b-0a9b1bb4c497-20231026-617,2023-10-26,debit,Amenities,0,624,-334292
ba225880-1776-4412-a62b-0a9b1bb4c497-20231026-618,2023-10-26,debit,Late Fee,0,884,-335176
ba225880-1776-4412-a62b-0a9b1bb4c497-20231027-619,2023-10-27,debit,Amenities,0,624,-335800
ba225880-1776-4412-a62b-0a9b1bb4c497-20231027-620,2023-10-27,debit,Late Fee,0,855,-336655
ba225880-1776-4412-a62b-0a9b1bb4c497-20231028-621,2023-10-28,debit,Amenities,0,624,-337279
ba225880-1776-4412-a62b-0a9b1bb4c497-20231028-622,2023-10-28,debit,Late Fee,0,656,-337935
ba225880-1776-4412-a62b-0a9b1bb4c497-20231029-623,2023-10-29,debit,Amenities,0,624,-338559
ba225880-1776-4412-a62b-0a9b1bb4c497-20231029-624,2023-10-29,debit,Late Fee,0,736,-339295
ba225880-1776-4412-a62b-0a9b1bb4c497-20231030-625,2023-10-30,debit,Amenities,0,624,-339919
ba225880-1776-4412-a62b-0a9b1bb4c497-20231030-626,2023-10-30,debit,Late Fee,0,587,-340506
ba225880-1776-4412-a62b-0a9b1bb4c497-20231031-627,2023-10-31,debit,Amenities,0,624,-341130
ba225880-1776-4412-a62b-0a9b1bb4c497-20231031-628,2023-10-31,debit,Late Fee,0,883,-342013
ba225880-1776-4412-a62b-0a9b1bb4c497-20231101-629,2023-11-01,credit,Salary,4160,0,-337853
ba225880-1776-4412-a62b-0a9b1bb4c497-20231101-630,2023-11-01,debit,Amenities,0,624,-338477
ba225880-1776-4412-a62b-0a9b1bb4c497-20231101-631,2023-11-01,debit,Late Fee,0,611,-339088
ba225880-1776-4412-a62b-0a9b1bb4c497-20231102-632,2023-11-02,debit,Amenities,0,624,-339712
ba225880-1776-4412-a62b-0a9b1bb4c497-20231102-633,2023-11-02,debit,Late Fee,0,582,-340294
ba225880-1776-4412-a62b-0a9b1bb4c497-20231103-634,2023-11-03,debit,Amenities,0,624,-340918
ba225880-1776-4412-a62b-0a9b1bb4c497-20231103-635,2023-11-03,debit,Late Fee,0,789,-341707
ba225880-1776-4412-a62b-0a9b1bb4c497-20231104-636,2023-11-04,debit,Amenities,0,624,-342331
ba225880-1776-4412-a62b-0a9b1bb4c497-20231104-637,2023-11-04,debit,Late Fee,0,606,-342937
ba225880-1776-4412-a62b-0a9b1bb4c497-20231105-638,2023-11-05,debit,Amenities,0,624,-343561
ba225880-1776-4412-a62b-0a9b1bb4c497-20231105-639,2023-11-05,debit,Late Fee,0,673,-344234
ba225880-1776-4412-a62b-0a9b1bb4c497-20231106-640,2023-11-06,debit,Amenities,0,624,-344858
ba225880-1776-4412-a62b-0a9b1bb4c497-20231106-641,2023-11-06,debit,Late Fee,0,454,-345312
ba225880-1776-4412-a62b-0a9b1bb4c497-20231107-642,2023-11-07,debit,Amenities,0,624,-345936
ba225880-1776-4412-a62b-0a9b1bb4c497-20231107-643,2023-11-07,debit,Late Fee,0,438,-346374
ba225880-1776-4412-a62b-0a9b1bb4c497-20231108-644,2023-11-08,debit,Amenities,0,624,-346998
ba225880-1776-4412-a62b-0a9b1bb4c497-20231108-645,2023-11-08,debit,Late Fee,0,986,-347984
ba225880-1776-4412-a62b-0a9b1bb4c497-20231109-646,2023-11-09,debit,Amenities,0,624,-348608
ba225880-1776-4412-a62b-0a9b1bb4c497-20231109-647,2023-11-09,debit,Late Fee,0,342,-348950
ba225880-1776-4412-a62b-0a9b1bb4c497-20231110-648,2023-11-10,debit,Amenities,0,624,-349574
ba225880-1776-4412-a62b-0a9b1bb4c497-20231110-649,2023-11-10,debit,Late Fee,0,758,-350332
ba225880-1776-4412-a62b-0a9b1bb4c497-20231111-650,2023-11-11,debit,Amenities,0,624,-350956
ba225880-1776-4412-a62b-0a9b1bb4c497-20231111-651,2023-11-11,debit,Late Fee,0,460,-351416
ba225880-1776-4412-a62b-0a9b1bb4c497-20231112-652,2023-11-12,debit,Amenities,0,624,-352040
ba225880-1776-4412-a62b-0a9b1bb4c497-20231112-653,2023-11-12,debit,Late Fee,0,414,-352454
ba225880-1776-4412-a62b-0a9b1bb4c497-20231113-654,2023-11-13,debit,Amenities,0,624,-353078
ba225880-1776-4412-a62b-0a9b1bb4c497-20231113-655,2023-11-13,debit,Late Fee,0,448,-353526
ba225880-1776-4412-a62b-0a9b1bb4c497-20231114-656,2023-11-14,debit,Amenities,0,624,-354150
ba225880-1776-4412-a62b-0a9b1bb4c497-20231114-657,2023-11-14,debit,Late Fee,0,542,-354692
ba225880-1776-4412-a62b-0a9b1bb4c497-20231115-658,2023-11-15,debit,Amenities,0,624,-355316
ba225880-1776-4412-a62b-0a9b1bb4c497-20231115-659,2023-11-15,debit,Late Fee,0,841,-356157
ba225880-1776-4412-a62b-0a9b1bb4c497-20231116-660,2023-11-16,debit,Amenities,0,624,-356781
ba225880-1776-4412-a62b-0a9b1bb4c497-20231116-661,2023-11-16,debit,Late Fee,0,896,-357677
ba225880-1776-4412-a62b-0a9b1bb4c497-20231117-662,2023-11-17,debit,Amenities,0,624,-358301
ba225880-1776-4412-a62b-0a9b1bb4c497-20231117-663,2023-11-17,debit,Late Fee,0,473,-358774
ba225880-1776-4412-a62b-0a9b1bb4c497-20231118-664,2023-11-18,debit,Amenities,0,624,-359398
ba225880-1776-4412-a62b-0a9b1bb4c497-20231118-665,2023-11-18,debit,Late Fee,0,407,-359805
ba225880-1776-4412-a62b-0a9b1bb4c497-20231119-666,2023-11-19,debit,Amenities,0,624,-360429
ba225880-1776-4412-a62b-0a9b1bb4c497-20231119-667,2023-11-19,debit,Late Fee,0,710,-361139
ba225880-1776-4412-a62b-0a9b1bb4c497-20231120-668,2023-11-20,debit,Amenities,0,624,-361763
ba225880-1776-4412-a62b-0a9b1bb4c497-20231120-669,2023-11-20,debit,Late Fee,0,795,-362558
ba225880-1776-4412-a62b-0a9b1bb4c497-20231121-670,2023-11-21,debit,Groceries,0,1248,-363806
ba225880-1776-4412-a62b-0a9b1bb4c497-20231121-671,2023-11-21,debit,Amenities,0,624,-364430
ba225880-1776-4412-a62b-0a9b1bb4c497-20231121-672,2023-11-21,debit,Late Fee,0,815,-365245
ba225880-1776-4412-a62b-0a9b1bb4c497-20231122-673,2023-11-22,debit,Amenities,0,624,-365869
ba225880-1776-4412-a62b-0a9b1bb4c497-20231122-674,2023-11-22,debit,Late Fee,0,485,-366354
ba225880-1776-4412-a62b-0a9b1bb4c497-20231123-675,2023-11-23,debit,Amenities,0,624,-366978
ba225880-1776-4412-a62b-0a9b1bb4c497-20231123-676,2023-11-23,debit,Late Fee,0,916,-367894
ba225880-1776-4412-a62b-0a9b1bb4c497-20231124-677,2023-11-24,debit,Amenities,0,624,-368518
ba225880-1776-4412-a62b-0a9b1bb4c497-20231124-678,2023-11-24,debit,Late Fee,0,464,-368982
ba225880-1776-4412-a62b-0a9b1bb4c497-20231125-679,2023-11-25,debit,Amenities,0,624,-369606
ba225880-1776-4412-a62b-0a9b1bb4c497-20231125-680,2023-11-25,debit,Late Fee,0,812,-370418
ba225880-1776-4412-a62b-0a9b1bb4c497-20231126-681,2023-11-26,debit,Amenities,0,624,-371042
ba225880-1776-4412-a62b-0a9b1bb4c497-20231126-682,2023-11-26,debit,Late Fee,0,670,-371712
ba225880-1776-4412-a62b-0a9b1bb4c497-20231127-683,2023-11-27,debit,Amenities,0,624,-372336
ba225880-1776-4412-a62b-0a9b1bb4c497-20231127-684,2023-11-27,debit,Late Fee,0,470,-372806
ba225880-1776-4412-a62b-0a9b1bb4c497-20231128-685,2023-11-28,debit,Amenities,0,624,-373430
ba225880-1776-4412-a62b-0a9b1bb4c497-20231128-686,2023-11-28,debit,Late Fee,0,549,-373979
ba225880-1776-4412-a62b-0a9b1bb4c497-20231129-687,2023-11-29,debit,Amenities,0,624,-374603
ba225880-1776-4412-a62b-0a9b1bb4c497-20231129-688,2023-11-29,debit,Late Fee,0,551,-375154
ba225880-1776-4412-a62b-0a9b1bb4c497-20231130-689,2023-11-30,debit,Amenities,0,624,-375778
ba225880-1776-4412-a62b-0a9b1bb4c497-20231130-690,2023-11-30,debit,Late Fee,0,522,-376300
ba225880-1776-4412-a62b-0a9b1bb4c497-20231201-691,2023-12-01,credit,Salary,4160,0,-372140
ba225880-1776-4412-a62b-0a9b1bb4c497-20231201-692,2023-12-01,debit,Amenities,0,624,-372764
ba225880-1776-4412-a62b-0a9b1bb4c497-20231201-693,2023-12-01,debit,Late Fee,0,421,-373185
ba225880-1776-4412-a62b-0a9b1bb4c497-20231202-694,2023-12-02,debit,Amenities,0,624,-373809
ba225880-1776-4412-a62b-0a9b1bb4c497-20231202-695,2023-12-02,debit,Late Fee,0,434,-374243
ba225880-1776-4412-a62b-0a9b1bb4c497-20231203-696,2023-12-03,debit,Amenities,0,624,-374867
ba225880-1776-4412-a62b-0a9b1bb4c497-20231203-697,2023-12-03,debit,Late Fee,0,608,-375475
ba225880-1776-4412-a62b-0a9b1bb4c497-20231204-698,2023-12-04,debit,Amenities,0,624,-376099
ba225880-1776-4412-a62b-0a9b1bb4c497-20231204-699,2023-12-04,debit,Late Fee,0,626,-376725
ba225880-1776-4412-a62b-0a9b1bb4c497-20231205-700,2023-12-05,debit,Amenities,0,624,-377349
ba225880-1776-4412-a62b-0a9b1bb4c497-20231205-701,2023-12-05,debit,Late Fee,0,880,-378229
ba225880-1776-4412-a62b-0a9b1bb4c497-20231206-702,2023-12-06,debit,Amenities,0,624,-378853
ba225880-1776-4412-a62b-0a9b1bb4c497-20231206-703,2023-12-06,debit,Late Fee,0,697,-379550
ba225880-1776-4412-a62b-0a9b1bb4c497-20231207-704,2023-12-07,debit,Amenities,0,624,-380174
ba225880-1776-4412-a62b-0a9b1bb4c497-20231207-705,2023-12-07,debit,Late Fee,0,586,-380760
ba225880-1776-4412-a62b-0a9b1bb4c497-20231208-706,2023-12-08,debit,Amenities,0,624,-381384
ba225880-1776-4412-a62b-0a9b1bb4c497-20231208-707,2023-12-08,debit,Late Fee,0,825,-382209
ba225880-1776-4412-a62b-0a9b1bb4c497-20231209-708,2023-12-09,debit,Amenities,0,624,-382833
ba225880-1776-4412-a62b-0a9b1bb4c497-20231209-709,2023-12-09,debit,Late Fee,0,940,-383773
ba225880-1776-4412-a62b-0a9b1bb4c497-20231210-710,2023-12-10,debit,Amenities,0,624,-384397
ba225880-1776-4412-a62b-0a9b1bb4c497-20231210-711,2023-12-10,debit,Late Fee,0,725,-385122
ba225880-1776-4412-a62b-0a9b1bb4c497-20231211-712,2023-12-11,debit,Amenities,0,624,-385746
ba225880-1776-4412-a62b-0a9b1bb4c497-20231211-713,2023-12-11,debit,Late Fee,0,953,-386699
ba225880-1776-4412-a62b-0a9b1bb4c497-20231212-714,2023-12-12,debit,Amenities,0,624,-387323
ba225880-1776-4412-a62b-0a9b1bb4c497-20231212-715,2023-12-12,debit,Late Fee,0,944,-388267
ba225880-1776-4412-a62b-0a9b1bb4c497-20231213-716,2023-12-13,debit,Amenities,0,624,-388891
ba225880-1776-4412-a62b-0a9b1bb4c497-20231213-717,2023-12-13,debit,Late Fee,0,394,-389285
ba225880-1776-4412-a62b-0a9b1bb4c497-20231214-718,2023-12-14,debit,Amenities,0,624,-389909
ba225880-1776-4412-a62b-0a9b1bb4c497-20231214-719,2023-12-14,debit,Late Fee,0,555,-390464
ba225880-1776-4412-a62b-0a9b1bb4c497-20231215-720,2023-12-15,debit,Amenities,0,624,-391088
ba225880-1776-4412-a62b-0a9b1bb4c497-20231215-721,2023-12-15,debit,Late Fee,0,475,-391563
ba225880-1776-4412-a62b-0a9b1bb4c497-20231216-722,2023-12-16,debit,Amenities,0,624,-392187
ba225880-1776-4412-a62b-0a9b1bb4c497-20231216-723,2023-12-16,debit,Late Fee,0,780,-392967
ba225880-1776-4412-a62b-0a9b1bb4c497-20231217-724,2023-12-17,debit,Amenities,0,624,-393591
ba225880-1776-4412-a62b-0a9b1bb4c497-20231217-725,2023-12-17,debit,Late Fee,0,344,-393935
ba225880-1776-4412-a62b-0a9b1bb4c497-20231218-726,2023-12-18,debit,Amenities,0,624,-394559
ba225880-1776-4412-a62b-0a9b1bb4c497-20231218-727,2023-12-18,debit,Late Fee,0,381,-394940
ba225880-1776-4412-a62b-0a9b1bb4c497-20231219-728,2023-12-19,debit,Amenities,0,624,-395564
ba225880-1776-4412-a62b-0a9b1bb4c497-20231219-729,2023-12-19,debit,Late Fee,0,542,-396106
ba225880-1776-4412-a62b-0a9b1bb4c497-20231220-730,2023-12-20,debit,Amenities,0,624,-396730
ba225880-1776-4412-a62b-0a9b1bb4c497-20231220-731,2023-12-20,debit,Late Fee,0,837,-397567
ba225880-1776-4412-a62b-0a9b1bb4c497-20231221-732,2023-12-21,debit,Groceries,0,1248,-398815
ba225880-1776-4412-a62b-0a9b1bb4c497-20231221-733,2023-12-21,debit,Amenities,0,624,-399439
ba225880-1776-4412-a62b-0a9b1bb4c497-20231221-734,2023-12-21,debit,Late Fee,0,313,-399752
ba225880-1776-4412-a62b-0a9b1bb4c497-20231222-735,2023-12-22,debit,Amenities,0,624,-400376
ba225880-1776-4412-a62b-0a9b1bb4c497-20231222-736,2023-12-22,debit,Late Fee,0,804,-401180
ba225880-1776-4412-a62b-0a9b1bb4c497-20231223-737,2023-12-23,debit,Amenities,0,624,-401804
ba225880-1776-4412-a62b-0a9b1bb4c497-20231223-738,2023-12-23,debit,Late Fee,0,563,-402367
ba225880-1776-4412-a62b-0a9b1bb4c497-20231224-739,2023-12-24,debit,Amenities,0,624,-402991
ba225880-1776-4412-a62b-0a9b1bb4c497-20231224-740,2023-12-24,debit,Late Fee,0,591,-403582
ba225880-1776-4412-a62b-0a9b1bb4c497-20231225-741,2023-12-25,debit,Amenities,0,624,-404206
ba225880-1776-4412-a62b-0a9b1bb4c497-20231225-742,2023-12-25,debit,Late Fee,0,665,-404871
ba225880-1776-4412-a62b-0a9b1bb4c497-20231226-743,2023-12-26,debit,Amenities,0,624,-405495
ba225880-1776-4412-a62b-0a9b1bb4c497-20231226-744,2023-12-26,debit,Late Fee,0,999,-406494
ba225880-1776-4412-a62b-0a9b1bb4c497-20231227-745,2023-12-27,debit,Amenities,0,624,-407118
ba225880-1776-4412-a62b-0a9b1bb4c497-20231227-746,2023-12-27,debit,Late Fee,0,494,-407612
ba225880-1776-4412-a62b-0a9b1bb4c497-20231228-747,2023-12-28,debit,Amenities,0,624,-408236
ba225880-1776-4412-a62b-0a9b1bb4c497-20231228-748,2023-12-28,debit,Late Fee,0,327,-408563
ba225880-1776-4412-a62b-0a9b1bb4c497-20231229-749,2023-12-29,debit,Amenities,0,624,-409187
ba225880-1776-4412-a62b-0a9b1bb4c497-20231229-750,2023-12-29,debit,Late Fee,0,983,-410170
ba225880-1776-4412-a62b-0a9b1bb4c497-20231230-751,2023-12-30,debit,Amenities,0,624,-410794
ba225880-1776-4412-a62b-0a9b1bb4c497-20231230-752,2023-12-30,debit,Late Fee,0,436,-411230
ba225880-1776-4412-a62b-0a9b1bb4c497-20231231-753,2023-12-31,debit,Amenities,0,624,-411854
ba225880-1776-4412-a62b-0a9b1bb4c497-20231231-754,2023-12-31,debit,Late Fee,0,843,-412697
