Date,Consolidated,Description,Catgory 1,Category 2,Category 3,Debit,Credit,Balance,DR/CR
1/1/2020,Monthly Income,Monthly Income,Income,Income,Wages,0,6000,6000,CR
2/1/2020,EnergyAustralia /Expense/Household/Utilities,EnergyAustralia ,Expense,Household,Utilities,473,0,5527,DR
2/1/2020,Timezone /Expense/Leisure & Lifestyle/Entertainment,Timezone ,Expense,Leisure & Lifestyle,Entertainment,418,0,5109,DR
3/1/2020,Hungry Jack’s /Expense/Leisure & Lifestyle/Takeaway,Hungry Jack’s ,Expense,Leisure & Lifestyle,Takeaway,208,0,4901,DR
3/1/2020, BSA Ltd /Expense/Household/Maintenance & Improvements, BSA Ltd ,Expense,Household,Maintenance & Improvements,193,0,4708,DR
5/1/2020,Medicare Claim /Expense/Personal/Health & Medical,Medicare Claim ,Expense,Personal,Health & Medical,470,0,4238,DR
5/1/2020,Hungry Jack’s /Expense/Leisure & Lifestyle/Takeaway,Hungry Jack’s ,Expense,Leisure & Lifestyle,Takeaway,344,0,3894,DR
5/1/2020,"Budget Direct Car Insurance /Expense/Transport/Car Insurance, Rego & Maintenance",Budget Direct Car Insurance ,Expense,Transport,"Car Insurance, Rego & Maintenance",253,0,3641,DR
6/1/2020,Optometrist /Expense/Personal/Health & Medical,Optometrist ,Expense,Personal,Health & Medical,207,0,3434,DR
7/1/2020,Payday Advance /Income/Income/Other Income,Payday Advance ,Income,Income,Other Income,272,0,3162,DR
8/1/2020,Tennis Australia /Expense/Personal/Fitness & Wellbeing,Tennis Australia ,Expense,Personal,Fitness & Wellbeing,170,0,2992,DR
8/1/2020,McDonald’s /Expense/Leisure & Lifestyle/Takeaway,McDonald’s ,Expense,Leisure & Lifestyle,Takeaway,277,0,2715,DR
9/1/2020,Mathnasium /Expense/Personal/Education,Mathnasium ,Expense,Personal,Education,259,0,2456,DR
9/1/2020,Boost Juice Bars /Expense/Leisure & Lifestyle/Takeaway,Boost Juice Bars ,Expense,Leisure & Lifestyle,Takeaway,107,0,2349,DR
9/1/2020,Sylvan Learning /Expense/Personal/Education,Sylvan Learning ,Expense,Personal,Education,204,0,2145,DR
11/1/2020,Gold's Gym /Expense/Personal/Fitness & Wellbeing,Gold's Gym ,Expense,Personal,Fitness & Wellbeing,88,0,2057,DR
11/1/2020,ATO Tax Refund /Income/Income/Other Income,ATO Tax Refund ,Income,Income,Other Income,136,0,1921,DR
11/1/2020,"Green Slip Insurance /Expense/Transport/Car Insurance, Rego & Maintenance",Green Slip Insurance ,Expense,Transport,"Car Insurance, Rego & Maintenance",173,0,1748,DR
13/1/2020,Menulog /Expense/Leisure & Lifestyle/Takeaway,Menulog ,Expense,Leisure & Lifestyle,Takeaway,156,0,1592,DR
13/1/2020,ALDI /Expense/Household/Groceries,ALDI ,Expense,Household,Groceries,90,0,1502,DR
15/1/2020,Zarraffa's Coffee /Expense/Leisure & Lifestyle/Restaurants & Cafes,Zarraffa's Coffee ,Expense,Leisure & Lifestyle,Restaurants & Cafes,36,0,1466,DR
15/1/2020,"JAX Tyres /Expense/Transport/Car Insurance, Rego & Maintenance",JAX Tyres ,Expense,Transport,"Car Insurance, Rego & Maintenance",99,0,1367,DR
15/1/2020,Target /Expense/Personal/Clothing & Accessories,Target ,Expense,Personal,Clothing & Accessories,135,0,1232,DR
17/1/2020,Guzman y Gomez /Expense/Leisure & Lifestyle/Takeaway,Guzman y Gomez ,Expense,Leisure & Lifestyle,Takeaway,52,0,1180,DR
17/1/2020,"Stan /Expense/Leisure & Lifestyle/Tv, Music & Streaming",Stan ,Expense,Leisure & Lifestyle,"Tv, Music & Streaming",67,0,1113,DR
18/1/2020,Childcare Payments /Expense/Personal/Children & Family,Childcare Payments ,Expense,Personal,Children & Family,63,0,1050,DR
19/1/2020,ATO Tax Refund /Income/Income/Other Income,ATO Tax Refund ,Income,Income,Other Income,74,0,976,DR
19/1/2020,Hungry Jack’s /Expense/Leisure & Lifestyle/Takeaway,Hungry Jack’s ,Expense,Leisure & Lifestyle,Takeaway,48,0,928,DR
21/1/2020,David Jones /Expense/Personal/Clothing & Accessories,David Jones ,Expense,Personal,Clothing & Accessories,79,0,849,DR
22/1/2020,Boost Juice Bars /Expense/Leisure & Lifestyle/Takeaway,Boost Juice Bars ,Expense,Leisure & Lifestyle,Takeaway,28,0,821,DR
24/1/2020,Upwork Freelancer Payment /Income/Income/Other Income,Upwork Freelancer Payment ,Income,Income,Other Income,79,0,742,DR
24/1/2020, Metricon /Expense/Household/Maintenance & Improvements, Metricon ,Expense,Household,Maintenance & Improvements,65,0,677,DR
24/1/2020,Karate for Kids /Expense/Personal/Fitness & Wellbeing,Karate for Kids ,Expense,Personal,Fitness & Wellbeing,47,0,630,DR
25/1/2020,Local Fish and Chips /Expense/Leisure & Lifestyle/Takeaway,Local Fish and Chips ,Expense,Leisure & Lifestyle,Takeaway,22,0,608,DR
26/1/2020,Gold's Gym /Expense/Personal/Fitness & Wellbeing,Gold's Gym ,Expense,Personal,Fitness & Wellbeing,57,0,551,DR
26/1/2020,Chinatown Night Market /Expense/Leisure & Lifestyle/Pubs & Bars,Chinatown Night Market ,Expense,Leisure & Lifestyle,Pubs & Bars,49,0,502,DR
26/1/2020,Menulog /Expense/Leisure & Lifestyle/Takeaway,Menulog ,Expense,Leisure & Lifestyle,Takeaway,7,0,495,DR
1/2/2020,Monthly Income,Monthly Income,Income,Income,Wages,0,6000,6495,CR
2/2/2020,Sea Life Aquarium /Expense/Leisure & Lifestyle/Entertainment,Sea Life Aquarium ,Expense,Leisure & Lifestyle,Entertainment,342,0,6153,DR
2/2/2020,Boost Juice Bars /Expense/Leisure & Lifestyle/Takeaway,Boost Juice Bars ,Expense,Leisure & Lifestyle,Takeaway,269,0,5884,DR
2/2/2020,Surf Dive 'n Ski /Expense/Personal/Clothing & Accessories,Surf Dive 'n Ski ,Expense,Personal,Clothing & Accessories,138,0,5746,DR
3/2/2020,JB HiFi/Expense/Leisure & Lifestyle/Electronics,JB HiFi,Expense,Leisure & Lifestyle,Electronics,401,0,5345,DR
3/2/2020,Health Food Store /Expense/Personal/Fitness & Wellbeing,Health Food Store ,Expense,Personal,Fitness & Wellbeing,132,0,5213,DR
3/2/2020,Apple Store /Expense/Leisure & Lifestyle/Electronics,Apple Store ,Expense,Leisure & Lifestyle,Electronics,324,0,4889,DR
6/2/2020,Witchery /Expense/Personal/Clothing & Accessories,Witchery ,Expense,Personal,Clothing & Accessories,157,0,4732,DR
7/2/2020,"Green Slip Insurance /Expense/Transport/Car Insurance, Rego & Maintenance",Green Slip Insurance ,Expense,Transport,"Car Insurance, Rego & Maintenance",96,0,4636,DR
8/2/2020,"Adairs /Expense/Household/Furniture, Electronics & Homewares",Adairs ,Expense,Household,"Furniture, Electronics & Homewares",291,0,4345,DR
8/2/2020,Sydney Water /Expense/Household/Utilities,Sydney Water ,Expense,Household,Utilities,336,0,4009,DR
9/2/2020,Culture Kings /Expense/Personal/Clothing & Accessories,Culture Kings ,Expense,Personal,Clothing & Accessories,311,0,3698,DR
10/2/2020,Grill’d /Expense/Leisure & Lifestyle/Takeaway,Grill’d ,Expense,Leisure & Lifestyle,Takeaway,327,0,3371,DR
11/2/2020,Chinatown Night Market /Expense/Leisure & Lifestyle/Pubs & Bars,Chinatown Night Market ,Expense,Leisure & Lifestyle,Pubs & Bars,7,0,3364,DR
11/2/2020,Optometrist /Expense/Personal/Health & Medical,Optometrist ,Expense,Personal,Health & Medical,163,0,3201,DR
11/2/2020,Soccer Clubs /Expense/Personal/Fitness & Wellbeing,Soccer Clubs ,Expense,Personal,Fitness & Wellbeing,260,0,2941,DR
12/2/2020,Health Food Store /Expense/Personal/Fitness & Wellbeing,Health Food Store ,Expense,Personal,Fitness & Wellbeing,246,0,2695,DR
13/2/2020,Bulk Billing Doctor /Expense/Personal/Health & Medical,Bulk Billing Doctor ,Expense,Personal,Health & Medical,105,0,2590,DR
13/2/2020,"Audible /Expense/Leisure & Lifestyle/Tv, Music & Streaming",Audible ,Expense,Leisure & Lifestyle,"Tv, Music & Streaming",26,0,2564,DR
14/2/2020,YMCA /Expense/Personal/Fitness & Wellbeing,YMCA ,Expense,Personal,Fitness & Wellbeing,119,0,2445,DR
14/2/2020,"EB Games /Expense/Leisure & Lifestyle/Apps, Games & Software",EB Games ,Expense,Leisure & Lifestyle,"Apps, Games & Software",211,0,2234,DR
16/2/2020,"JAX Tyres /Expense/Transport/Car Insurance, Rego & Maintenance",JAX Tyres ,Expense,Transport,"Car Insurance, Rego & Maintenance",199,0,2035,DR
17/2/2020,"Repco /Expense/Transport/Car Insurance, Rego & Maintenance",Repco ,Expense,Transport,"Car Insurance, Rego & Maintenance",92,0,1943,DR
18/2/2020,Music Academy /Expense/Leisure & Lifestyle/Hobbies,Music Academy ,Expense,Leisure & Lifestyle,Hobbies,105,0,1838,DR
18/2/2020,Child Support Agency Deposit /Income/Income/Other Income,Child Support Agency Deposit ,Income,Income,Other Income,29,0,1809,DR
18/2/2020,Big W /Expense/Personal/Children & Family,Big W ,Expense,Personal,Children & Family,136,0,1673,DR
19/2/2020,Taronga Zoo /Expense/Leisure & Lifestyle/Entertainment,Taronga Zoo ,Expense,Leisure & Lifestyle,Entertainment,69,0,1604,DR
19/2/2020,Ballet Schools /Expense/Personal/Fitness & Wellbeing,Ballet Schools ,Expense,Personal,Fitness & Wellbeing,157,0,1447,DR
19/2/2020,Tennis Australia /Expense/Personal/Fitness & Wellbeing,Tennis Australia ,Expense,Personal,Fitness & Wellbeing,35,0,1412,DR
19/2/2020, Jim's Mowing /Expense/Household/Maintenance & Improvements, Jim's Mowing ,Expense,Household,Maintenance & Improvements,118,0,1294,DR
19/2/2020,Myer /Expense/Personal/Clothing & Accessories,Myer ,Expense,Personal,Clothing & Accessories,97,0,1197,DR
20/2/2020,Liquorland /Expense/Leisure & Lifestyle/Alcohol,Liquorland ,Expense,Leisure & Lifestyle,Alcohol,120,0,1077,DR
20/2/2020, Meriton Apartments /Expense/Household/Rates & Insurance, Meriton Apartments ,Expense,Household,Rates & Insurance,28,0,1049,DR
20/2/2020,Jetts Fitness /Expense/Personal/Fitness & Wellbeing,Jetts Fitness ,Expense,Personal,Fitness & Wellbeing,47,0,1002,DR
21/2/2020, Rentokil /Expense/Household/Maintenance & Improvements, Rentokil ,Expense,Household,Maintenance & Improvements,23,0,979,DR
21/2/2020,Officeworks /Expense/Personal/Life Admin,Officeworks ,Expense,Personal,Life Admin,52,0,927,DR
21/2/2020,ABC Reading Eggs /Expense/Personal/Education,ABC Reading Eggs ,Expense,Personal,Education,57,0,870,DR
22/2/2020,Westpac Dividend Deposit /Income/Income/Investments,Westpac Dividend Deposit ,Income,Income,Investments,17,0,853,DR
23/2/2020,"Adairs /Expense/Household/Furniture, Electronics & Homewares",Adairs ,Expense,Household,"Furniture, Electronics & Homewares",72,0,781,DR
24/2/2020,OfficeMax /Expense/Personal/Life Admin,OfficeMax ,Expense,Personal,Life Admin,61,0,720,DR
25/2/2020,ABC Reading Eggs /Expense/Personal/Education,ABC Reading Eggs ,Expense,Personal,Education,34,0,686,DR
26/2/2020,Dan Murphy’s /Expense/Leisure & Lifestyle/Alcohol,Dan Murphy’s ,Expense,Leisure & Lifestyle,Alcohol,20,0,666,DR
26/2/2020,Culture Kings /Expense/Personal/Clothing & Accessories,Culture Kings ,Expense,Personal,Clothing & Accessories,50,0,616,DR
28/2/2020,PayPal Transfer from Sale /Income/Income/Other Income,PayPal Transfer from Sale ,Income,Income,Other Income,19,0,597,DR
1/3/2020,Monthly Income,Monthly Income,Income,Income,Wages,0,6000,6597,CR
3/3/2020,The Espy /Expense/Leisure & Lifestyle/Pubs & Bars,The Espy ,Expense,Leisure & Lifestyle,Pubs & Bars,60,0,6537,DR
3/3/2020,Medicare Claim /Expense/Personal/Health & Medical,Medicare Claim ,Expense,Personal,Health & Medical,309,0,6228,DR
3/3/2020,"EB Games /Expense/Leisure & Lifestyle/Apps, Games & Software",EB Games ,Expense,Leisure & Lifestyle,"Apps, Games & Software",357,0,5871,DR
4/3/2020,Centrelink JobSeeker Payment /Income/Income/Other Income,Centrelink JobSeeker Payment ,Income,Income,Other Income,39,0,5832,DR
4/3/2020,Ice Cream Parlour /Expense/Leisure & Lifestyle/Takeaway,Ice Cream Parlour ,Expense,Leisure & Lifestyle,Takeaway,312,0,5520,DR
4/3/2020,The Espy /Expense/Leisure & Lifestyle/Pubs & Bars,The Espy ,Expense,Leisure & Lifestyle,Pubs & Bars,97,0,5423,DR
5/3/2020,Pizza Hut /Expense/Leisure & Lifestyle/Takeaway,Pizza Hut ,Expense,Leisure & Lifestyle,Takeaway,353,0,5070,DR
7/3/2020,Campion Education /Expense/Personal/Children & Family,Campion Education ,Expense,Personal,Children & Family,192,0,4878,DR
7/3/2020,G8 Education /Expense/Personal/Children & Family,G8 Education ,Expense,Personal,Children & Family,196,0,4682,DR
7/3/2020,Massage Therapy Center /Expense/Personal/Health & Medical,Massage Therapy Center ,Expense,Personal,Health & Medical,390,0,4292,DR
8/3/2020,"Car Wash Cafe /Expense/Transport/Car Insurance, Rego & Maintenance",Car Wash Cafe ,Expense,Transport,"Car Insurance, Rego & Maintenance",418,0,3874,DR
8/3/2020,Sylvan Learning /Expense/Personal/Education,Sylvan Learning ,Expense,Personal,Education,371,0,3503,DR
9/3/2020,Target /Expense/Personal/Clothing & Accessories,Target ,Expense,Personal,Clothing & Accessories,342,0,3161,DR
9/3/2020,Myer /Expense/Personal/Clothing & Accessories,Myer ,Expense,Personal,Clothing & Accessories,14,0,3147,DR
9/3/2020,"Kmart Tyre & Auto Service /Expense/Transport/Car Insurance, Rego & Maintenance",Kmart Tyre & Auto Service ,Expense,Transport,"Car Insurance, Rego & Maintenance",261,0,2886,DR
9/3/2020,Optometrist /Expense/Personal/Health & Medical,Optometrist ,Expense,Personal,Health & Medical,14,0,2872,DR
10/3/2020,Petbarn /Expense/Household/Pets,Petbarn ,Expense,Household,Pets,283,0,2589,DR
12/3/2020,Decathlon /Expense/Personal/Fitness & Wellbeing,Decathlon ,Expense,Personal,Fitness & Wellbeing,133,0,2456,DR
12/3/2020,AustralianSuper Pension /Income/Income/Other Income,AustralianSuper Pension ,Income,Income,Other Income,63,0,2393,DR
13/3/2020,Beacon Lighting /Expense/Household/Maintenance & Improvements,Beacon Lighting ,Expense,Household,Maintenance & Improvements,110,0,2283,DR
13/3/2020,McDonald’s /Expense/Leisure & Lifestyle/Takeaway,McDonald’s ,Expense,Leisure & Lifestyle,Takeaway,7,0,2276,DR
14/3/2020,"Bridgestone Select /Expense/Transport/Car Insurance, Rego & Maintenance",Bridgestone Select ,Expense,Transport,"Car Insurance, Rego & Maintenance",227,0,2049,DR
14/3/2020,Flight Centre /Expense/Leisure & Lifestyle/Holidays & Travel,Flight Centre ,Expense,Leisure & Lifestyle,Holidays & Travel,98,0,1951,DR
14/3/2020,Sydney Water /Expense/Household/Utilities,Sydney Water ,Expense,Household,Utilities,139,0,1812,DR
15/3/2020,"JAX Tyres /Expense/Transport/Car Insurance, Rego & Maintenance",JAX Tyres ,Expense,Transport,"Car Insurance, Rego & Maintenance",49,0,1763,DR
16/3/2020,"The Good Guys /Expense/Household/Furniture, Electronics & Homewares",The Good Guys ,Expense,Household,"Furniture, Electronics & Homewares",47,0,1716,DR
17/3/2020,Karate for Kids /Expense/Personal/Fitness & Wellbeing,Karate for Kids ,Expense,Personal,Fitness & Wellbeing,84,0,1632,DR
17/3/2020,ALDI /Expense/Household/Groceries,ALDI ,Expense,Household,Groceries,146,0,1486,DR
17/3/2020,Goodstart Early Learning /Expense/Personal/Children & Family,Goodstart Early Learning ,Expense,Personal,Children & Family,82,0,1404,DR
17/3/2020,Uber /Expense/Transport/Taxies & Share Cars,Uber ,Expense,Transport,Taxies & Share Cars,50,0,1354,DR
17/3/2020,ABC Reading Eggs /Expense/Personal/Education,ABC Reading Eggs ,Expense,Personal,Education,87,0,1267,DR
18/3/2020,"MyCar Tyre & Auto /Expense/Transport/Car Insurance, Rego & Maintenance",MyCar Tyre & Auto ,Expense,Transport,"Car Insurance, Rego & Maintenance",117,0,1150,DR
18/3/2020,Decathlon /Expense/Personal/Fitness & Wellbeing,Decathlon ,Expense,Personal,Fitness & Wellbeing,116,0,1034,DR
18/3/2020,King Swim /Expense/Personal/Fitness & Wellbeing,King Swim ,Expense,Personal,Fitness & Wellbeing,80,0,954,DR
20/3/2020,Target /Expense/Personal/Clothing & Accessories,Target ,Expense,Personal,Clothing & Accessories,83,0,871,DR
20/3/2020,ABC Reading Eggs /Expense/Personal/Education,ABC Reading Eggs ,Expense,Personal,Education,13,0,858,DR
21/3/2020,Upwork Freelancer Payment /Income/Income/Other Income,Upwork Freelancer Payment ,Income,Income,Other Income,41,0,817,DR
22/3/2020,Surfstitch /Expense/Personal/Clothing & Accessories,Surfstitch ,Expense,Personal,Clothing & Accessories,76,0,741,DR
22/3/2020,"Ultra Tune /Expense/Transport/Car Insurance, Rego & Maintenance",Ultra Tune ,Expense,Transport,"Car Insurance, Rego & Maintenance",37,0,704,DR
22/3/2020,QBE Insurance Claim Payout /Income/Income/Other Income,QBE Insurance Claim Payout ,Income,Income,Other Income,65,0,639,DR
22/3/2020,"Kayo Sports /Expense/Leisure & Lifestyle/Tv, Music & Streaming",Kayo Sports ,Expense,Leisure & Lifestyle,"Tv, Music & Streaming",38,0,601,DR
23/3/2020,"Barbeques Galore /Expense/Household/Furniture, Electronics & Homewares",Barbeques Galore ,Expense,Household,"Furniture, Electronics & Homewares",8,0,593,DR
23/3/2020,"Adairs /Expense/Household/Furniture, Electronics & Homewares",Adairs ,Expense,Household,"Furniture, Electronics & Homewares",46,0,547,DR
23/3/2020,Fitness First /Expense/Personal/Fitness & Wellbeing,Fitness First ,Expense,Personal,Fitness & Wellbeing,14,0,533,DR
23/3/2020,Harris Farm Markets /Expense/Household/Groceries,Harris Farm Markets ,Expense,Household,Groceries,46,0,487,DR
23/3/2020,Beachside Caravan Park /Expense/Leisure & Lifestyle/Holidays & Travel,Beachside Caravan Park ,Expense,Leisure & Lifestyle,Holidays & Travel,26,0,461,DR
24/3/2020,"VicRoads /Expense/Transport/Car Insurance, Rego & Maintenance",VicRoads ,Expense,Transport,"Car Insurance, Rego & Maintenance",30,0,431,DR
25/3/2020,Muffin Break /Expense/Leisure & Lifestyle/Restaurants & Cafes,Muffin Break ,Expense,Leisure & Lifestyle,Restaurants & Cafes,16,0,415,DR
25/3/2020,AMF Bowling /Expense/Leisure & Lifestyle/Entertainment,AMF Bowling ,Expense,Leisure & Lifestyle,Entertainment,24,0,391,DR
26/3/2020,Queensland Urban Utilities /Expense/Household/Utilities,Queensland Urban Utilities ,Expense,Household,Utilities,36,0,355,DR
26/3/2020,Zarraffa's Coffee /Expense/Leisure & Lifestyle/Restaurants & Cafes,Zarraffa's Coffee ,Expense,Leisure & Lifestyle,Restaurants & Cafes,14,0,341,DR
27/3/2020,Payday Advance /Income/Income/Other Income,Payday Advance ,Income,Income,Other Income,32,0,309,DR
27/3/2020,The Victory Hotel /Expense/Leisure & Lifestyle/Pubs & Bars,The Victory Hotel ,Expense,Leisure & Lifestyle,Pubs & Bars,25,0,284,DR
27/3/2020,Swim Australia /Expense/Personal/Fitness & Wellbeing,Swim Australia ,Expense,Personal,Fitness & Wellbeing,25,0,259,DR
27/3/2020,SEQTA /Expense/Personal/Education,SEQTA ,Expense,Personal,Education,10,0,249,DR
1/4/2020,Monthly Income,Monthly Income,Income,Income,Wages,0,6000,6249,CR
2/4/2020,Eau De Vie /Expense/Leisure & Lifestyle/Pubs & Bars,Eau De Vie ,Expense,Leisure & Lifestyle,Pubs & Bars,197,0,6052,DR
2/4/2020,Coles Express /Expense/Transport/Fuel,Coles Express ,Expense,Transport,Fuel,229,0,5823,DR
3/4/2020,Country Road /Expense/Personal/Clothing & Accessories,Country Road ,Expense,Personal,Clothing & Accessories,90,0,5733,DR
4/4/2020,ALDI /Expense/Household/Groceries,ALDI ,Expense,Household,Groceries,147,0,5586,DR
4/4/2020,Tennis Australia /Expense/Personal/Fitness & Wellbeing,Tennis Australia ,Expense,Personal,Fitness & Wellbeing,387,0,5199,DR
5/4/2020,Officeworks /Expense/Personal/Life Admin,Officeworks ,Expense,Personal,Life Admin,269,0,4930,DR
5/4/2020,"EB Games /Expense/Leisure & Lifestyle/Apps, Games & Software",EB Games ,Expense,Leisure & Lifestyle,"Apps, Games & Software",435,0,4495,DR
6/4/2020,Ladbrokes /Expense/Leisure & Lifestyle/Lottery & Gambling,Ladbrokes ,Expense,Leisure & Lifestyle,Lottery & Gambling,39,0,4456,DR
7/4/2020,Swim Australia /Expense/Personal/Fitness & Wellbeing,Swim Australia ,Expense,Personal,Fitness & Wellbeing,423,0,4033,DR
7/4/2020,"NRMA Roadside Assistance /Expense/Transport/Car Insurance, Rego & Maintenance",NRMA Roadside Assistance ,Expense,Transport,"Car Insurance, Rego & Maintenance",327,0,3706,DR
8/4/2020,The Iconic /Expense/Personal/Clothing & Accessories,The Iconic ,Expense,Personal,Clothing & Accessories,220,0,3486,DR
9/4/2020,Ladbrokes /Expense/Leisure & Lifestyle/Lottery & Gambling,Ladbrokes ,Expense,Leisure & Lifestyle,Lottery & Gambling,38,0,3448,DR
9/4/2020,Quay Restaurant /Expense/Leisure & Lifestyle/Pubs & Bars,Quay Restaurant ,Expense,Leisure & Lifestyle,Pubs & Bars,324,0,3124,DR
9/4/2020,ABC Reading Eggs /Expense/Personal/Education,ABC Reading Eggs ,Expense,Personal,Education,156,0,2968,DR
9/4/2020,Café Nero /Expense/Leisure & Lifestyle/Restaurants & Cafes,Café Nero ,Expense,Leisure & Lifestyle,Restaurants & Cafes,71,0,2897,DR
10/4/2020,The Victory Hotel /Expense/Leisure & Lifestyle/Pubs & Bars,The Victory Hotel ,Expense,Leisure & Lifestyle,Pubs & Bars,31,0,2866,DR
10/4/2020,Mathnasium /Expense/Personal/Education,Mathnasium ,Expense,Personal,Education,172,0,2694,DR
11/4/2020,Westpac Dividend Deposit /Income/Income/Investments,Westpac Dividend Deposit ,Income,Income,Investments,53,0,2641,DR
12/4/2020,"Adairs /Expense/Household/Furniture, Electronics & Homewares",Adairs ,Expense,Household,"Furniture, Electronics & Homewares",162,0,2479,DR
12/4/2020,Spotlight /Expense/Leisure & Lifestyle/Hobbies,Spotlight ,Expense,Leisure & Lifestyle,Hobbies,214,0,2265,DR
12/4/2020,Karate for Kids /Expense/Personal/Fitness & Wellbeing,Karate for Kids ,Expense,Personal,Fitness & Wellbeing,68,0,2197,DR
13/4/2020,AustralianSuper Pension /Income/Income/Other Income,AustralianSuper Pension ,Income,Income,Other Income,34,0,2163,DR
14/4/2020,Woolworths /Expense/Household/Groceries,Woolworths ,Expense,Household,Groceries,54,0,2109,DR
15/4/2020,Dan Murphy’s /Expense/Leisure & Lifestyle/Alcohol,Dan Murphy’s ,Expense,Leisure & Lifestyle,Alcohol,188,0,1921,DR
15/4/2020,Acupuncture Clinic /Expense/Personal/Health & Medical,Acupuncture Clinic ,Expense,Personal,Health & Medical,139,0,1782,DR
16/4/2020,Melbourne Central Lion Hotel /Expense/Leisure & Lifestyle/Pubs & Bars,Melbourne Central Lion Hotel ,Expense,Leisure & Lifestyle,Pubs & Bars,148,0,1634,DR
17/4/2020,Beach Café /Expense/Leisure & Lifestyle/Restaurants & Cafes,Beach Café ,Expense,Leisure & Lifestyle,Restaurants & Cafes,23,0,1611,DR
17/4/2020,Pizza Hut /Expense/Leisure & Lifestyle/Takeaway,Pizza Hut ,Expense,Leisure & Lifestyle,Takeaway,88,0,1523,DR
18/4/2020,The Baxter Inn /Expense/Leisure & Lifestyle/Pubs & Bars,The Baxter Inn ,Expense,Leisure & Lifestyle,Pubs & Bars,40,0,1483,DR
18/4/2020,Acupuncture Clinic /Expense/Personal/Health & Medical,Acupuncture Clinic ,Expense,Personal,Health & Medical,144,0,1339,DR
18/4/2020,Lorna Jane /Expense/Personal/Clothing & Accessories,Lorna Jane ,Expense,Personal,Clothing & Accessories,18,0,1321,DR
18/4/2020,Coles /Expense/Household/Groceries,Coles ,Expense,Household,Groceries,88,0,1233,DR
19/4/2020,David Jones /Expense/Personal/Clothing & Accessories,David Jones ,Expense,Personal,Clothing & Accessories,82,0,1151,DR
19/4/2020,"Stan /Expense/Leisure & Lifestyle/Tv, Music & Streaming",Stan ,Expense,Leisure & Lifestyle,"Tv, Music & Streaming",115,0,1036,DR
21/4/2020,BWS /Expense/Leisure & Lifestyle/Alcohol,BWS ,Expense,Leisure & Lifestyle,Alcohol,81,0,955,DR
21/4/2020,"JAX Tyres /Expense/Transport/Car Insurance, Rego & Maintenance",JAX Tyres ,Expense,Transport,"Car Insurance, Rego & Maintenance",93,0,862,DR
22/4/2020,SEQTA /Expense/Personal/Education,SEQTA ,Expense,Personal,Education,9,0,853,DR
23/4/2020,Kumon /Expense/Personal/Education,Kumon ,Expense,Personal,Education,82,0,771,DR
23/4/2020,Acupuncture Clinic /Expense/Personal/Health & Medical,Acupuncture Clinic ,Expense,Personal,Health & Medical,53,0,718,DR
23/4/2020,Guardian Childcare & Education /Expense/Personal/Children & Family,Guardian Childcare & Education ,Expense,Personal,Children & Family,23,0,695,DR
24/4/2020,Sylvan Learning /Expense/Personal/Education,Sylvan Learning ,Expense,Personal,Education,57,0,638,DR
25/4/2020,SEQTA /Expense/Personal/Education,SEQTA ,Expense,Personal,Education,24,0,614,DR
26/4/2020,McDonald’s /Expense/Leisure & Lifestyle/Takeaway,McDonald’s ,Expense,Leisure & Lifestyle,Takeaway,43,0,571,DR
26/4/2020,"The Good Guys /Expense/Household/Furniture, Electronics & Homewares",The Good Guys ,Expense,Household,"Furniture, Electronics & Homewares",55,0,516,DR
26/4/2020,Sea Kayak Tours /Expense/Leisure & Lifestyle/Holidays & Travel,Sea Kayak Tours ,Expense,Leisure & Lifestyle,Holidays & Travel,52,0,464,DR
26/4/2020, Commonwealth Bank /Expense/Household/Rent & Mortgage, Commonwealth Bank ,Expense,Household,Rent & Mortgage,13,0,451,DR
26/4/2020,The Ivy /Expense/Leisure & Lifestyle/Pubs & Bars,The Ivy ,Expense,Leisure & Lifestyle,Pubs & Bars,9,0,442,DR
27/4/2020,Sunburn Swimwear /Expense/Personal/Clothing & Accessories,Sunburn Swimwear ,Expense,Personal,Clothing & Accessories,14,0,428,DR
27/4/2020,T2 Tea /Expense/Personal/Fitness & Wellbeing,T2 Tea ,Expense,Personal,Fitness & Wellbeing,9,0,419,DR
1/5/2020,Monthly Income,Monthly Income,Income,Income,Wages,0,6000,6419,CR
3/5/2020,YMCA /Expense/Personal/Fitness & Wellbeing,YMCA ,Expense,Personal,Fitness & Wellbeing,306,0,6113,DR
3/5/2020,"MyCar Tyre & Auto /Expense/Transport/Car Insurance, Rego & Maintenance",MyCar Tyre & Auto ,Expense,Transport,"Car Insurance, Rego & Maintenance",182,0,5931,DR
5/5/2020,G8 Education /Expense/Personal/Children & Family,G8 Education ,Expense,Personal,Children & Family,309,0,5622,DR
7/5/2020,Event Cinemas /Expense/Leisure & Lifestyle/Entertainment,Event Cinemas ,Expense,Leisure & Lifestyle,Entertainment,214,0,5408,DR
8/5/2020,McDonald’s /Expense/Leisure & Lifestyle/Takeaway,McDonald’s ,Expense,Leisure & Lifestyle,Takeaway,164,0,5244,DR
10/5/2020,CommSec Share Trading Gains /Income/Income/Investments,CommSec Share Trading Gains ,Income,Income,Investments,350,0,4894,DR
11/5/2020,Flight Centre /Expense/Leisure & Lifestyle/Holidays & Travel,Flight Centre ,Expense,Leisure & Lifestyle,Holidays & Travel,385,0,4509,DR
13/5/2020,Shell V Power/Expense/Transport/Fuel,Shell V Power,Expense,Transport,Fuel,291,0,4218,DR
13/5/2020,The Body Shop /Expense/Personal/Hair & Beauty,The Body Shop ,Expense,Personal,Hair & Beauty,154,0,4064,DR
13/5/2020,EnergyAustralia /Expense/Household/Utilities,EnergyAustralia ,Expense,Household,Utilities,73,0,3991,DR
14/5/2020, Commonwealth Bank /Expense/Household/Rent & Mortgage, Commonwealth Bank ,Expense,Household,Rent & Mortgage,296,0,3695,DR
15/5/2020,"Kmart Tyre & Auto Service /Expense/Transport/Car Insurance, Rego & Maintenance",Kmart Tyre & Auto Service ,Expense,Transport,"Car Insurance, Rego & Maintenance",251,0,3444,DR
16/5/2020, Metricon /Expense/Household/Maintenance & Improvements, Metricon ,Expense,Household,Maintenance & Improvements,261,0,3183,DR
16/5/2020,"NRMA Roadside Assistance /Expense/Transport/Car Insurance, Rego & Maintenance",NRMA Roadside Assistance ,Expense,Transport,"Car Insurance, Rego & Maintenance",278,0,2905,DR
16/5/2020,Melbourne Central Lion Hotel /Expense/Leisure & Lifestyle/Pubs & Bars,Melbourne Central Lion Hotel ,Expense,Leisure & Lifestyle,Pubs & Bars,72,0,2833,DR
17/5/2020,"Netflix /Expense/Leisure & Lifestyle/Tv, Music & Streaming",Netflix ,Expense,Leisure & Lifestyle,"Tv, Music & Streaming",23,0,2810,DR
18/5/2020,Local Hospital /Expense/Personal/Health & Medical,Local Hospital ,Expense,Personal,Health & Medical,235,0,2575,DR
19/5/2020,Target /Expense/Personal/Clothing & Accessories,Target ,Expense,Personal,Clothing & Accessories,185,0,2390,DR
20/5/2020,The Victory Hotel /Expense/Leisure & Lifestyle/Pubs & Bars,The Victory Hotel ,Expense,Leisure & Lifestyle,Pubs & Bars,45,0,2345,DR
21/5/2020,Surf Dive 'n Ski /Expense/Personal/Clothing & Accessories,Surf Dive 'n Ski ,Expense,Personal,Clothing & Accessories,188,0,2157,DR
21/5/2020,ABC Reading Eggs /Expense/Personal/Education,ABC Reading Eggs ,Expense,Personal,Education,169,0,1988,DR
22/5/2020,Guzman y Gomez /Expense/Leisure & Lifestyle/Takeaway,Guzman y Gomez ,Expense,Leisure & Lifestyle,Takeaway,121,0,1867,DR
22/5/2020,The Sydney Morning Herald /Expense/Personal/Education,The Sydney Morning Herald ,Expense,Personal,Education,143,0,1724,DR
22/5/2020,Hungry Jack’s /Expense/Leisure & Lifestyle/Takeaway,Hungry Jack’s ,Expense,Leisure & Lifestyle,Takeaway,160,0,1564,DR
24/5/2020,Palace Cinemas /Expense/Leisure & Lifestyle/Entertainment,Palace Cinemas ,Expense,Leisure & Lifestyle,Entertainment,17,0,1547,DR
25/5/2020,"Service NSW /Expense/Transport/Car Insurance, Rego & Maintenance",Service NSW ,Expense,Transport,"Car Insurance, Rego & Maintenance",65,0,1482,DR
27/5/2020,Medicare Claim /Expense/Personal/Health & Medical,Medicare Claim ,Expense,Personal,Health & Medical,85,0,1397,DR
27/5/2020,Vodafone Prepaid /Expense/Personal/Mobile Phone,Vodafone Prepaid ,Expense,Personal,Mobile Phone,55,0,1342,DR
28/5/2020,"The Good Guys /Expense/Household/Furniture, Electronics & Homewares",The Good Guys ,Expense,Household,"Furniture, Electronics & Homewares",82,0,1260,DR
28/5/2020,"Autobarn /Expense/Transport/Car Insurance, Rego & Maintenance",Autobarn ,Expense,Transport,"Car Insurance, Rego & Maintenance",28,0,1232,DR
1/6/2020,Monthly Income,Monthly Income,Income,Income,Wages,0,6000,7232,CR
2/6/2020,"Ultra Tune /Expense/Transport/Car Insurance, Rego & Maintenance",Ultra Tune ,Expense,Transport,"Car Insurance, Rego & Maintenance",69,0,7163,DR
4/6/2020,"Supercheap Auto /Expense/Transport/Car Insurance, Rego & Maintenance",Supercheap Auto ,Expense,Transport,"Car Insurance, Rego & Maintenance",571,0,6592,DR
6/6/2020,Quay Restaurant /Expense/Leisure & Lifestyle/Pubs & Bars,Quay Restaurant ,Expense,Leisure & Lifestyle,Pubs & Bars,249,0,6343,DR
7/6/2020,Chiropractor /Expense/Personal/Health & Medical,Chiropractor ,Expense,Personal,Health & Medical,445,0,5898,DR
8/6/2020,Westpac Dividend Deposit /Income/Income/Investments,Westpac Dividend Deposit ,Income,Income,Investments,412,0,5486,DR
11/6/2020,Sea Kayak Tours /Expense/Leisure & Lifestyle/Holidays & Travel,Sea Kayak Tours ,Expense,Leisure & Lifestyle,Holidays & Travel,155,0,5331,DR
15/6/2020,Crown Perth /Expense/Leisure & Lifestyle/Pubs & Bars,Crown Perth ,Expense,Leisure & Lifestyle,Pubs & Bars,204,0,5127,DR
16/6/2020,Medicare Claim /Expense/Personal/Health & Medical,Medicare Claim ,Expense,Personal,Health & Medical,145,0,4982,DR
17/6/2020,Dental Clinic /Expense/Personal/Health & Medical,Dental Clinic ,Expense,Personal,Health & Medical,256,0,4726,DR
18/6/2020,Culture Kings /Expense/Personal/Clothing & Accessories,Culture Kings ,Expense,Personal,Clothing & Accessories,407,0,4319,DR
18/6/2020,Tennis Australia /Expense/Personal/Fitness & Wellbeing,Tennis Australia ,Expense,Personal,Fitness & Wellbeing,277,0,4042,DR
18/6/2020,The Iconic /Expense/Personal/Clothing & Accessories,The Iconic ,Expense,Personal,Clothing & Accessories,88,0,3954,DR
19/6/2020,Queensland Urban Utilities /Expense/Household/Utilities,Queensland Urban Utilities ,Expense,Household,Utilities,338,0,3616,DR
19/6/2020,Chiropractor /Expense/Personal/Health & Medical,Chiropractor ,Expense,Personal,Health & Medical,219,0,3397,DR
20/6/2020,SEQTA /Expense/Personal/Education,SEQTA ,Expense,Personal,Education,68,0,3329,DR
21/6/2020,Sea Kayak Tours /Expense/Leisure & Lifestyle/Holidays & Travel,Sea Kayak Tours ,Expense,Leisure & Lifestyle,Holidays & Travel,32,0,3297,DR
24/6/2020,PayPal Transfer from Sale /Income/Income/Other Income,PayPal Transfer from Sale ,Income,Income,Other Income,130,0,3167,DR
25/6/2020,Beachfront Markets /Expense/Personal/Clothing & Accessories,Beachfront Markets ,Expense,Personal,Clothing & Accessories,234,0,2933,DR
26/6/2020, Ray White Real Estate /Expense/Personal/Life Admin, Ray White Real Estate ,Expense,Personal,Life Admin,269,0,2664,DR
28/6/2020,Upwork Freelancer Payment /Income/Income/Other Income,Upwork Freelancer Payment ,Income,Income,Other Income,95,0,2569,DR
28/6/2020,Apple Store /Expense/Leisure & Lifestyle/Electronics,Apple Store ,Expense,Leisure & Lifestyle,Electronics,198,0,2371,DR
28/6/2020,Gardening Australia /Expense/Household/Maintenance & Improvements,Gardening Australia ,Expense,Household,Maintenance & Improvements,93,0,2278,DR
28/6/2020,"JAX Tyres /Expense/Transport/Car Insurance, Rego & Maintenance",JAX Tyres ,Expense,Transport,"Car Insurance, Rego & Maintenance",128,0,2150,DR
1/7/2020,Monthly Income,Monthly Income,Income,Income,Wages,0,6000,8150,CR
2/7/2020,Coles Express /Expense/Transport/Fuel,Coles Express ,Expense,Transport,Fuel,45,0,8105,DR
2/7/2020,ATO Tax Refund /Income/Income/Other Income,ATO Tax Refund ,Income,Income,Other Income,748,0,7357,DR
2/7/2020,Palace Cinemas /Expense/Leisure & Lifestyle/Entertainment,Palace Cinemas ,Expense,Leisure & Lifestyle,Entertainment,476,0,6881,DR
2/7/2020,Jetts Fitness /Expense/Personal/Fitness & Wellbeing,Jetts Fitness ,Expense,Personal,Fitness & Wellbeing,279,0,6602,DR
3/7/2020,"Kayo Sports /Expense/Leisure & Lifestyle/Tv, Music & Streaming",Kayo Sports ,Expense,Leisure & Lifestyle,"Tv, Music & Streaming",455,0,6147,DR
3/7/2020, Jim's Mowing /Expense/Household/Maintenance & Improvements, Jim's Mowing ,Expense,Household,Maintenance & Improvements,296,0,5851,DR
4/7/2020,F45 Training /Expense/Personal/Fitness & Wellbeing,F45 Training ,Expense,Personal,Fitness & Wellbeing,82,0,5769,DR
4/7/2020,Booktopia /Expense/Leisure & Lifestyle/Hobbies,Booktopia ,Expense,Leisure & Lifestyle,Hobbies,203,0,5566,DR
4/7/2020,Jetts Fitness /Expense/Personal/Fitness & Wellbeing,Jetts Fitness ,Expense,Personal,Fitness & Wellbeing,313,0,5253,DR
5/7/2020,Centrelink JobSeeker Payment /Income/Income/Other Income,Centrelink JobSeeker Payment ,Income,Income,Other Income,354,0,4899,DR
8/7/2020,Taronga Zoo /Expense/Leisure & Lifestyle/Entertainment,Taronga Zoo ,Expense,Leisure & Lifestyle,Entertainment,243,0,4656,DR
8/7/2020,Guzman y Gomez /Expense/Leisure & Lifestyle/Takeaway,Guzman y Gomez ,Expense,Leisure & Lifestyle,Takeaway,173,0,4483,DR
8/7/2020,Airbnb Host Income /Income/Income/Other Income,Airbnb Host Income ,Income,Income,Other Income,350,0,4133,DR
9/7/2020,ABC Reading Eggs /Expense/Personal/Education,ABC Reading Eggs ,Expense,Personal,Education,274,0,3859,DR
9/7/2020," The Good Guys /Expense/Household/Furniture, Electronics & Homewares", The Good Guys ,Expense,Household,"Furniture, Electronics & Homewares",304,0,3555,DR
11/7/2020,Petbarn /Expense/Household/Pets,Petbarn ,Expense,Household,Pets,314,0,3241,DR
11/7/2020,Catholic Education Office /Expense/Personal/Education,Catholic Education Office ,Expense,Personal,Education,291,0,2950,DR
11/7/2020,"Spotify /Expense/Leisure & Lifestyle/Tv, Music & Streaming",Spotify ,Expense,Leisure & Lifestyle,"Tv, Music & Streaming",144,0,2806,DR
14/7/2020, Rentokil /Expense/Household/Maintenance & Improvements, Rentokil ,Expense,Household,Maintenance & Improvements,191,0,2615,DR
14/7/2020,Endota Spa /Expense/Personal/Fitness & Wellbeing,Endota Spa ,Expense,Personal,Fitness & Wellbeing,243,0,2372,DR
14/7/2020,Swim Australia /Expense/Personal/Fitness & Wellbeing,Swim Australia ,Expense,Personal,Fitness & Wellbeing,218,0,2154,DR
17/7/2020,Queensland Urban Utilities /Expense/Household/Utilities,Queensland Urban Utilities ,Expense,Household,Utilities,101,0,2053,DR
18/7/2020,Greencross Vets /Expense/Household/Pets,Greencross Vets ,Expense,Household,Pets,61,0,1992,DR
18/7/2020,T2 Tea /Expense/Personal/Fitness & Wellbeing,T2 Tea ,Expense,Personal,Fitness & Wellbeing,65,0,1927,DR
19/7/2020,Catholic Education Office /Expense/Personal/Education,Catholic Education Office ,Expense,Personal,Education,71,0,1856,DR
21/7/2020,The Ivy /Expense/Leisure & Lifestyle/Pubs & Bars,The Ivy ,Expense,Leisure & Lifestyle,Pubs & Bars,89,0,1767,DR
22/7/2020,Country Road /Expense/Personal/Clothing & Accessories,Country Road ,Expense,Personal,Clothing & Accessories,91,0,1676,DR
23/7/2020,Ballet Schools /Expense/Personal/Fitness & Wellbeing,Ballet Schools ,Expense,Personal,Fitness & Wellbeing,165,0,1511,DR
23/7/2020,Origin Energy /Expense/Household/Utilities,Origin Energy ,Expense,Household,Utilities,47,0,1464,DR
23/7/2020,Flight Centre /Expense/Leisure & Lifestyle/Holidays & Travel,Flight Centre ,Expense,Leisure & Lifestyle,Holidays & Travel,106,0,1358,DR
26/7/2020, EnergyAustralia /Expense/Household/Utilities, EnergyAustralia ,Expense,Household,Utilities,48,0,1310,DR
26/7/2020,Harris Farm Markets /Expense/Household/Groceries,Harris Farm Markets ,Expense,Household,Groceries,98,0,1212,DR
26/7/2020,Apple Store /Expense/Leisure & Lifestyle/Electronics,Apple Store ,Expense,Leisure & Lifestyle,Electronics,92,0,1120,DR
28/7/2020,Pizza Hut /Expense/Leisure & Lifestyle/Takeaway,Pizza Hut ,Expense,Leisure & Lifestyle,Takeaway,77,0,1043,DR
28/7/2020,"Stan /Expense/Leisure & Lifestyle/Tv, Music & Streaming",Stan ,Expense,Leisure & Lifestyle,"Tv, Music & Streaming",41,0,1002,DR
1/8/2020,Monthly Income,Monthly Income,Income,Income,Wages,0,6000,7002,CR
2/8/2020,Priceline Pharmacy /Expense/Personal/Health & Medical,Priceline Pharmacy ,Expense,Personal,Health & Medical,274,0,6728,DR
2/8/2020,T2 Tea /Expense/Personal/Fitness & Wellbeing,T2 Tea ,Expense,Personal,Fitness & Wellbeing,32,0,6696,DR
2/8/2020,Karate for Kids /Expense/Personal/Fitness & Wellbeing,Karate for Kids ,Expense,Personal,Fitness & Wellbeing,262,0,6434,DR
3/8/2020,Beachfront Markets /Expense/Personal/Clothing & Accessories,Beachfront Markets ,Expense,Personal,Clothing & Accessories,431,0,6003,DR
3/8/2020,Eat Street Northshore /Expense/Leisure & Lifestyle/Pubs & Bars,Eat Street Northshore ,Expense,Leisure & Lifestyle,Pubs & Bars,525,0,5478,DR
3/8/2020,Health Food Store /Expense/Personal/Fitness & Wellbeing,Health Food Store ,Expense,Personal,Fitness & Wellbeing,323,0,5155,DR
4/8/2020,Melbourne Central Lion Hotel /Expense/Leisure & Lifestyle/Pubs & Bars,Melbourne Central Lion Hotel ,Expense,Leisure & Lifestyle,Pubs & Bars,63,0,5092,DR
4/8/2020,Target /Expense/Personal/Clothing & Accessories,Target ,Expense,Personal,Clothing & Accessories,140,0,4952,DR
5/8/2020,Costco /Expense/Household/Groceries,Costco ,Expense,Household,Groceries,161,0,4791,DR
5/8/2020,David Jones /Expense/Personal/Clothing & Accessories,David Jones ,Expense,Personal,Clothing & Accessories,400,0,4391,DR
8/8/2020,Ice Cream Parlour /Expense/Leisure & Lifestyle/Takeaway,Ice Cream Parlour ,Expense,Leisure & Lifestyle,Takeaway,197,0,4194,DR
8/8/2020,AMF Bowling /Expense/Leisure & Lifestyle/Entertainment,AMF Bowling ,Expense,Leisure & Lifestyle,Entertainment,252,0,3942,DR
10/8/2020,Beachside Yoga Classes /Expense/Personal/Fitness & Wellbeing,Beachside Yoga Classes ,Expense,Personal,Fitness & Wellbeing,15,0,3927,DR
11/8/2020,"Netflix /Expense/Leisure & Lifestyle/Tv, Music & Streaming",Netflix ,Expense,Leisure & Lifestyle,"Tv, Music & Streaming",320,0,3607,DR
11/8/2020,"Repco /Expense/Transport/Car Insurance, Rego & Maintenance",Repco ,Expense,Transport,"Car Insurance, Rego & Maintenance",323,0,3284,DR
12/8/2020,Campion Education /Expense/Personal/Children & Family,Campion Education ,Expense,Personal,Children & Family,180,0,3104,DR
13/8/2020,The Athlete's Foot /Expense/Personal/Clothing & Accessories,The Athlete's Foot ,Expense,Personal,Clothing & Accessories,259,0,2845,DR
13/8/2020,The Iconic /Expense/Personal/Clothing & Accessories,The Iconic ,Expense,Personal,Clothing & Accessories,191,0,2654,DR
14/8/2020,Upwork Freelancer Payment /Income/Income/Other Income,Upwork Freelancer Payment ,Income,Income,Other Income,174,0,2480,DR
14/8/2020,Upwork Freelancer Payment /Income/Income/Other Income,Upwork Freelancer Payment ,Income,Income,Other Income,195,0,2285,DR
16/8/2020,Taronga Zoo /Expense/Leisure & Lifestyle/Entertainment,Taronga Zoo ,Expense,Leisure & Lifestyle,Entertainment,68,0,2217,DR
16/8/2020,"Barbeques Galore /Expense/Household/Furniture, Electronics & Homewares",Barbeques Galore ,Expense,Household,"Furniture, Electronics & Homewares",29,0,2188,DR
17/8/2020, Ray White Real Estate /Expense/Personal/Life Admin, Ray White Real Estate ,Expense,Personal,Life Admin,186,0,2002,DR
18/8/2020,Tabcorp /Expense/Leisure & Lifestyle/Lottery & Gambling,Tabcorp ,Expense,Leisure & Lifestyle,Lottery & Gambling,143,0,1859,DR
19/8/2020,The Rocks Bar and Pub /Expense/Leisure & Lifestyle/Pubs & Bars,The Rocks Bar and Pub ,Expense,Leisure & Lifestyle,Pubs & Bars,142,0,1717,DR
19/8/2020,JB HiFi/Expense/Leisure & Lifestyle/Electronics,JB HiFi,Expense,Leisure & Lifestyle,Electronics,147,0,1570,DR
21/8/2020,Greencross Vets /Expense/Household/Pets,Greencross Vets ,Expense,Household,Pets,65,0,1505,DR
22/8/2020,The Australian /Expense/Personal/Education,The Australian ,Expense,Personal,Education,102,0,1403,DR
22/8/2020,Sunnybank Hotel /Expense/Leisure & Lifestyle/Pubs & Bars,Sunnybank Hotel ,Expense,Leisure & Lifestyle,Pubs & Bars,29,0,1374,DR
23/8/2020,"Kmart Tyre & Auto Service /Expense/Transport/Car Insurance, Rego & Maintenance",Kmart Tyre & Auto Service ,Expense,Transport,"Car Insurance, Rego & Maintenance",61,0,1313,DR
25/8/2020,"Supercheap Auto /Expense/Transport/Car Insurance, Rego & Maintenance",Supercheap Auto ,Expense,Transport,"Car Insurance, Rego & Maintenance",65,0,1248,DR
26/8/2020,Telstra /Expense/Personal/Mobile Phone,Telstra ,Expense,Personal,Mobile Phone,67,0,1181,DR
27/8/2020,Harris Farm Markets /Expense/Household/Groceries,Harris Farm Markets ,Expense,Household,Groceries,19,0,1162,DR
27/8/2020,Pathology Lab /Expense/Personal/Health & Medical,Pathology Lab ,Expense,Personal,Health & Medical,110,0,1052,DR
27/8/2020,Upwork Freelancer Payment /Income/Income/Other Income,Upwork Freelancer Payment ,Income,Income,Other Income,47,0,1005,DR
27/8/2020,Flight Centre /Expense/Leisure & Lifestyle/Holidays & Travel,Flight Centre ,Expense,Leisure & Lifestyle,Holidays & Travel,60,0,945,DR
27/8/2020,Event Cinemas /Expense/Leisure & Lifestyle/Entertainment,Event Cinemas ,Expense,Leisure & Lifestyle,Entertainment,81,0,864,DR
28/8/2020,"Amazon Prime /Expense/Leisure & Lifestyle/Tv, Music & Streaming",Amazon Prime ,Expense,Leisure & Lifestyle,"Tv, Music & Streaming",37,0,827,DR
28/8/2020,Optometrist /Expense/Personal/Health & Medical,Optometrist ,Expense,Personal,Health & Medical,59,0,768,DR
1/9/2020,Monthly Income,Monthly Income,Income,Income,Wages,0,6000,6768,CR
2/9/2020,Surfstitch /Expense/Personal/Clothing & Accessories,Surfstitch ,Expense,Personal,Clothing & Accessories,329,0,6439,DR
3/9/2020," Fantastic Furniture /Expense/Household/Furniture, Electronics & Homewares", Fantastic Furniture ,Expense,Household,"Furniture, Electronics & Homewares",580,0,5859,DR
5/9/2020,Platypus Shoes /Expense/Personal/Clothing & Accessories,Platypus Shoes ,Expense,Personal,Clothing & Accessories,95,0,5764,DR
6/9/2020,Grill'd /Expense/Leisure & Lifestyle/Takeaway,Grill'd ,Expense,Leisure & Lifestyle,Takeaway,208,0,5556,DR
8/9/2020,The Sydney Morning Herald /Expense/Personal/Education,The Sydney Morning Herald ,Expense,Personal,Education,534,0,5022,DR
9/9/2020,Hungry Jack’s /Expense/Leisure & Lifestyle/Takeaway,Hungry Jack’s ,Expense,Leisure & Lifestyle,Takeaway,160,0,4862,DR
9/9/2020,"JAX Tyres /Expense/Transport/Car Insurance, Rego & Maintenance",JAX Tyres ,Expense,Transport,"Car Insurance, Rego & Maintenance",335,0,4527,DR
9/9/2020,"Disney+ /Expense/Leisure & Lifestyle/Tv, Music & Streaming",Disney+ ,Expense,Leisure & Lifestyle,"Tv, Music & Streaming",348,0,4179,DR
10/9/2020,Beacon Lighting /Expense/Household/Maintenance & Improvements,Beacon Lighting ,Expense,Household,Maintenance & Improvements,349,0,3830,DR
11/9/2020,Taronga Zoo /Expense/Leisure & Lifestyle/Entertainment,Taronga Zoo ,Expense,Leisure & Lifestyle,Entertainment,297,0,3533,DR
12/9/2020,Endota Spa /Expense/Personal/Fitness & Wellbeing,Endota Spa ,Expense,Personal,Fitness & Wellbeing,320,0,3213,DR
12/9/2020,The Ivy /Expense/Leisure & Lifestyle/Pubs & Bars,The Ivy ,Expense,Leisure & Lifestyle,Pubs & Bars,78,0,3135,DR
12/9/2020,BWS /Expense/Leisure & Lifestyle/Alcohol,BWS ,Expense,Leisure & Lifestyle,Alcohol,211,0,2924,DR
12/9/2020,Kumon /Expense/Personal/Education,Kumon ,Expense,Personal,Education,102,0,2822,DR
13/9/2020,"Barbeques Galore /Expense/Household/Furniture, Electronics & Homewares",Barbeques Galore ,Expense,Household,"Furniture, Electronics & Homewares",271,0,2551,DR
13/9/2020,The Espy /Expense/Leisure & Lifestyle/Pubs & Bars,The Espy ,Expense,Leisure & Lifestyle,Pubs & Bars,42,0,2509,DR
14/9/2020,KU Children's Services /Expense/Personal/Children & Family,KU Children's Services ,Expense,Personal,Children & Family,62,0,2447,DR
15/9/2020,Pathology Lab /Expense/Personal/Health & Medical,Pathology Lab ,Expense,Personal,Health & Medical,130,0,2317,DR
21/9/2020,Muffin Break /Expense/Leisure & Lifestyle/Restaurants & Cafes,Muffin Break ,Expense,Leisure & Lifestyle,Restaurants & Cafes,54,0,2263,DR
21/9/2020,Menulog /Expense/Leisure & Lifestyle/Takeaway,Menulog ,Expense,Leisure & Lifestyle,Takeaway,132,0,2131,DR
21/9/2020,Witchery /Expense/Personal/Clothing & Accessories,Witchery ,Expense,Personal,Clothing & Accessories,149,0,1982,DR
21/9/2020,Platypus Shoes /Expense/Personal/Clothing & Accessories,Platypus Shoes ,Expense,Personal,Clothing & Accessories,137,0,1845,DR
22/9/2020,Medicare Claim /Expense/Personal/Health & Medical,Medicare Claim ,Expense,Personal,Health & Medical,47,0,1798,DR
23/9/2020,Hobart Brewing Company /Expense/Leisure & Lifestyle/Pubs & Bars,Hobart Brewing Company ,Expense,Leisure & Lifestyle,Pubs & Bars,7,0,1791,DR
25/9/2020,YMCA /Expense/Personal/Fitness & Wellbeing,YMCA ,Expense,Personal,Fitness & Wellbeing,110,0,1681,DR
25/9/2020,Beachside Caravan Park /Expense/Leisure & Lifestyle/Holidays & Travel,Beachside Caravan Park ,Expense,Leisure & Lifestyle,Holidays & Travel,105,0,1576,DR
27/9/2020,Uber /Expense/Transport/Taxies & Share Cars,Uber ,Expense,Transport,Taxies & Share Cars,108,0,1468,DR
1/10/2020,Monthly Income,Monthly Income,Income,Income,Wages,0,6000,7468,CR
3/10/2020, Commonwealth Bank /Expense/Household/Rent & Mortgage, Commonwealth Bank ,Expense,Household,Rent & Mortgage,53,0,7415,DR
4/10/2020,Petbarn /Expense/Household/Pets,Petbarn ,Expense,Household,Pets,37,0,7378,DR
4/10/2020,Airbnb Host Income /Income/Income/Other Income,Airbnb Host Income ,Income,Income,Other Income,127,0,7251,DR
5/10/2020,Airbnb Host Income /Income/Income/Other Income,Airbnb Host Income ,Income,Income,Other Income,503,0,6748,DR
6/10/2020,Apple Store /Expense/Leisure & Lifestyle/Electronics,Apple Store ,Expense,Leisure & Lifestyle,Electronics,275,0,6473,DR
7/10/2020,"Netflix /Expense/Leisure & Lifestyle/Tv, Music & Streaming",Netflix ,Expense,Leisure & Lifestyle,"Tv, Music & Streaming",422,0,6051,DR
9/10/2020,Ice Cream Parlour /Expense/Leisure & Lifestyle/Takeaway,Ice Cream Parlour ,Expense,Leisure & Lifestyle,Takeaway,321,0,5730,DR
9/10/2020,KU Children's Services /Expense/Personal/Children & Family,KU Children's Services ,Expense,Personal,Children & Family,475,0,5255,DR
10/10/2020,Gold's Gym /Expense/Personal/Fitness & Wellbeing,Gold's Gym ,Expense,Personal,Fitness & Wellbeing,286,0,4969,DR
11/10/2020,The Australian /Expense/Personal/Education,The Australian ,Expense,Personal,Education,87,0,4882,DR
11/10/2020,Upwork Freelancer Payment /Income/Income/Other Income,Upwork Freelancer Payment ,Income,Income,Other Income,249,0,4633,DR
12/10/2020,Stand Up Paddleboard Rental /Expense/Personal/Fitness & Wellbeing,Stand Up Paddleboard Rental ,Expense,Personal,Fitness & Wellbeing,15,0,4618,DR
13/10/2020,PayPal Transfer from Sale /Income/Income/Other Income,PayPal Transfer from Sale ,Income,Income,Other Income,25,0,4593,DR
13/10/2020,The Athlete's Foot /Expense/Personal/Clothing & Accessories,The Athlete's Foot ,Expense,Personal,Clothing & Accessories,240,0,4353,DR
14/10/2020,Apple Store /Expense/Leisure & Lifestyle/Electronics,Apple Store ,Expense,Leisure & Lifestyle,Electronics,240,0,4113,DR
15/10/2020,Beachside Yoga Classes /Expense/Personal/Fitness & Wellbeing,Beachside Yoga Classes ,Expense,Personal,Fitness & Wellbeing,333,0,3780,DR
15/10/2020,"EB Games /Expense/Leisure & Lifestyle/Apps, Games & Software",EB Games ,Expense,Leisure & Lifestyle,"Apps, Games & Software",76,0,3704,DR
15/10/2020,AustralianSuper Pension /Income/Income/Other Income,AustralianSuper Pension ,Income,Income,Other Income,287,0,3417,DR
15/10/2020, Ray White Real Estate /Expense/Personal/Life Admin, Ray White Real Estate ,Expense,Personal,Life Admin,46,0,3371,DR
16/10/2020,Palace Cinemas /Expense/Leisure & Lifestyle/Entertainment,Palace Cinemas ,Expense,Leisure & Lifestyle,Entertainment,77,0,3294,DR
17/10/2020,Campion Education /Expense/Personal/Children & Family,Campion Education ,Expense,Personal,Children & Family,134,0,3160,DR
17/10/2020,Chemist Warehouse /Expense/Personal/Health & Medical,Chemist Warehouse ,Expense,Personal,Health & Medical,32,0,3128,DR
18/10/2020,Myer /Expense/Personal/Clothing & Accessories,Myer ,Expense,Personal,Clothing & Accessories,133,0,2995,DR
18/10/2020, Jim's Mowing /Expense/Household/Maintenance & Improvements, Jim's Mowing ,Expense,Household,Maintenance & Improvements,111,0,2884,DR
19/10/2020,Who Gives A Crap /Expense/Household/Groceries,Who Gives A Crap ,Expense,Household,Groceries,226,0,2658,DR
19/10/2020,Harris Farm Markets /Expense/Household/Groceries,Harris Farm Markets ,Expense,Household,Groceries,34,0,2624,DR
21/10/2020,Camp Australia /Expense/Leisure & Lifestyle/Hobbies,Camp Australia ,Expense,Leisure & Lifestyle,Hobbies,131,0,2493,DR
22/10/2020,"VicRoads /Expense/Transport/Car Insurance, Rego & Maintenance",VicRoads ,Expense,Transport,"Car Insurance, Rego & Maintenance",197,0,2296,DR
22/10/2020,Coles /Expense/Household/Groceries,Coles ,Expense,Household,Groceries,223,0,2073,DR
23/10/2020, EnergyAustralia /Expense/Household/Utilities, EnergyAustralia ,Expense,Household,Utilities,68,0,2005,DR
23/10/2020,Optus /Expense/Personal/Mobile Phone,Optus ,Expense,Personal,Mobile Phone,71,0,1934,DR
23/10/2020,Shell V Power/Expense/Transport/Fuel,Shell V Power,Expense,Transport,Fuel,18,0,1916,DR
24/10/2020,Apple Store /Expense/Leisure & Lifestyle/Electronics,Apple Store ,Expense,Leisure & Lifestyle,Electronics,146,0,1770,DR
27/10/2020,Rebel Sport /Expense/Personal/Fitness & Wellbeing,Rebel Sport ,Expense,Personal,Fitness & Wellbeing,159,0,1611,DR
27/10/2020,Swim Australia /Expense/Personal/Fitness & Wellbeing,Swim Australia ,Expense,Personal,Fitness & Wellbeing,102,0,1509,DR
1/11/2020,Monthly Income,Monthly Income,Income,Income,Wages,0,6000,7509,CR
2/11/2020, EnergyAustralia /Expense/Household/Utilities, EnergyAustralia ,Expense,Household,Utilities,83,0,7426,DR
2/11/2020,"Le Creuset /Expense/Household/Furniture, Electronics & Homewares",Le Creuset ,Expense,Household,"Furniture, Electronics & Homewares",279,0,7147,DR
2/11/2020,Beach Café /Expense/Leisure & Lifestyle/Restaurants & Cafes,Beach Café ,Expense,Leisure & Lifestyle,Restaurants & Cafes,90,0,7057,DR
4/11/2020,Culture Kings /Expense/Personal/Clothing & Accessories,Culture Kings ,Expense,Personal,Clothing & Accessories,354,0,6703,DR
5/11/2020, Metricon /Expense/Household/Maintenance & Improvements, Metricon ,Expense,Household,Maintenance & Improvements,397,0,6306,DR
5/11/2020,"Stan /Expense/Leisure & Lifestyle/Tv, Music & Streaming",Stan ,Expense,Leisure & Lifestyle,"Tv, Music & Streaming",326,0,5980,DR
5/11/2020,The Australian /Expense/Personal/Education,The Australian ,Expense,Personal,Education,194,0,5786,DR
6/11/2020,Eat Street Northshore /Expense/Leisure & Lifestyle/Pubs & Bars,Eat Street Northshore ,Expense,Leisure & Lifestyle,Pubs & Bars,220,0,5566,DR
8/11/2020,F45 Training /Expense/Personal/Fitness & Wellbeing,F45 Training ,Expense,Personal,Fitness & Wellbeing,439,0,5127,DR
8/11/2020,Ice Cream Parlour /Expense/Leisure & Lifestyle/Takeaway,Ice Cream Parlour ,Expense,Leisure & Lifestyle,Takeaway,69,0,5058,DR
8/11/2020,Taronga Zoo /Expense/Leisure & Lifestyle/Entertainment,Taronga Zoo ,Expense,Leisure & Lifestyle,Entertainment,431,0,4627,DR
9/11/2020,Apple Store /Expense/Leisure & Lifestyle/Electronics,Apple Store ,Expense,Leisure & Lifestyle,Electronics,362,0,4265,DR
9/11/2020,Myer /Expense/Personal/Clothing & Accessories,Myer ,Expense,Personal,Clothing & Accessories,178,0,4087,DR
9/11/2020,Guzman y Gomez /Expense/Leisure & Lifestyle/Takeaway,Guzman y Gomez ,Expense,Leisure & Lifestyle,Takeaway,23,0,4064,DR
10/11/2020, NRMA Insurance /Expense/Household/Rates & Insurance, NRMA Insurance ,Expense,Household,Rates & Insurance,320,0,3744,DR
10/11/2020, BSA Ltd /Expense/Household/Maintenance & Improvements, BSA Ltd ,Expense,Household,Maintenance & Improvements,171,0,3573,DR
12/11/2020,Origin Energy /Expense/Household/Utilities,Origin Energy ,Expense,Household,Utilities,114,0,3459,DR
13/11/2020,Jetts Fitness /Expense/Personal/Fitness & Wellbeing,Jetts Fitness ,Expense,Personal,Fitness & Wellbeing,106,0,3353,DR
14/11/2020,"Ultra Tune /Expense/Transport/Car Insurance, Rego & Maintenance",Ultra Tune ,Expense,Transport,"Car Insurance, Rego & Maintenance",52,0,3301,DR
14/11/2020,Shell V Power/Expense/Transport/Fuel,Shell V Power,Expense,Transport,Fuel,138,0,3163,DR
15/11/2020,ALDI /Expense/Household/Groceries,ALDI ,Expense,Household,Groceries,174,0,2989,DR
15/11/2020,Local Hospital /Expense/Personal/Health & Medical,Local Hospital ,Expense,Personal,Health & Medical,115,0,2874,DR
16/11/2020,The Sydney Morning Herald /Expense/Personal/Education,The Sydney Morning Herald ,Expense,Personal,Education,245,0,2629,DR
17/11/2020,Uber /Expense/Transport/Taxies & Share Cars,Uber ,Expense,Transport,Taxies & Share Cars,143,0,2486,DR
17/11/2020,Jetts Fitness /Expense/Personal/Fitness & Wellbeing,Jetts Fitness ,Expense,Personal,Fitness & Wellbeing,81,0,2405,DR
18/11/2020,"Kayo Sports /Expense/Leisure & Lifestyle/Tv, Music & Streaming",Kayo Sports ,Expense,Leisure & Lifestyle,"Tv, Music & Streaming",240,0,2165,DR
18/11/2020,Quay Restaurant /Expense/Leisure & Lifestyle/Pubs & Bars,Quay Restaurant ,Expense,Leisure & Lifestyle,Pubs & Bars,66,0,2099,DR
18/11/2020,Surf Dive 'n Ski /Expense/Personal/Clothing & Accessories,Surf Dive 'n Ski ,Expense,Personal,Clothing & Accessories,156,0,1943,DR
19/11/2020,VetLove /Expense/Household/Pets,VetLove ,Expense,Household,Pets,87,0,1856,DR
19/11/2020,Ice Cream Parlour /Expense/Leisure & Lifestyle/Takeaway,Ice Cream Parlour ,Expense,Leisure & Lifestyle,Takeaway,75,0,1781,DR
20/11/2020,OfficeMax /Expense/Personal/Life Admin,OfficeMax ,Expense,Personal,Life Admin,24,0,1757,DR
20/11/2020,Hungry Jack’s /Expense/Leisure & Lifestyle/Takeaway,Hungry Jack’s ,Expense,Leisure & Lifestyle,Takeaway,90,0,1667,DR
21/11/2020,eBay Sales Proceeds /Income/Income/Other Income,eBay Sales Proceeds ,Income,Income,Other Income,42,0,1625,DR
21/11/2020, Commonwealth Bank /Expense/Household/Rent & Mortgage, Commonwealth Bank ,Expense,Household,Rent & Mortgage,150,0,1475,DR
21/11/2020,Ladbrokes /Expense/Leisure & Lifestyle/Lottery & Gambling,Ladbrokes ,Expense,Leisure & Lifestyle,Lottery & Gambling,53,0,1422,DR
22/11/2020,IKEA /Expense/Household/Maintenance & Improvements,IKEA ,Expense,Household,Maintenance & Improvements,107,0,1315,DR
24/11/2020,"Supercheap Auto /Expense/Transport/Car Insurance, Rego & Maintenance",Supercheap Auto ,Expense,Transport,"Car Insurance, Rego & Maintenance",101,0,1214,DR
24/11/2020,Muffin Break /Expense/Leisure & Lifestyle/Restaurants & Cafes,Muffin Break ,Expense,Leisure & Lifestyle,Restaurants & Cafes,56,0,1158,DR
24/11/2020,SEQTA /Expense/Personal/Education,SEQTA ,Expense,Personal,Education,21,0,1137,DR
24/11/2020,ATO Tax Refund /Income/Income/Other Income,ATO Tax Refund ,Income,Income,Other Income,56,0,1081,DR
26/11/2020,The Baxter Inn /Expense/Leisure & Lifestyle/Pubs & Bars,The Baxter Inn ,Expense,Leisure & Lifestyle,Pubs & Bars,39,0,1042,DR
27/11/2020,Zone Bowling /Expense/Leisure & Lifestyle/Entertainment,Zone Bowling ,Expense,Leisure & Lifestyle,Entertainment,68,0,974,DR
28/11/2020,Flight Centre /Expense/Leisure & Lifestyle/Holidays & Travel,Flight Centre ,Expense,Leisure & Lifestyle,Holidays & Travel,32,0,942,DR
1/12/2020,Monthly Income,Monthly Income,Income,Income,Wages,0,6000,6942,CR
3/12/2020,Tabcorp /Expense/Leisure & Lifestyle/Lottery & Gambling,Tabcorp ,Expense,Leisure & Lifestyle,Lottery & Gambling,78,0,6864,DR
4/12/2020,"Kayo Sports /Expense/Leisure & Lifestyle/Tv, Music & Streaming",Kayo Sports ,Expense,Leisure & Lifestyle,"Tv, Music & Streaming",87,0,6777,DR
7/12/2020,Palace Cinemas /Expense/Leisure & Lifestyle/Entertainment,Palace Cinemas ,Expense,Leisure & Lifestyle,Entertainment,144,0,6633,DR
7/12/2020,Shell V Power/Expense/Transport/Fuel,Shell V Power,Expense,Transport,Fuel,388,0,6245,DR
8/12/2020,"Adairs /Expense/Household/Furniture, Electronics & Homewares",Adairs ,Expense,Household,"Furniture, Electronics & Homewares",512,0,5733,DR
10/12/2020, Rentokil /Expense/Household/Maintenance & Improvements, Rentokil ,Expense,Household,Maintenance & Improvements,476,0,5257,DR
10/12/2020,The Ivy /Expense/Leisure & Lifestyle/Pubs & Bars,The Ivy ,Expense,Leisure & Lifestyle,Pubs & Bars,19,0,5238,DR
10/12/2020,"Apple Music /Expense/Leisure & Lifestyle/Tv, Music & Streaming",Apple Music ,Expense,Leisure & Lifestyle,"Tv, Music & Streaming",161,0,5077,DR
13/12/2020,Kumon /Expense/Personal/Education,Kumon ,Expense,Personal,Education,457,0,4620,DR
13/12/2020,Caltex /Expense/Transport/Fuel,Caltex ,Expense,Transport,Fuel,102,0,4518,DR
13/12/2020,Dental Clinic /Expense/Personal/Health & Medical,Dental Clinic ,Expense,Personal,Health & Medical,184,0,4334,DR
15/12/2020,Snap Fitness /Expense/Personal/Fitness & Wellbeing,Snap Fitness ,Expense,Personal,Fitness & Wellbeing,240,0,4094,DR
15/12/2020,Montessori Schools /Expense/Personal/Education,Montessori Schools ,Expense,Personal,Education,221,0,3873,DR
18/12/2020,AustralianSuper Pension /Income/Income/Other Income,AustralianSuper Pension ,Income,Income,Other Income,175,0,3698,DR
18/12/2020,Rebel Sport /Expense/Personal/Fitness & Wellbeing,Rebel Sport ,Expense,Personal,Fitness & Wellbeing,38,0,3660,DR
20/12/2020,Rooftop Bar /Expense/Leisure & Lifestyle/Pubs & Bars,Rooftop Bar ,Expense,Leisure & Lifestyle,Pubs & Bars,62,0,3598,DR
21/12/2020,Chiropractor /Expense/Personal/Health & Medical,Chiropractor ,Expense,Personal,Health & Medical,249,0,3349,DR
22/12/2020,Greencross Vets /Expense/Household/Pets,Greencross Vets ,Expense,Household,Pets,310,0,3039,DR
23/12/2020,Guardian Childcare & Education /Expense/Personal/Children & Family,Guardian Childcare & Education ,Expense,Personal,Children & Family,177,0,2862,DR
23/12/2020,"EB Games /Expense/Leisure & Lifestyle/Apps, Games & Software",EB Games ,Expense,Leisure & Lifestyle,"Apps, Games & Software",20,0,2842,DR
24/12/2020,Stand Up Paddleboard Rental /Expense/Personal/Fitness & Wellbeing,Stand Up Paddleboard Rental ,Expense,Personal,Fitness & Wellbeing,272,0,2570,DR
25/12/2020,"Stan /Expense/Leisure & Lifestyle/Tv, Music & Streaming",Stan ,Expense,Leisure & Lifestyle,"Tv, Music & Streaming",154,0,2416,DR
28/12/2020,"Car Wash Cafe /Expense/Transport/Car Insurance, Rego & Maintenance",Car Wash Cafe ,Expense,Transport,"Car Insurance, Rego & Maintenance",191,0,2225,DR
28/12/2020,The Rocks Bar and Pub /Expense/Leisure & Lifestyle/Pubs & Bars,The Rocks Bar and Pub ,Expense,Leisure & Lifestyle,Pubs & Bars,147,0,2078,DR
1/1/2021,Monthly Income,Monthly Income,Income,Income,Wages,0,6000,8078,CR
2/1/2021,eBay Sales Proceeds /Income/Income/Other Income,eBay Sales Proceeds ,Income,Income,Other Income,220,0,7858,DR
2/1/2021,Dan Murphy’s /Expense/Leisure & Lifestyle/Alcohol,Dan Murphy’s ,Expense,Leisure & Lifestyle,Alcohol,751,0,7107,DR
2/1/2021,"Apple Music /Expense/Leisure & Lifestyle/Tv, Music & Streaming",Apple Music ,Expense,Leisure & Lifestyle,"Tv, Music & Streaming",502,0,6605,DR
3/1/2021,Rebel Sport /Expense/Personal/Fitness & Wellbeing,Rebel Sport ,Expense,Personal,Fitness & Wellbeing,111,0,6494,DR
4/1/2021,Sea Kayak Tours /Expense/Leisure & Lifestyle/Holidays & Travel,Sea Kayak Tours ,Expense,Leisure & Lifestyle,Holidays & Travel,314,0,6180,DR
5/1/2021, Slater and Gordon Lawyers /Expense/Personal/Life Admin, Slater and Gordon Lawyers ,Expense,Personal,Life Admin,389,0,5791,DR
5/1/2021,YMCA /Expense/Personal/Fitness & Wellbeing,YMCA ,Expense,Personal,Fitness & Wellbeing,576,0,5215,DR
6/1/2021, Commonwealth Bank /Expense/Household/Rent & Mortgage, Commonwealth Bank ,Expense,Household,Rent & Mortgage,16,0,5199,DR
6/1/2021,City Beach /Expense/Personal/Clothing & Accessories,City Beach ,Expense,Personal,Clothing & Accessories,102,0,5097,DR
10/1/2021,"Autobarn /Expense/Transport/Car Insurance, Rego & Maintenance",Autobarn ,Expense,Transport,"Car Insurance, Rego & Maintenance",486,0,4611,DR
10/1/2021,"JAX Tyres /Expense/Transport/Car Insurance, Rego & Maintenance",JAX Tyres ,Expense,Transport,"Car Insurance, Rego & Maintenance",336,0,4275,DR
12/1/2021,AMF Bowling /Expense/Leisure & Lifestyle/Entertainment,AMF Bowling ,Expense,Leisure & Lifestyle,Entertainment,321,0,3954,DR
13/1/2021,Coles /Expense/Household/Groceries,Coles ,Expense,Household,Groceries,370,0,3584,DR
13/1/2021,"Disney+ /Expense/Leisure & Lifestyle/Tv, Music & Streaming",Disney+ ,Expense,Leisure & Lifestyle,"Tv, Music & Streaming",155,0,3429,DR
14/1/2021,"Stan /Expense/Leisure & Lifestyle/Tv, Music & Streaming",Stan ,Expense,Leisure & Lifestyle,"Tv, Music & Streaming",144,0,3285,DR
15/1/2021,Spotlight /Expense/Leisure & Lifestyle/Hobbies,Spotlight ,Expense,Leisure & Lifestyle,Hobbies,116,0,3169,DR
16/1/2021,"EB Games /Expense/Leisure & Lifestyle/Apps, Games & Software",EB Games ,Expense,Leisure & Lifestyle,"Apps, Games & Software",58,0,3111,DR
19/1/2021,Salary Deposit from Woolworths Group /Income/Income/Wages,Salary Deposit from Woolworths Group ,Income,Income,Wages,301,0,2810,DR
20/1/2021,Upwork Freelancer Payment /Income/Income/Other Income,Upwork Freelancer Payment ,Income,Income,Other Income,197,0,2613,DR
20/1/2021,Bulk Billing Doctor /Expense/Personal/Health & Medical,Bulk Billing Doctor ,Expense,Personal,Health & Medical,166,0,2447,DR
23/1/2021,Eat Street Northshore /Expense/Leisure & Lifestyle/Pubs & Bars,Eat Street Northshore ,Expense,Leisure & Lifestyle,Pubs & Bars,237,0,2210,DR
24/1/2021,"Bridgestone Select /Expense/Transport/Car Insurance, Rego & Maintenance",Bridgestone Select ,Expense,Transport,"Car Insurance, Rego & Maintenance",200,0,2010,DR
25/1/2021,Woolworths /Expense/Household/Groceries,Woolworths ,Expense,Household,Groceries,100,0,1910,DR
26/1/2021,Little Athletics /Expense/Personal/Fitness & Wellbeing,Little Athletics ,Expense,Personal,Fitness & Wellbeing,59,0,1851,DR
1/2/2021,Monthly Income,Monthly Income,Income,Income,Wages,0,6000,7851,CR
3/2/2021,Woolworths /Expense/Household/Groceries,Woolworths ,Expense,Household,Groceries,560,0,7291,DR
6/2/2021,Gardening Australia /Expense/Household/Maintenance & Improvements,Gardening Australia ,Expense,Household,Maintenance & Improvements,186,0,7105,DR
8/2/2021,KU Children's Services /Expense/Personal/Children & Family,KU Children's Services ,Expense,Personal,Children & Family,65,0,7040,DR
8/2/2021,PayPal Transfer from Sale /Income/Income/Other Income,PayPal Transfer from Sale ,Income,Income,Other Income,167,0,6873,DR
11/2/2021,Myer /Expense/Personal/Clothing & Accessories,Myer ,Expense,Personal,Clothing & Accessories,322,0,6551,DR
12/2/2021,"Spotify /Expense/Leisure & Lifestyle/Tv, Music & Streaming",Spotify ,Expense,Leisure & Lifestyle,"Tv, Music & Streaming",224,0,6327,DR
13/2/2021,"Le Creuset /Expense/Household/Furniture, Electronics & Homewares",Le Creuset ,Expense,Household,"Furniture, Electronics & Homewares",541,0,5786,DR
15/2/2021,Camp Australia /Expense/Leisure & Lifestyle/Hobbies,Camp Australia ,Expense,Leisure & Lifestyle,Hobbies,378,0,5408,DR
15/2/2021,Petbarn /Expense/Household/Pets,Petbarn ,Expense,Household,Pets,314,0,5094,DR
15/2/2021,Dan Murphy’s /Expense/Leisure & Lifestyle/Alcohol,Dan Murphy’s ,Expense,Leisure & Lifestyle,Alcohol,329,0,4765,DR
16/2/2021,Surfstitch /Expense/Personal/Clothing & Accessories,Surfstitch ,Expense,Personal,Clothing & Accessories,15,0,4750,DR
19/2/2021,BWS /Expense/Leisure & Lifestyle/Alcohol,BWS ,Expense,Leisure & Lifestyle,Alcohol,272,0,4478,DR
19/2/2021,"NRMA Roadside Assistance /Expense/Transport/Car Insurance, Rego & Maintenance",NRMA Roadside Assistance ,Expense,Transport,"Car Insurance, Rego & Maintenance",228,0,4250,DR
20/2/2021,School Locker /Expense/Personal/Children & Family,School Locker ,Expense,Personal,Children & Family,299,0,3951,DR
23/2/2021,Rebel Sport /Expense/Personal/Fitness & Wellbeing,Rebel Sport ,Expense,Personal,Fitness & Wellbeing,215,0,3736,DR
23/2/2021,"Harvey Norman /Expense/Household/Furniture, Electronics & Homewares",Harvey Norman ,Expense,Household,"Furniture, Electronics & Homewares",205,0,3531,DR
25/2/2021,"Bridgestone Select /Expense/Transport/Car Insurance, Rego & Maintenance",Bridgestone Select ,Expense,Transport,"Car Insurance, Rego & Maintenance",303,0,3228,DR
25/2/2021,The Victory Hotel /Expense/Leisure & Lifestyle/Pubs & Bars,The Victory Hotel ,Expense,Leisure & Lifestyle,Pubs & Bars,52,0,3176,DR
27/2/2021,McDonald’s /Expense/Leisure & Lifestyle/Takeaway,McDonald’s ,Expense,Leisure & Lifestyle,Takeaway,40,0,3136,DR
27/2/2021,Priceline Pharmacy /Expense/Personal/Health & Medical,Priceline Pharmacy ,Expense,Personal,Health & Medical,145,0,2991,DR
1/3/2021,Monthly Income,Monthly Income,Income,Income,Wages,0,6000,8991,CR
2/3/2021,Lorna Jane /Expense/Personal/Clothing & Accessories,Lorna Jane ,Expense,Personal,Clothing & Accessories,858,0,8133,DR
2/3/2021, Jim's Mowing /Expense/Household/Maintenance & Improvements, Jim's Mowing ,Expense,Household,Maintenance & Improvements,50,0,8083,DR
2/3/2021,Lorna Jane /Expense/Personal/Clothing & Accessories,Lorna Jane ,Expense,Personal,Clothing & Accessories,660,0,7423,DR
2/3/2021,South East Water /Expense/Household/Utilities,South East Water ,Expense,Household,Utilities,605,0,6818,DR
3/3/2021,Gold's Gym /Expense/Personal/Fitness & Wellbeing,Gold's Gym ,Expense,Personal,Fitness & Wellbeing,489,0,6329,DR
3/3/2021,PayPal Transfer from Sale /Income/Income/Other Income,PayPal Transfer from Sale ,Income,Income,Other Income,245,0,6084,DR
4/3/2021, Rentokil /Expense/Household/Maintenance & Improvements, Rentokil ,Expense,Household,Maintenance & Improvements,573,0,5511,DR
5/3/2021,Little Athletics /Expense/Personal/Fitness & Wellbeing,Little Athletics ,Expense,Personal,Fitness & Wellbeing,546,0,4965,DR
5/3/2021,Liquorland /Expense/Leisure & Lifestyle/Alcohol,Liquorland ,Expense,Leisure & Lifestyle,Alcohol,125,0,4840,DR
5/3/2021,Eat Street Northshore /Expense/Leisure & Lifestyle/Pubs & Bars,Eat Street Northshore ,Expense,Leisure & Lifestyle,Pubs & Bars,107,0,4733,DR
6/3/2021, Metricon /Expense/Household/Maintenance & Improvements, Metricon ,Expense,Household,Maintenance & Improvements,122,0,4611,DR
6/3/2021,The Body Shop /Expense/Personal/Hair & Beauty,The Body Shop ,Expense,Personal,Hair & Beauty,29,0,4582,DR
7/3/2021,The Victory Hotel /Expense/Leisure & Lifestyle/Pubs & Bars,The Victory Hotel ,Expense,Leisure & Lifestyle,Pubs & Bars,214,0,4368,DR
7/3/2021,Menulog /Expense/Leisure & Lifestyle/Takeaway,Menulog ,Expense,Leisure & Lifestyle,Takeaway,78,0,4290,DR
7/3/2021,Soccer Clubs /Expense/Personal/Fitness & Wellbeing,Soccer Clubs ,Expense,Personal,Fitness & Wellbeing,253,0,4037,DR
7/3/2021,Chemist Warehouse /Expense/Personal/Health & Medical,Chemist Warehouse ,Expense,Personal,Health & Medical,8,0,4029,DR
8/3/2021,Domino’s Pizza /Expense/Leisure & Lifestyle/Takeaway,Domino’s Pizza ,Expense,Leisure & Lifestyle,Takeaway,241,0,3788,DR
9/3/2021,Kumon /Expense/Personal/Education,Kumon ,Expense,Personal,Education,337,0,3451,DR
9/3/2021,Bulk Billing Doctor /Expense/Personal/Health & Medical,Bulk Billing Doctor ,Expense,Personal,Health & Medical,157,0,3294,DR
9/3/2021,Coles Express /Expense/Transport/Fuel,Coles Express ,Expense,Transport,Fuel,133,0,3161,DR
10/3/2021,"Le Creuset /Expense/Household/Furniture, Electronics & Homewares",Le Creuset ,Expense,Household,"Furniture, Electronics & Homewares",43,0,3118,DR
10/3/2021,Sunnybank Hotel /Expense/Leisure & Lifestyle/Pubs & Bars,Sunnybank Hotel ,Expense,Leisure & Lifestyle,Pubs & Bars,65,0,3053,DR
11/3/2021,The Espy /Expense/Leisure & Lifestyle/Pubs & Bars,The Espy ,Expense,Leisure & Lifestyle,Pubs & Bars,271,0,2782,DR
12/3/2021,Sunburn Swimwear /Expense/Personal/Clothing & Accessories,Sunburn Swimwear ,Expense,Personal,Clothing & Accessories,92,0,2690,DR
12/3/2021,Menulog /Expense/Leisure & Lifestyle/Takeaway,Menulog ,Expense,Leisure & Lifestyle,Takeaway,256,0,2434,DR
13/3/2021,"Green Slip Insurance /Expense/Transport/Car Insurance, Rego & Maintenance",Green Slip Insurance ,Expense,Transport,"Car Insurance, Rego & Maintenance",213,0,2221,DR
13/3/2021,Timezone /Expense/Leisure & Lifestyle/Entertainment,Timezone ,Expense,Leisure & Lifestyle,Entertainment,120,0,2101,DR
13/3/2021, EnergyAustralia /Expense/Household/Utilities, EnergyAustralia ,Expense,Household,Utilities,148,0,1953,DR
14/3/2021,Microsoft 365 /Expense/Personal/Education,Microsoft 365 ,Expense,Personal,Education,37,0,1916,DR
14/3/2021, Rentokil /Expense/Household/Maintenance & Improvements, Rentokil ,Expense,Household,Maintenance & Improvements,69,0,1847,DR
16/3/2021,The Sydney Morning Herald /Expense/Personal/Education,The Sydney Morning Herald ,Expense,Personal,Education,16,0,1831,DR
16/3/2021,Little Athletics /Expense/Personal/Fitness & Wellbeing,Little Athletics ,Expense,Personal,Fitness & Wellbeing,82,0,1749,DR
16/3/2021,Caltex Woolworths /Expense/Transport/Fuel,Caltex Woolworths ,Expense,Transport,Fuel,173,0,1576,DR
16/3/2021,JB HiFi/Expense/Leisure & Lifestyle/Electronics,JB HiFi,Expense,Leisure & Lifestyle,Electronics,149,0,1427,DR
16/3/2021,"Budget Direct Car Insurance /Expense/Transport/Car Insurance, Rego & Maintenance",Budget Direct Car Insurance ,Expense,Transport,"Car Insurance, Rego & Maintenance",141,0,1286,DR
17/3/2021,AGL Energy /Expense/Household/Utilities,AGL Energy ,Expense,Household,Utilities,57,0,1229,DR
18/3/2021,Sunburn Swimwear /Expense/Personal/Clothing & Accessories,Sunburn Swimwear ,Expense,Personal,Clothing & Accessories,24,0,1205,DR
18/3/2021,Petbarn /Expense/Household/Pets,Petbarn ,Expense,Household,Pets,118,0,1087,DR
19/3/2021,The Sydney Morning Herald /Expense/Personal/Education,The Sydney Morning Herald ,Expense,Personal,Education,84,0,1003,DR
20/3/2021, Metricon /Expense/Household/Maintenance & Improvements, Metricon ,Expense,Household,Maintenance & Improvements,43,0,960,DR
21/3/2021,VetLove /Expense/Household/Pets,VetLove ,Expense,Household,Pets,51,0,909,DR
21/3/2021,Beacon Lighting /Expense/Household/Maintenance & Improvements,Beacon Lighting ,Expense,Household,Maintenance & Improvements,32,0,877,DR
22/3/2021,Boost Juice Bars /Expense/Leisure & Lifestyle/Takeaway,Boost Juice Bars ,Expense,Leisure & Lifestyle,Takeaway,19,0,858,DR
23/3/2021,BP /Expense/Transport/Fuel,BP ,Expense,Transport,Fuel,83,0,775,DR
23/3/2021,Pathology Lab /Expense/Personal/Health & Medical,Pathology Lab ,Expense,Personal,Health & Medical,58,0,717,DR
24/3/2021,National Hearing Care /Expense/Personal/Health & Medical,National Hearing Care ,Expense,Personal,Health & Medical,28,0,689,DR
24/3/2021,Sylvan Learning /Expense/Personal/Education,Sylvan Learning ,Expense,Personal,Education,38,0,651,DR
24/3/2021,AGL Energy /Expense/Household/Utilities,AGL Energy ,Expense,Household,Utilities,42,0,609,DR
24/3/2021,Origin Energy /Expense/Household/Utilities,Origin Energy ,Expense,Household,Utilities,26,0,583,DR
24/3/2021,Gardening Australia /Expense/Household/Maintenance & Improvements,Gardening Australia ,Expense,Household,Maintenance & Improvements,38,0,545,DR
25/3/2021,Beachside Yoga Classes /Expense/Personal/Fitness & Wellbeing,Beachside Yoga Classes ,Expense,Personal,Fitness & Wellbeing,32,0,513,DR
25/3/2021,Muffin Break /Expense/Leisure & Lifestyle/Restaurants & Cafes,Muffin Break ,Expense,Leisure & Lifestyle,Restaurants & Cafes,28,0,485,DR
25/3/2021,"The Good Guys /Expense/Household/Furniture, Electronics & Homewares",The Good Guys ,Expense,Household,"Furniture, Electronics & Homewares",7,0,478,DR
27/3/2021,Catholic Education Office /Expense/Personal/Education,Catholic Education Office ,Expense,Personal,Education,47,0,431,DR
27/3/2021,"VicRoads /Expense/Transport/Car Insurance, Rego & Maintenance",VicRoads ,Expense,Transport,"Car Insurance, Rego & Maintenance",38,0,393,DR
28/3/2021,Soccer Clubs /Expense/Personal/Fitness & Wellbeing,Soccer Clubs ,Expense,Personal,Fitness & Wellbeing,8,0,385,DR
1/4/2021,Monthly Income,Monthly Income,Income,Income,Wages,0,6000,6385,CR
2/4/2021,AGL Energy /Expense/Household/Utilities,AGL Energy ,Expense,Household,Utilities,195,0,6190,DR
4/4/2021,The Baxter Inn /Expense/Leisure & Lifestyle/Pubs & Bars,The Baxter Inn ,Expense,Leisure & Lifestyle,Pubs & Bars,365,0,5825,DR
4/4/2021,Local Fish and Chips /Expense/Leisure & Lifestyle/Takeaway,Local Fish and Chips ,Expense,Leisure & Lifestyle,Takeaway,435,0,5390,DR
5/4/2021,Vodafone Prepaid /Expense/Personal/Mobile Phone,Vodafone Prepaid ,Expense,Personal,Mobile Phone,15,0,5375,DR
6/4/2021,Dental Clinic /Expense/Personal/Health & Medical,Dental Clinic ,Expense,Personal,Health & Medical,71,0,5304,DR
6/4/2021,Anytime Fitness /Expense/Personal/Fitness & Wellbeing,Anytime Fitness ,Expense,Personal,Fitness & Wellbeing,291,0,5013,DR
7/4/2021,Café Nero /Expense/Leisure & Lifestyle/Restaurants & Cafes,Café Nero ,Expense,Leisure & Lifestyle,Restaurants & Cafes,194,0,4819,DR
7/4/2021,Bulk Billing Doctor /Expense/Personal/Health & Medical,Bulk Billing Doctor ,Expense,Personal,Health & Medical,475,0,4344,DR
10/4/2021,The Ivy /Expense/Leisure & Lifestyle/Pubs & Bars,The Ivy ,Expense,Leisure & Lifestyle,Pubs & Bars,166,0,4178,DR
11/4/2021,Kmart /Expense/Personal/Children & Family,Kmart ,Expense,Personal,Children & Family,135,0,4043,DR
12/4/2021,Spotlight /Expense/Leisure & Lifestyle/Hobbies,Spotlight ,Expense,Leisure & Lifestyle,Hobbies,333,0,3710,DR
12/4/2021,Jetts Fitness /Expense/Personal/Fitness & Wellbeing,Jetts Fitness ,Expense,Personal,Fitness & Wellbeing,192,0,3518,DR
12/4/2021,Chiropractor /Expense/Personal/Health & Medical,Chiropractor ,Expense,Personal,Health & Medical,218,0,3300,DR
13/4/2021,Woolworths /Expense/Household/Groceries,Woolworths ,Expense,Household,Groceries,281,0,3019,DR
13/4/2021,Scouts Australia /Expense/Leisure & Lifestyle/Hobbies,Scouts Australia ,Expense,Leisure & Lifestyle,Hobbies,167,0,2852,DR
13/4/2021,Beacon Lighting /Expense/Household/Maintenance & Improvements,Beacon Lighting ,Expense,Household,Maintenance & Improvements,73,0,2779,DR
13/4/2021,PayPal Transfer from Sale /Income/Income/Other Income,PayPal Transfer from Sale ,Income,Income,Other Income,217,0,2562,DR
13/4/2021,Little Athletics /Expense/Personal/Fitness & Wellbeing,Little Athletics ,Expense,Personal,Fitness & Wellbeing,105,0,2457,DR
13/4/2021,Witchery /Expense/Personal/Clothing & Accessories,Witchery ,Expense,Personal,Clothing & Accessories,235,0,2222,DR
14/4/2021,Witchery /Expense/Personal/Clothing & Accessories,Witchery ,Expense,Personal,Clothing & Accessories,157,0,2065,DR
14/4/2021,Who Gives A Crap /Expense/Household/Groceries,Who Gives A Crap ,Expense,Household,Groceries,164,0,1901,DR
14/4/2021, Meriton Apartments /Expense/Household/Rates & Insurance, Meriton Apartments ,Expense,Household,Rates & Insurance,105,0,1796,DR
15/4/2021,Chiropractor /Expense/Personal/Health & Medical,Chiropractor ,Expense,Personal,Health & Medical,108,0,1688,DR
15/4/2021,CommSec Share Trading Gains /Income/Income/Investments,CommSec Share Trading Gains ,Income,Income,Investments,70,0,1618,DR
15/4/2021,"Budget Direct Car Insurance /Expense/Transport/Car Insurance, Rego & Maintenance",Budget Direct Car Insurance ,Expense,Transport,"Car Insurance, Rego & Maintenance",5,0,1613,DR
17/4/2021," Fantastic Furniture /Expense/Household/Furniture, Electronics & Homewares", Fantastic Furniture ,Expense,Household,"Furniture, Electronics & Homewares",148,0,1465,DR
18/4/2021,"VicRoads /Expense/Transport/Car Insurance, Rego & Maintenance",VicRoads ,Expense,Transport,"Car Insurance, Rego & Maintenance",67,0,1398,DR
18/4/2021,Local Fish and Chips /Expense/Leisure & Lifestyle/Takeaway,Local Fish and Chips ,Expense,Leisure & Lifestyle,Takeaway,70,0,1328,DR
19/4/2021,"Kayo Sports /Expense/Leisure & Lifestyle/Tv, Music & Streaming",Kayo Sports ,Expense,Leisure & Lifestyle,"Tv, Music & Streaming",106,0,1222,DR
23/4/2021,"Bridgestone Select /Expense/Transport/Car Insurance, Rego & Maintenance",Bridgestone Select ,Expense,Transport,"Car Insurance, Rego & Maintenance",27,0,1195,DR
23/4/2021,The Iconic /Expense/Personal/Clothing & Accessories,The Iconic ,Expense,Personal,Clothing & Accessories,116,0,1079,DR
26/4/2021,Childcare Payments /Expense/Personal/Children & Family,Childcare Payments ,Expense,Personal,Children & Family,39,0,1040,DR
26/4/2021,Liquorland /Expense/Leisure & Lifestyle/Alcohol,Liquorland ,Expense,Leisure & Lifestyle,Alcohol,71,0,969,DR
26/4/2021,Booktopia /Expense/Leisure & Lifestyle/Hobbies,Booktopia ,Expense,Leisure & Lifestyle,Hobbies,91,0,878,DR
27/4/2021,Apple Store /Expense/Leisure & Lifestyle/Electronics,Apple Store ,Expense,Leisure & Lifestyle,Electronics,42,0,836,DR
27/4/2021,BP /Expense/Transport/Fuel,BP ,Expense,Transport,Fuel,41,0,795,DR
27/4/2021,"The Good Guys /Expense/Household/Furniture, Electronics & Homewares",The Good Guys ,Expense,Household,"Furniture, Electronics & Homewares",17,0,778,DR
27/4/2021,"Green Slip Insurance /Expense/Transport/Car Insurance, Rego & Maintenance",Green Slip Insurance ,Expense,Transport,"Car Insurance, Rego & Maintenance",70,0,708,DR
27/4/2021, Brisbane City Council /Expense/Household/Rates & Insurance, Brisbane City Council ,Expense,Household,Rates & Insurance,38,0,670,DR
28/4/2021,Ballet Schools /Expense/Personal/Fitness & Wellbeing,Ballet Schools ,Expense,Personal,Fitness & Wellbeing,65,0,605,DR
1/5/2021,Monthly Income,Monthly Income,Income,Income,Wages,0,6000,6605,CR
2/5/2021,Acupuncture Clinic /Expense/Personal/Health & Medical,Acupuncture Clinic ,Expense,Personal,Health & Medical,368,0,6237,DR
4/5/2021,"Netflix /Expense/Leisure & Lifestyle/Tv, Music & Streaming",Netflix ,Expense,Leisure & Lifestyle,"Tv, Music & Streaming",518,0,5719,DR
4/5/2021,Woolworths /Expense/Household/Groceries,Woolworths ,Expense,Household,Groceries,524,0,5195,DR
5/5/2021,QBE Insurance Claim Payout /Income/Income/Other Income,QBE Insurance Claim Payout ,Income,Income,Other Income,416,0,4779,DR
6/5/2021,Music Academy /Expense/Leisure & Lifestyle/Hobbies,Music Academy ,Expense,Leisure & Lifestyle,Hobbies,437,0,4342,DR
7/5/2021,"Spotify /Expense/Leisure & Lifestyle/Tv, Music & Streaming",Spotify ,Expense,Leisure & Lifestyle,"Tv, Music & Streaming",385,0,3957,DR
7/5/2021," Fantastic Furniture /Expense/Household/Furniture, Electronics & Homewares", Fantastic Furniture ,Expense,Household,"Furniture, Electronics & Homewares",144,0,3813,DR
8/5/2021,IKEA /Expense/Household/Maintenance & Improvements,IKEA ,Expense,Household,Maintenance & Improvements,10,0,3803,DR
8/5/2021,G8 Education /Expense/Personal/Children & Family,G8 Education ,Expense,Personal,Children & Family,28,0,3775,DR
8/5/2021,School Locker /Expense/Personal/Children & Family,School Locker ,Expense,Personal,Children & Family,62,0,3713,DR
10/5/2021,"Adairs /Expense/Household/Furniture, Electronics & Homewares",Adairs ,Expense,Household,"Furniture, Electronics & Homewares",251,0,3462,DR
12/5/2021,The Rocks Bar and Pub /Expense/Leisure & Lifestyle/Pubs & Bars,The Rocks Bar and Pub ,Expense,Leisure & Lifestyle,Pubs & Bars,15,0,3447,DR
12/5/2021,Soccer Clubs /Expense/Personal/Fitness & Wellbeing,Soccer Clubs ,Expense,Personal,Fitness & Wellbeing,340,0,3107,DR
13/5/2021,"Netflix /Expense/Leisure & Lifestyle/Tv, Music & Streaming",Netflix ,Expense,Leisure & Lifestyle,"Tv, Music & Streaming",33,0,3074,DR
13/5/2021,Aqua Fun Park /Expense/Leisure & Lifestyle/Holidays & Travel,Aqua Fun Park ,Expense,Leisure & Lifestyle,Holidays & Travel,290,0,2784,DR
14/5/2021,Local Hospital /Expense/Personal/Health & Medical,Local Hospital ,Expense,Personal,Health & Medical,196,0,2588,DR
14/5/2021,Crown Perth /Expense/Leisure & Lifestyle/Pubs & Bars,Crown Perth ,Expense,Leisure & Lifestyle,Pubs & Bars,19,0,2569,DR
15/5/2021,"Spotify /Expense/Leisure & Lifestyle/Tv, Music & Streaming",Spotify ,Expense,Leisure & Lifestyle,"Tv, Music & Streaming",50,0,2519,DR
16/5/2021,"Stan /Expense/Leisure & Lifestyle/Tv, Music & Streaming",Stan ,Expense,Leisure & Lifestyle,"Tv, Music & Streaming",243,0,2276,DR
17/5/2021,"Foxtel /Expense/Leisure & Lifestyle/Tv, Music & Streaming",Foxtel ,Expense,Leisure & Lifestyle,"Tv, Music & Streaming",187,0,2089,DR
17/5/2021,Mathnasium /Expense/Personal/Education,Mathnasium ,Expense,Personal,Education,117,0,1972,DR
17/5/2021,Interest Payment from Commonwealth Bank /Income/Income/Investments,Interest Payment from Commonwealth Bank ,Income,Income,Investments,134,0,1838,DR
18/5/2021,"NRMA Roadside Assistance /Expense/Transport/Car Insurance, Rego & Maintenance",NRMA Roadside Assistance ,Expense,Transport,"Car Insurance, Rego & Maintenance",72,0,1766,DR
18/5/2021,Café Nero /Expense/Leisure & Lifestyle/Restaurants & Cafes,Café Nero ,Expense,Leisure & Lifestyle,Restaurants & Cafes,166,0,1600,DR
18/5/2021,Payday Advance /Income/Income/Other Income,Payday Advance ,Income,Income,Other Income,92,0,1508,DR
19/5/2021,Swim Australia /Expense/Personal/Fitness & Wellbeing,Swim Australia ,Expense,Personal,Fitness & Wellbeing,91,0,1417,DR
20/5/2021,Grill'd /Expense/Leisure & Lifestyle/Takeaway,Grill'd ,Expense,Leisure & Lifestyle,Takeaway,9,0,1408,DR
20/5/2021,The Athlete's Foot /Expense/Personal/Clothing & Accessories,The Athlete's Foot ,Expense,Personal,Clothing & Accessories,11,0,1397,DR
20/5/2021,Local Hospital /Expense/Personal/Health & Medical,Local Hospital ,Expense,Personal,Health & Medical,90,0,1307,DR
21/5/2021,"Ultra Tune /Expense/Transport/Car Insurance, Rego & Maintenance",Ultra Tune ,Expense,Transport,"Car Insurance, Rego & Maintenance",7,0,1300,DR
21/5/2021,Myer /Expense/Personal/Clothing & Accessories,Myer ,Expense,Personal,Clothing & Accessories,99,0,1201,DR
22/5/2021,BP /Expense/Transport/Fuel,BP ,Expense,Transport,Fuel,45,0,1156,DR
22/5/2021,Guardian Childcare & Education /Expense/Personal/Children & Family,Guardian Childcare & Education ,Expense,Personal,Children & Family,92,0,1064,DR
23/5/2021,TerryWhite Chemmart /Expense/Personal/Health & Medical,TerryWhite Chemmart ,Expense,Personal,Health & Medical,30,0,1034,DR
23/5/2021,Swim Australia /Expense/Personal/Fitness & Wellbeing,Swim Australia ,Expense,Personal,Fitness & Wellbeing,39,0,995,DR
25/5/2021,Chinatown Night Market /Expense/Leisure & Lifestyle/Pubs & Bars,Chinatown Night Market ,Expense,Leisure & Lifestyle,Pubs & Bars,75,0,920,DR
25/5/2021,Westpac Dividend Deposit /Income/Income/Investments,Westpac Dividend Deposit ,Income,Income,Investments,20,0,900,DR
25/5/2021,Vodafone Prepaid /Expense/Personal/Mobile Phone,Vodafone Prepaid ,Expense,Personal,Mobile Phone,64,0,836,DR
26/5/2021, Meriton Apartments /Expense/Household/Rates & Insurance, Meriton Apartments ,Expense,Household,Rates & Insurance,38,0,798,DR
26/5/2021,Hobart Brewing Company /Expense/Leisure & Lifestyle/Pubs & Bars,Hobart Brewing Company ,Expense,Leisure & Lifestyle,Pubs & Bars,75,0,723,DR
27/5/2021,School Locker /Expense/Personal/Children & Family,School Locker ,Expense,Personal,Children & Family,59,0,664,DR
27/5/2021,Ladbrokes /Expense/Leisure & Lifestyle/Lottery & Gambling,Ladbrokes ,Expense,Leisure & Lifestyle,Lottery & Gambling,66,0,598,DR
27/5/2021,Shell V Power/Expense/Transport/Fuel,Shell V Power,Expense,Transport,Fuel,12,0,586,DR
28/5/2021,Camp Australia /Expense/Leisure & Lifestyle/Hobbies,Camp Australia ,Expense,Leisure & Lifestyle,Hobbies,14,0,572,DR
1/6/2021,Monthly Income,Monthly Income,Income,Income,Wages,0,6000,6572,CR
2/6/2021,Queensland Urban Utilities /Expense/Household/Utilities,Queensland Urban Utilities ,Expense,Household,Utilities,22,0,6550,DR
2/6/2021,David Jones /Expense/Personal/Clothing & Accessories,David Jones ,Expense,Personal,Clothing & Accessories,111,0,6439,DR
2/6/2021,"Green Slip Insurance /Expense/Transport/Car Insurance, Rego & Maintenance",Green Slip Insurance ,Expense,Transport,"Car Insurance, Rego & Maintenance",324,0,6115,DR
3/6/2021,AMF Bowling /Expense/Leisure & Lifestyle/Entertainment,AMF Bowling ,Expense,Leisure & Lifestyle,Entertainment,195,0,5920,DR
4/6/2021,Billabong /Expense/Personal/Clothing & Accessories,Billabong ,Expense,Personal,Clothing & Accessories,551,0,5369,DR
5/6/2021,"Disney+ /Expense/Leisure & Lifestyle/Tv, Music & Streaming",Disney+ ,Expense,Leisure & Lifestyle,"Tv, Music & Streaming",145,0,5224,DR
5/6/2021,F45 Training /Expense/Personal/Fitness & Wellbeing,F45 Training ,Expense,Personal,Fitness & Wellbeing,91,0,5133,DR
6/6/2021,IKEA /Expense/Household/Maintenance & Improvements,IKEA ,Expense,Household,Maintenance & Improvements,141,0,4992,DR
8/6/2021,Childcare Payments /Expense/Personal/Children & Family,Childcare Payments ,Expense,Personal,Children & Family,220,0,4772,DR
8/6/2021,TerryWhite Chemmart /Expense/Personal/Health & Medical,TerryWhite Chemmart ,Expense,Personal,Health & Medical,458,0,4314,DR
10/6/2021,Muffin Break /Expense/Leisure & Lifestyle/Restaurants & Cafes,Muffin Break ,Expense,Leisure & Lifestyle,Restaurants & Cafes,362,0,3952,DR
11/6/2021,Village Cinemas /Expense/Leisure & Lifestyle/Entertainment,Village Cinemas ,Expense,Leisure & Lifestyle,Entertainment,187,0,3765,DR
12/6/2021,The Ivy /Expense/Leisure & Lifestyle/Pubs & Bars,The Ivy ,Expense,Leisure & Lifestyle,Pubs & Bars,338,0,3427,DR
13/6/2021,Kumon /Expense/Personal/Education,Kumon ,Expense,Personal,Education,65,0,3362,DR
16/6/2021,Shell V Power/Expense/Transport/Fuel,Shell V Power,Expense,Transport,Fuel,95,0,3267,DR
16/6/2021,Endota Spa /Expense/Personal/Fitness & Wellbeing,Endota Spa ,Expense,Personal,Fitness & Wellbeing,73,0,3194,DR
18/6/2021,Music Academy /Expense/Leisure & Lifestyle/Hobbies,Music Academy ,Expense,Leisure & Lifestyle,Hobbies,259,0,2935,DR
19/6/2021, Slater and Gordon Lawyers /Expense/Personal/Life Admin, Slater and Gordon Lawyers ,Expense,Personal,Life Admin,86,0,2849,DR
19/6/2021,"Adairs /Expense/Household/Furniture, Electronics & Homewares",Adairs ,Expense,Household,"Furniture, Electronics & Homewares",255,0,2594,DR
19/6/2021,Fernwood Fitness /Expense/Personal/Fitness & Wellbeing,Fernwood Fitness ,Expense,Personal,Fitness & Wellbeing,86,0,2508,DR
20/6/2021, NRMA Insurance /Expense/Household/Rates & Insurance, NRMA Insurance ,Expense,Household,Rates & Insurance,35,0,2473,DR
21/6/2021,Rebel Sport /Expense/Personal/Fitness & Wellbeing,Rebel Sport ,Expense,Personal,Fitness & Wellbeing,229,0,2244,DR
22/6/2021,Origin Energy /Expense/Household/Utilities,Origin Energy ,Expense,Household,Utilities,51,0,2193,DR
23/6/2021,Ladbrokes /Expense/Leisure & Lifestyle/Lottery & Gambling,Ladbrokes ,Expense,Leisure & Lifestyle,Lottery & Gambling,83,0,2110,DR
24/6/2021, Slater and Gordon Lawyers /Expense/Personal/Life Admin, Slater and Gordon Lawyers ,Expense,Personal,Life Admin,161,0,1949,DR
28/6/2021,Karate for Kids /Expense/Personal/Fitness & Wellbeing,Karate for Kids ,Expense,Personal,Fitness & Wellbeing,157,0,1792,DR
28/6/2021,Optometrist /Expense/Personal/Health & Medical,Optometrist ,Expense,Personal,Health & Medical,128,0,1664,DR
28/6/2021,Endota Spa /Expense/Personal/Fitness & Wellbeing,Endota Spa ,Expense,Personal,Fitness & Wellbeing,16,0,1648,DR
1/7/2021,Monthly Income,Monthly Income,Income,Income,Wages,0,6000,7648,CR
2/7/2021, Slater and Gordon Lawyers /Expense/Personal/Life Admin, Slater and Gordon Lawyers ,Expense,Personal,Life Admin,391,0,7257,DR
2/7/2021,Hungry Jack’s /Expense/Leisure & Lifestyle/Takeaway,Hungry Jack’s ,Expense,Leisure & Lifestyle,Takeaway,500,0,6757,DR
2/7/2021,Caltex /Expense/Transport/Fuel,Caltex ,Expense,Transport,Fuel,276,0,6481,DR
3/7/2021,The Victory Hotel /Expense/Leisure & Lifestyle/Pubs & Bars,The Victory Hotel ,Expense,Leisure & Lifestyle,Pubs & Bars,31,0,6450,DR
3/7/2021,Big W /Expense/Personal/Children & Family,Big W ,Expense,Personal,Children & Family,565,0,5885,DR
4/7/2021, Metricon /Expense/Household/Maintenance & Improvements, Metricon ,Expense,Household,Maintenance & Improvements,407,0,5478,DR
4/7/2021,OfficeMax /Expense/Personal/Life Admin,OfficeMax ,Expense,Personal,Life Admin,529,0,4949,DR
5/7/2021,Montessori Schools /Expense/Personal/Education,Montessori Schools ,Expense,Personal,Education,375,0,4574,DR
5/7/2021,Ballet Schools /Expense/Personal/Fitness & Wellbeing,Ballet Schools ,Expense,Personal,Fitness & Wellbeing,67,0,4507,DR
6/7/2021,Physiotherapy Clinic /Expense/Personal/Health & Medical,Physiotherapy Clinic ,Expense,Personal,Health & Medical,190,0,4317,DR
6/7/2021,Beachside Yoga Classes /Expense/Personal/Fitness & Wellbeing,Beachside Yoga Classes ,Expense,Personal,Fitness & Wellbeing,398,0,3919,DR
6/7/2021,Tabcorp /Expense/Leisure & Lifestyle/Lottery & Gambling,Tabcorp ,Expense,Leisure & Lifestyle,Lottery & Gambling,87,0,3832,DR
6/7/2021,Bunnings Warehouse /Expense/Household/Maintenance & Improvements,Bunnings Warehouse ,Expense,Household,Maintenance & Improvements,365,0,3467,DR
7/7/2021,Chinatown Night Market /Expense/Leisure & Lifestyle/Pubs & Bars,Chinatown Night Market ,Expense,Leisure & Lifestyle,Pubs & Bars,294,0,3173,DR
7/7/2021,"Audible /Expense/Leisure & Lifestyle/Tv, Music & Streaming",Audible ,Expense,Leisure & Lifestyle,"Tv, Music & Streaming",148,0,3025,DR
8/7/2021,G8 Education /Expense/Personal/Children & Family,G8 Education ,Expense,Personal,Children & Family,226,0,2799,DR
8/7/2021,"MyCar Tyre & Auto /Expense/Transport/Car Insurance, Rego & Maintenance",MyCar Tyre & Auto ,Expense,Transport,"Car Insurance, Rego & Maintenance",89,0,2710,DR
8/7/2021,Anytime Fitness /Expense/Personal/Fitness & Wellbeing,Anytime Fitness ,Expense,Personal,Fitness & Wellbeing,170,0,2540,DR
9/7/2021,South East Water /Expense/Household/Utilities,South East Water ,Expense,Household,Utilities,247,0,2293,DR
9/7/2021,Timezone /Expense/Leisure & Lifestyle/Entertainment,Timezone ,Expense,Leisure & Lifestyle,Entertainment,46,0,2247,DR
10/7/2021,BrewDog /Expense/Leisure & Lifestyle/Alcohol,BrewDog ,Expense,Leisure & Lifestyle,Alcohol,117,0,2130,DR
10/7/2021,"JAX Tyres /Expense/Transport/Car Insurance, Rego & Maintenance",JAX Tyres ,Expense,Transport,"Car Insurance, Rego & Maintenance",110,0,2020,DR
11/7/2021,Café Nero /Expense/Leisure & Lifestyle/Restaurants & Cafes,Café Nero ,Expense,Leisure & Lifestyle,Restaurants & Cafes,96,0,1924,DR
11/7/2021,Eau De Vie /Expense/Leisure & Lifestyle/Pubs & Bars,Eau De Vie ,Expense,Leisure & Lifestyle,Pubs & Bars,15,0,1909,DR
12/7/2021,"EB Games /Expense/Leisure & Lifestyle/Apps, Games & Software",EB Games ,Expense,Leisure & Lifestyle,"Apps, Games & Software",37,0,1872,DR
12/7/2021,Tennis Australia /Expense/Personal/Fitness & Wellbeing,Tennis Australia ,Expense,Personal,Fitness & Wellbeing,123,0,1749,DR
12/7/2021,Massage Therapy Center /Expense/Personal/Health & Medical,Massage Therapy Center ,Expense,Personal,Health & Medical,105,0,1644,DR
13/7/2021,Childcare Payments /Expense/Personal/Children & Family,Childcare Payments ,Expense,Personal,Children & Family,103,0,1541,DR
13/7/2021,Little Athletics /Expense/Personal/Fitness & Wellbeing,Little Athletics ,Expense,Personal,Fitness & Wellbeing,42,0,1499,DR
14/7/2021,"Autobarn /Expense/Transport/Car Insurance, Rego & Maintenance",Autobarn ,Expense,Transport,"Car Insurance, Rego & Maintenance",32,0,1467,DR
14/7/2021,AustralianSuper Pension /Income/Income/Other Income,AustralianSuper Pension ,Income,Income,Other Income,25,0,1442,DR
15/7/2021,"Bridgestone Select /Expense/Transport/Car Insurance, Rego & Maintenance",Bridgestone Select ,Expense,Transport,"Car Insurance, Rego & Maintenance",98,0,1344,DR
16/7/2021,Local Fish and Chips /Expense/Leisure & Lifestyle/Takeaway,Local Fish and Chips ,Expense,Leisure & Lifestyle,Takeaway,135,0,1209,DR
17/7/2021,"Binge /Expense/Leisure & Lifestyle/Tv, Music & Streaming",Binge ,Expense,Leisure & Lifestyle,"Tv, Music & Streaming",109,0,1100,DR
17/7/2021,Adobe Creative Cloud /Expense/Leisure & Lifestyle/Hobbies,Adobe Creative Cloud ,Expense,Leisure & Lifestyle,Hobbies,110,0,990,DR
17/7/2021,Beachside Caravan Park /Expense/Leisure & Lifestyle/Holidays & Travel,Beachside Caravan Park ,Expense,Leisure & Lifestyle,Holidays & Travel,38,0,952,DR
17/7/2021,"The Good Guys /Expense/Household/Furniture, Electronics & Homewares",The Good Guys ,Expense,Household,"Furniture, Electronics & Homewares",38,0,914,DR
20/7/2021,Beacon Lighting /Expense/Household/Maintenance & Improvements,Beacon Lighting ,Expense,Household,Maintenance & Improvements,43,0,871,DR
20/7/2021,Physiotherapy Clinic /Expense/Personal/Health & Medical,Physiotherapy Clinic ,Expense,Personal,Health & Medical,23,0,848,DR
20/7/2021,TerryWhite Chemmart /Expense/Personal/Health & Medical,TerryWhite Chemmart ,Expense,Personal,Health & Medical,49,0,799,DR
22/7/2021,BrewDog /Expense/Leisure & Lifestyle/Alcohol,BrewDog ,Expense,Leisure & Lifestyle,Alcohol,19,0,780,DR
22/7/2021,T2 Tea /Expense/Personal/Fitness & Wellbeing,T2 Tea ,Expense,Personal,Fitness & Wellbeing,55,0,725,DR
22/7/2021,Costco /Expense/Household/Groceries,Costco ,Expense,Household,Groceries,7,0,718,DR
23/7/2021,Ballet Schools /Expense/Personal/Fitness & Wellbeing,Ballet Schools ,Expense,Personal,Fitness & Wellbeing,36,0,682,DR
23/7/2021,Mathnasium /Expense/Personal/Education,Mathnasium ,Expense,Personal,Education,64,0,618,DR
23/7/2021,Hobart Brewing Company /Expense/Leisure & Lifestyle/Pubs & Bars,Hobart Brewing Company ,Expense,Leisure & Lifestyle,Pubs & Bars,24,0,594,DR
24/7/2021,Priceline Pharmacy /Expense/Personal/Health & Medical,Priceline Pharmacy ,Expense,Personal,Health & Medical,17,0,577,DR
24/7/2021, Commonwealth Bank /Expense/Household/Rent & Mortgage, Commonwealth Bank ,Expense,Household,Rent & Mortgage,52,0,525,DR
24/7/2021,AustralianSuper Pension /Income/Income/Other Income,AustralianSuper Pension ,Income,Income,Other Income,22,0,503,DR
24/7/2021,BP /Expense/Transport/Fuel,BP ,Expense,Transport,Fuel,15,0,488,DR
25/7/2021,"EB Games /Expense/Leisure & Lifestyle/Apps, Games & Software",EB Games ,Expense,Leisure & Lifestyle,"Apps, Games & Software",23,0,465,DR
25/7/2021,Dymocks /Expense/Leisure & Lifestyle/Hobbies,Dymocks ,Expense,Leisure & Lifestyle,Hobbies,33,0,432,DR
25/7/2021,Greencross Vets /Expense/Household/Pets,Greencross Vets ,Expense,Household,Pets,32,0,400,DR
25/7/2021,Rip Curl /Expense/Personal/Clothing & Accessories,Rip Curl ,Expense,Personal,Clothing & Accessories,30,0,370,DR
27/7/2021,"Budget Direct Car Insurance /Expense/Transport/Car Insurance, Rego & Maintenance",Budget Direct Car Insurance ,Expense,Transport,"Car Insurance, Rego & Maintenance",26,0,344,DR
1/8/2021,Monthly Income,Monthly Income,Income,Income,Wages,0,6000,6344,CR
2/8/2021,Muffin Break /Expense/Leisure & Lifestyle/Restaurants & Cafes,Muffin Break ,Expense,Leisure & Lifestyle,Restaurants & Cafes,495,0,5849,DR
2/8/2021,Sunnybank Hotel /Expense/Leisure & Lifestyle/Pubs & Bars,Sunnybank Hotel ,Expense,Leisure & Lifestyle,Pubs & Bars,548,0,5301,DR
2/8/2021,Zone Bowling /Expense/Leisure & Lifestyle/Entertainment,Zone Bowling ,Expense,Leisure & Lifestyle,Entertainment,426,0,4875,DR
3/8/2021,"Binge /Expense/Leisure & Lifestyle/Tv, Music & Streaming",Binge ,Expense,Leisure & Lifestyle,"Tv, Music & Streaming",171,0,4704,DR
3/8/2021,"EB Games /Expense/Leisure & Lifestyle/Apps, Games & Software",EB Games ,Expense,Leisure & Lifestyle,"Apps, Games & Software",259,0,4445,DR
3/8/2021,EnergyAustralia /Expense/Household/Utilities,EnergyAustralia ,Expense,Household,Utilities,44,0,4401,DR
4/8/2021,The Rocks Bar and Pub /Expense/Leisure & Lifestyle/Pubs & Bars,The Rocks Bar and Pub ,Expense,Leisure & Lifestyle,Pubs & Bars,226,0,4175,DR
4/8/2021,Ice Cream Parlour /Expense/Leisure & Lifestyle/Takeaway,Ice Cream Parlour ,Expense,Leisure & Lifestyle,Takeaway,167,0,4008,DR
4/8/2021,Child Support Agency Deposit /Income/Income/Other Income,Child Support Agency Deposit ,Income,Income,Other Income,317,0,3691,DR
4/8/2021,The Athlete's Foot /Expense/Personal/Clothing & Accessories,The Athlete's Foot ,Expense,Personal,Clothing & Accessories,28,0,3663,DR
4/8/2021,Beachside Yoga Classes /Expense/Personal/Fitness & Wellbeing,Beachside Yoga Classes ,Expense,Personal,Fitness & Wellbeing,274,0,3389,DR
4/8/2021,Hobart Brewing Company /Expense/Leisure & Lifestyle/Pubs & Bars,Hobart Brewing Company ,Expense,Leisure & Lifestyle,Pubs & Bars,229,0,3160,DR
4/8/2021, Jim’s Building Inspections /Expense/Household/Maintenance & Improvements, Jim’s Building Inspections ,Expense,Household,Maintenance & Improvements,154,0,3006,DR
5/8/2021,Airbnb Host Income /Income/Income/Other Income,Airbnb Host Income ,Income,Income,Other Income,236,0,2770,DR
5/8/2021,Beachside Yoga Classes /Expense/Personal/Fitness & Wellbeing,Beachside Yoga Classes ,Expense,Personal,Fitness & Wellbeing,18,0,2752,DR
6/8/2021,G8 Education /Expense/Personal/Children & Family,G8 Education ,Expense,Personal,Children & Family,109,0,2643,DR
6/8/2021,Who Gives A Crap /Expense/Household/Groceries,Who Gives A Crap ,Expense,Household,Groceries,115,0,2528,DR
8/8/2021,Camp Australia /Expense/Leisure & Lifestyle/Hobbies,Camp Australia ,Expense,Leisure & Lifestyle,Hobbies,134,0,2394,DR
9/8/2021,Melbourne Central Lion Hotel /Expense/Leisure & Lifestyle/Pubs & Bars,Melbourne Central Lion Hotel ,Expense,Leisure & Lifestyle,Pubs & Bars,111,0,2283,DR
9/8/2021,"The Good Guys /Expense/Household/Furniture, Electronics & Homewares",The Good Guys ,Expense,Household,"Furniture, Electronics & Homewares",187,0,2096,DR
10/8/2021,Fitness First /Expense/Personal/Fitness & Wellbeing,Fitness First ,Expense,Personal,Fitness & Wellbeing,23,0,2073,DR
11/8/2021,Surf Dive 'n Ski /Expense/Personal/Clothing & Accessories,Surf Dive 'n Ski ,Expense,Personal,Clothing & Accessories,52,0,2021,DR
11/8/2021,Chemist Warehouse /Expense/Personal/Health & Medical,Chemist Warehouse ,Expense,Personal,Health & Medical,10,0,2011,DR
12/8/2021,VetLove /Expense/Household/Pets,VetLove ,Expense,Household,Pets,124,0,1887,DR
13/8/2021,Zone Bowling /Expense/Leisure & Lifestyle/Entertainment,Zone Bowling ,Expense,Leisure & Lifestyle,Entertainment,66,0,1821,DR
14/8/2021,Anytime Fitness /Expense/Personal/Fitness & Wellbeing,Anytime Fitness ,Expense,Personal,Fitness & Wellbeing,182,0,1639,DR
15/8/2021,Optometrist /Expense/Personal/Health & Medical,Optometrist ,Expense,Personal,Health & Medical,67,0,1572,DR
15/8/2021,Endota Spa /Expense/Personal/Fitness & Wellbeing,Endota Spa ,Expense,Personal,Fitness & Wellbeing,116,0,1456,DR
16/8/2021,Who Gives A Crap /Expense/Household/Groceries,Who Gives A Crap ,Expense,Household,Groceries,124,0,1332,DR
16/8/2021,Swim Australia /Expense/Personal/Fitness & Wellbeing,Swim Australia ,Expense,Personal,Fitness & Wellbeing,63,0,1269,DR
16/8/2021,Lorna Jane /Expense/Personal/Clothing & Accessories,Lorna Jane ,Expense,Personal,Clothing & Accessories,109,0,1160,DR
16/8/2021,Mathnasium /Expense/Personal/Education,Mathnasium ,Expense,Personal,Education,116,0,1044,DR
18/8/2021,Chiropractor /Expense/Personal/Health & Medical,Chiropractor ,Expense,Personal,Health & Medical,7,0,1037,DR
19/8/2021,Chinatown Night Market /Expense/Leisure & Lifestyle/Pubs & Bars,Chinatown Night Market ,Expense,Leisure & Lifestyle,Pubs & Bars,70,0,967,DR
19/8/2021,Upwork Freelancer Payment /Income/Income/Other Income,Upwork Freelancer Payment ,Income,Income,Other Income,60,0,907,DR
19/8/2021,Grill'd /Expense/Leisure & Lifestyle/Takeaway,Grill'd ,Expense,Leisure & Lifestyle,Takeaway,32,0,875,DR
20/8/2021,eBay Sales Proceeds /Income/Income/Other Income,eBay Sales Proceeds ,Income,Income,Other Income,17,0,858,DR
20/8/2021,CommSec Share Trading Gains /Income/Income/Investments,CommSec Share Trading Gains ,Income,Income,Investments,56,0,802,DR
21/8/2021,Fernwood Fitness /Expense/Personal/Fitness & Wellbeing,Fernwood Fitness ,Expense,Personal,Fitness & Wellbeing,55,0,747,DR
21/8/2021,"Harvey Norman /Expense/Household/Furniture, Electronics & Homewares",Harvey Norman ,Expense,Household,"Furniture, Electronics & Homewares",70,0,677,DR
21/8/2021,Cookie /Expense/Leisure & Lifestyle/Pubs & Bars,Cookie ,Expense,Leisure & Lifestyle,Pubs & Bars,67,0,610,DR
22/8/2021,Vodafone Prepaid /Expense/Personal/Mobile Phone,Vodafone Prepaid ,Expense,Personal,Mobile Phone,26,0,584,DR
22/8/2021,"Binge /Expense/Leisure & Lifestyle/Tv, Music & Streaming",Binge ,Expense,Leisure & Lifestyle,"Tv, Music & Streaming",31,0,553,DR
22/8/2021,Childcare Payments /Expense/Personal/Children & Family,Childcare Payments ,Expense,Personal,Children & Family,34,0,519,DR
23/8/2021,"Autobarn /Expense/Transport/Car Insurance, Rego & Maintenance",Autobarn ,Expense,Transport,"Car Insurance, Rego & Maintenance",18,0,501,DR
24/8/2021,"Disney+ /Expense/Leisure & Lifestyle/Tv, Music & Streaming",Disney+ ,Expense,Leisure & Lifestyle,"Tv, Music & Streaming",51,0,450,DR
24/8/2021,Telstra /Expense/Personal/Mobile Phone,Telstra ,Expense,Personal,Mobile Phone,23,0,427,DR
24/8/2021, BSA Ltd /Expense/Household/Maintenance & Improvements, BSA Ltd ,Expense,Household,Maintenance & Improvements,12,0,415,DR
27/8/2021,Payday Advance /Income/Income/Other Income,Payday Advance ,Income,Income,Other Income,7,0,408,DR
27/8/2021,Muffin Break /Expense/Leisure & Lifestyle/Restaurants & Cafes,Muffin Break ,Expense,Leisure & Lifestyle,Restaurants & Cafes,33,0,375,DR
28/8/2021,Sea Kayak Tours /Expense/Leisure & Lifestyle/Holidays & Travel,Sea Kayak Tours ,Expense,Leisure & Lifestyle,Holidays & Travel,24,0,351,DR
28/8/2021,T2 Tea /Expense/Personal/Fitness & Wellbeing,T2 Tea ,Expense,Personal,Fitness & Wellbeing,22,0,329,DR
28/8/2021,ATO Tax Refund /Income/Income/Other Income,ATO Tax Refund ,Income,Income,Other Income,27,0,302,DR
28/8/2021,Hungry Jack’s /Expense/Leisure & Lifestyle/Takeaway,Hungry Jack’s ,Expense,Leisure & Lifestyle,Takeaway,18,0,284,DR
1/9/2021,Monthly Income,Monthly Income,Income,Income,Wages,0,6000,6284,CR
4/9/2021,Salary Deposit from Woolworths Group /Income/Income/Wages,Salary Deposit from Woolworths Group ,Income,Income,Wages,475,0,5809,DR
4/9/2021,"Apple Music /Expense/Leisure & Lifestyle/Tv, Music & Streaming",Apple Music ,Expense,Leisure & Lifestyle,"Tv, Music & Streaming",255,0,5554,DR
5/9/2021,JB HiFi/Expense/Leisure & Lifestyle/Electronics,JB HiFi,Expense,Leisure & Lifestyle,Electronics,391,0,5163,DR
7/9/2021, BSA Ltd /Expense/Household/Maintenance & Improvements, BSA Ltd ,Expense,Household,Maintenance & Improvements,24,0,5139,DR
9/9/2021,Greencross Vets /Expense/Household/Pets,Greencross Vets ,Expense,Household,Pets,5,0,5134,DR
10/9/2021,Event Cinemas /Expense/Leisure & Lifestyle/Entertainment,Event Cinemas ,Expense,Leisure & Lifestyle,Entertainment,302,0,4832,DR
10/9/2021,Endota Spa /Expense/Personal/Fitness & Wellbeing,Endota Spa ,Expense,Personal,Fitness & Wellbeing,433,0,4399,DR
11/9/2021,Ice Cream Parlour /Expense/Leisure & Lifestyle/Takeaway,Ice Cream Parlour ,Expense,Leisure & Lifestyle,Takeaway,129,0,4270,DR
11/9/2021,Fernwood Fitness /Expense/Personal/Fitness & Wellbeing,Fernwood Fitness ,Expense,Personal,Fitness & Wellbeing,314,0,3956,DR
12/9/2021,F45 Training /Expense/Personal/Fitness & Wellbeing,F45 Training ,Expense,Personal,Fitness & Wellbeing,167,0,3789,DR
12/9/2021,Rip Curl /Expense/Personal/Clothing & Accessories,Rip Curl ,Expense,Personal,Clothing & Accessories,311,0,3478,DR
14/9/2021,Shell V Power/Expense/Transport/Fuel,Shell V Power,Expense,Transport,Fuel,40,0,3438,DR
15/9/2021,Queensland Urban Utilities /Expense/Household/Utilities,Queensland Urban Utilities ,Expense,Household,Utilities,17,0,3421,DR
15/9/2021,Coles /Expense/Household/Groceries,Coles ,Expense,Household,Groceries,5,0,3416,DR
15/9/2021,Airbnb Host Income /Income/Income/Other Income,Airbnb Host Income ,Income,Income,Other Income,319,0,3097,DR
21/9/2021,Snap Fitness /Expense/Personal/Fitness & Wellbeing,Snap Fitness ,Expense,Personal,Fitness & Wellbeing,96,0,3001,DR
23/9/2021,Zarraffa's Coffee /Expense/Leisure & Lifestyle/Restaurants & Cafes,Zarraffa's Coffee ,Expense,Leisure & Lifestyle,Restaurants & Cafes,176,0,2825,DR
24/9/2021,Beachside Caravan Park /Expense/Leisure & Lifestyle/Holidays & Travel,Beachside Caravan Park ,Expense,Leisure & Lifestyle,Holidays & Travel,252,0,2573,DR
24/9/2021,Mathnasium /Expense/Personal/Education,Mathnasium ,Expense,Personal,Education,253,0,2320,DR
25/9/2021,Tabcorp /Expense/Leisure & Lifestyle/Lottery & Gambling,Tabcorp ,Expense,Leisure & Lifestyle,Lottery & Gambling,114,0,2206,DR
25/9/2021,Billabong /Expense/Personal/Clothing & Accessories,Billabong ,Expense,Personal,Clothing & Accessories,196,0,2010,DR
25/9/2021,"Adairs /Expense/Household/Furniture, Electronics & Homewares",Adairs ,Expense,Household,"Furniture, Electronics & Homewares",151,0,1859,DR
25/9/2021,Officeworks /Expense/Personal/Life Admin,Officeworks ,Expense,Personal,Life Admin,86,0,1773,DR
28/9/2021,Origin Energy /Expense/Household/Utilities,Origin Energy ,Expense,Household,Utilities,75,0,1698,DR
1/10/2021,Monthly Income,Monthly Income,Income,Income,Wages,0,6000,7698,CR
2/10/2021,Decathlon /Expense/Personal/Fitness & Wellbeing,Decathlon ,Expense,Personal,Fitness & Wellbeing,377,0,7321,DR
3/10/2021,Ballet Schools /Expense/Personal/Fitness & Wellbeing,Ballet Schools ,Expense,Personal,Fitness & Wellbeing,241,0,7080,DR
5/10/2021,Westpac Dividend Deposit /Income/Income/Investments,Westpac Dividend Deposit ,Income,Income,Investments,103,0,6977,DR
7/10/2021,Sylvan Learning /Expense/Personal/Education,Sylvan Learning ,Expense,Personal,Education,139,0,6838,DR
7/10/2021, National Bank /Expense/Personal/Fees & Charges, National Bank ,Expense,Personal,Fees & Charges,116,0,6722,DR
7/10/2021,Ladbrokes /Expense/Leisure & Lifestyle/Lottery & Gambling,Ladbrokes ,Expense,Leisure & Lifestyle,Lottery & Gambling,113,0,6609,DR
7/10/2021,Surf Dive 'n Ski /Expense/Personal/Clothing & Accessories,Surf Dive 'n Ski ,Expense,Personal,Clothing & Accessories,189,0,6420,DR
8/10/2021,Anytime Fitness /Expense/Personal/Fitness & Wellbeing,Anytime Fitness ,Expense,Personal,Fitness & Wellbeing,428,0,5992,DR
8/10/2021,Camp Australia /Expense/Leisure & Lifestyle/Hobbies,Camp Australia ,Expense,Leisure & Lifestyle,Hobbies,177,0,5815,DR
8/10/2021,"VicRoads /Expense/Transport/Car Insurance, Rego & Maintenance",VicRoads ,Expense,Transport,"Car Insurance, Rego & Maintenance",439,0,5376,DR
9/10/2021,Chiropractor /Expense/Personal/Health & Medical,Chiropractor ,Expense,Personal,Health & Medical,489,0,4887,DR
10/10/2021, Ray White Real Estate /Expense/Personal/Life Admin, Ray White Real Estate ,Expense,Personal,Life Admin,450,0,4437,DR
10/10/2021,The Ivy /Expense/Leisure & Lifestyle/Pubs & Bars,The Ivy ,Expense,Leisure & Lifestyle,Pubs & Bars,121,0,4316,DR
11/10/2021,Hungry Jack’s /Expense/Leisure & Lifestyle/Takeaway,Hungry Jack’s ,Expense,Leisure & Lifestyle,Takeaway,230,0,4086,DR
11/10/2021,Sea Life Aquarium /Expense/Leisure & Lifestyle/Entertainment,Sea Life Aquarium ,Expense,Leisure & Lifestyle,Entertainment,7,0,4079,DR
12/10/2021,TerryWhite Chemmart /Expense/Personal/Health & Medical,TerryWhite Chemmart ,Expense,Personal,Health & Medical,108,0,3971,DR
12/10/2021,QBE Insurance Claim Payout /Income/Income/Other Income,QBE Insurance Claim Payout ,Income,Income,Other Income,390,0,3581,DR
15/10/2021, NRMA Insurance /Expense/Household/Rates & Insurance, NRMA Insurance ,Expense,Household,Rates & Insurance,283,0,3298,DR
16/10/2021,Dan Murphy’s /Expense/Leisure & Lifestyle/Alcohol,Dan Murphy’s ,Expense,Leisure & Lifestyle,Alcohol,14,0,3284,DR
17/10/2021,Palace Cinemas /Expense/Leisure & Lifestyle/Entertainment,Palace Cinemas ,Expense,Leisure & Lifestyle,Entertainment,118,0,3166,DR
19/10/2021,"Kmart Tyre & Auto Service /Expense/Transport/Car Insurance, Rego & Maintenance",Kmart Tyre & Auto Service ,Expense,Transport,"Car Insurance, Rego & Maintenance",87,0,3079,DR
19/10/2021,AMF Bowling /Expense/Leisure & Lifestyle/Entertainment,AMF Bowling ,Expense,Leisure & Lifestyle,Entertainment,194,0,2885,DR
19/10/2021,"Foxtel /Expense/Leisure & Lifestyle/Tv, Music & Streaming",Foxtel ,Expense,Leisure & Lifestyle,"Tv, Music & Streaming",44,0,2841,DR
19/10/2021, National Bank /Expense/Personal/Fees & Charges, National Bank ,Expense,Personal,Fees & Charges,92,0,2749,DR
19/10/2021,"Binge /Expense/Leisure & Lifestyle/Tv, Music & Streaming",Binge ,Expense,Leisure & Lifestyle,"Tv, Music & Streaming",249,0,2500,DR
19/10/2021,Payday Advance /Income/Income/Other Income,Payday Advance ,Income,Income,Other Income,123,0,2377,DR
21/10/2021,Rebel Sport /Expense/Personal/Fitness & Wellbeing,Rebel Sport ,Expense,Personal,Fitness & Wellbeing,29,0,2348,DR
22/10/2021,Village Cinemas /Expense/Leisure & Lifestyle/Entertainment,Village Cinemas ,Expense,Leisure & Lifestyle,Entertainment,230,0,2118,DR
22/10/2021,The Victory Hotel /Expense/Leisure & Lifestyle/Pubs & Bars,The Victory Hotel ,Expense,Leisure & Lifestyle,Pubs & Bars,177,0,1941,DR
22/10/2021,Eau De Vie /Expense/Leisure & Lifestyle/Pubs & Bars,Eau De Vie ,Expense,Leisure & Lifestyle,Pubs & Bars,106,0,1835,DR
23/10/2021,Decathlon /Expense/Personal/Fitness & Wellbeing,Decathlon ,Expense,Personal,Fitness & Wellbeing,125,0,1710,DR
23/10/2021,Surf Dive 'n Ski /Expense/Personal/Clothing & Accessories,Surf Dive 'n Ski ,Expense,Personal,Clothing & Accessories,159,0,1551,DR
25/10/2021,Target /Expense/Personal/Clothing & Accessories,Target ,Expense,Personal,Clothing & Accessories,59,0,1492,DR
28/10/2021,The Victory Hotel /Expense/Leisure & Lifestyle/Pubs & Bars,The Victory Hotel ,Expense,Leisure & Lifestyle,Pubs & Bars,47,0,1445,DR
28/10/2021,"Adairs /Expense/Household/Furniture, Electronics & Homewares",Adairs ,Expense,Household,"Furniture, Electronics & Homewares",66,0,1379,DR
28/10/2021,"Autobarn /Expense/Transport/Car Insurance, Rego & Maintenance",Autobarn ,Expense,Transport,"Car Insurance, Rego & Maintenance",32,0,1347,DR
1/11/2021,Monthly Income,Monthly Income,Income,Income,Wages,0,6000,7347,CR
2/11/2021,IKEA /Expense/Household/Maintenance & Improvements,IKEA ,Expense,Household,Maintenance & Improvements,456,0,6891,DR
2/11/2021,"Supercheap Auto /Expense/Transport/Car Insurance, Rego & Maintenance",Supercheap Auto ,Expense,Transport,"Car Insurance, Rego & Maintenance",88,0,6803,DR
3/11/2021,"Supercheap Auto /Expense/Transport/Car Insurance, Rego & Maintenance",Supercheap Auto ,Expense,Transport,"Car Insurance, Rego & Maintenance",310,0,6493,DR
4/11/2021,"Foxtel /Expense/Leisure & Lifestyle/Tv, Music & Streaming",Foxtel ,Expense,Leisure & Lifestyle,"Tv, Music & Streaming",30,0,6463,DR
4/11/2021,QBE Insurance Claim Payout /Income/Income/Other Income,QBE Insurance Claim Payout ,Income,Income,Other Income,383,0,6080,DR
4/11/2021,Mathnasium /Expense/Personal/Education,Mathnasium ,Expense,Personal,Education,46,0,6034,DR
6/11/2021,Snap Fitness /Expense/Personal/Fitness & Wellbeing,Snap Fitness ,Expense,Personal,Fitness & Wellbeing,480,0,5554,DR
6/11/2021,BWS /Expense/Leisure & Lifestyle/Alcohol,BWS ,Expense,Leisure & Lifestyle,Alcohol,309,0,5245,DR
6/11/2021,Ladbrokes /Expense/Leisure & Lifestyle/Lottery & Gambling,Ladbrokes ,Expense,Leisure & Lifestyle,Lottery & Gambling,164,0,5081,DR
7/11/2021,Hobart Brewing Company /Expense/Leisure & Lifestyle/Pubs & Bars,Hobart Brewing Company ,Expense,Leisure & Lifestyle,Pubs & Bars,34,0,5047,DR
7/11/2021,"Foxtel /Expense/Leisure & Lifestyle/Tv, Music & Streaming",Foxtel ,Expense,Leisure & Lifestyle,"Tv, Music & Streaming",278,0,4769,DR
8/11/2021,EnergyAustralia /Expense/Household/Utilities,EnergyAustralia ,Expense,Household,Utilities,340,0,4429,DR
8/11/2021,"Barbeques Galore /Expense/Household/Furniture, Electronics & Homewares",Barbeques Galore ,Expense,Household,"Furniture, Electronics & Homewares",419,0,4010,DR
8/11/2021,Tabcorp /Expense/Leisure & Lifestyle/Lottery & Gambling,Tabcorp ,Expense,Leisure & Lifestyle,Lottery & Gambling,205,0,3805,DR
8/11/2021,Café Nero /Expense/Leisure & Lifestyle/Restaurants & Cafes,Café Nero ,Expense,Leisure & Lifestyle,Restaurants & Cafes,195,0,3610,DR
9/11/2021,Telstra /Expense/Personal/Mobile Phone,Telstra ,Expense,Personal,Mobile Phone,253,0,3357,DR
10/11/2021,G8 Education /Expense/Personal/Children & Family,G8 Education ,Expense,Personal,Children & Family,159,0,3198,DR
11/11/2021,Origin Energy /Expense/Household/Utilities,Origin Energy ,Expense,Household,Utilities,264,0,2934,DR
11/11/2021,Harris Farm Markets /Expense/Household/Groceries,Harris Farm Markets ,Expense,Household,Groceries,19,0,2915,DR
11/11/2021,"Le Creuset /Expense/Household/Furniture, Electronics & Homewares",Le Creuset ,Expense,Household,"Furniture, Electronics & Homewares",199,0,2716,DR
11/11/2021,David Jones /Expense/Personal/Clothing & Accessories,David Jones ,Expense,Personal,Clothing & Accessories,216,0,2500,DR
11/11/2021,Optus /Expense/Personal/Mobile Phone,Optus ,Expense,Personal,Mobile Phone,111,0,2389,DR
13/11/2021,Origin Energy /Expense/Household/Utilities,Origin Energy ,Expense,Household,Utilities,42,0,2347,DR
13/11/2021,Taronga Zoo /Expense/Leisure & Lifestyle/Entertainment,Taronga Zoo ,Expense,Leisure & Lifestyle,Entertainment,218,0,2129,DR
13/11/2021, National Bank /Expense/Personal/Fees & Charges, National Bank ,Expense,Personal,Fees & Charges,154,0,1975,DR
13/11/2021,YMCA /Expense/Personal/Fitness & Wellbeing,YMCA ,Expense,Personal,Fitness & Wellbeing,193,0,1782,DR
13/11/2021,Hobart Brewing Company /Expense/Leisure & Lifestyle/Pubs & Bars,Hobart Brewing Company ,Expense,Leisure & Lifestyle,Pubs & Bars,73,0,1709,DR
14/11/2021,Domino’s Pizza /Expense/Leisure & Lifestyle/Takeaway,Domino’s Pizza ,Expense,Leisure & Lifestyle,Takeaway,20,0,1689,DR
14/11/2021,"Binge /Expense/Leisure & Lifestyle/Tv, Music & Streaming",Binge ,Expense,Leisure & Lifestyle,"Tv, Music & Streaming",53,0,1636,DR
15/11/2021,Timezone /Expense/Leisure & Lifestyle/Entertainment,Timezone ,Expense,Leisure & Lifestyle,Entertainment,156,0,1480,DR
16/11/2021,Endota Spa /Expense/Personal/Fitness & Wellbeing,Endota Spa ,Expense,Personal,Fitness & Wellbeing,95,0,1385,DR
17/11/2021,Lorna Jane /Expense/Personal/Clothing & Accessories,Lorna Jane ,Expense,Personal,Clothing & Accessories,54,0,1331,DR
18/11/2021,Tennis Australia /Expense/Personal/Fitness & Wellbeing,Tennis Australia ,Expense,Personal,Fitness & Wellbeing,44,0,1287,DR
18/11/2021, Jim's Mowing /Expense/Household/Maintenance & Improvements, Jim's Mowing ,Expense,Household,Maintenance & Improvements,119,0,1168,DR
19/11/2021," The Good Guys /Expense/Household/Furniture, Electronics & Homewares", The Good Guys ,Expense,Household,"Furniture, Electronics & Homewares",53,0,1115,DR
19/11/2021,T2 Tea /Expense/Personal/Fitness & Wellbeing,T2 Tea ,Expense,Personal,Fitness & Wellbeing,5,0,1110,DR
19/11/2021,"Bridgestone Select /Expense/Transport/Car Insurance, Rego & Maintenance",Bridgestone Select ,Expense,Transport,"Car Insurance, Rego & Maintenance",29,0,1081,DR
20/11/2021,"Budget Direct Car Insurance /Expense/Transport/Car Insurance, Rego & Maintenance",Budget Direct Car Insurance ,Expense,Transport,"Car Insurance, Rego & Maintenance",32,0,1049,DR
20/11/2021," The Good Guys /Expense/Household/Furniture, Electronics & Homewares", The Good Guys ,Expense,Household,"Furniture, Electronics & Homewares",62,0,987,DR
20/11/2021,"Autobarn /Expense/Transport/Car Insurance, Rego & Maintenance",Autobarn ,Expense,Transport,"Car Insurance, Rego & Maintenance",46,0,941,DR
21/11/2021,Big W /Expense/Personal/Children & Family,Big W ,Expense,Personal,Children & Family,53,0,888,DR
22/11/2021,"Ultra Tune /Expense/Transport/Car Insurance, Rego & Maintenance",Ultra Tune ,Expense,Transport,"Car Insurance, Rego & Maintenance",76,0,812,DR
23/11/2021,Country Road /Expense/Personal/Clothing & Accessories,Country Road ,Expense,Personal,Clothing & Accessories,37,0,775,DR
24/11/2021,Rip Curl /Expense/Personal/Clothing & Accessories,Rip Curl ,Expense,Personal,Clothing & Accessories,77,0,698,DR
25/11/2021,Pizza Hut /Expense/Leisure & Lifestyle/Takeaway,Pizza Hut ,Expense,Leisure & Lifestyle,Takeaway,31,0,667,DR
25/11/2021,Sea Kayak Tours /Expense/Leisure & Lifestyle/Holidays & Travel,Sea Kayak Tours ,Expense,Leisure & Lifestyle,Holidays & Travel,52,0,615,DR
25/11/2021,CommSec Share Trading Gains /Income/Income/Investments,CommSec Share Trading Gains ,Income,Income,Investments,35,0,580,DR
26/11/2021,The Australian /Expense/Personal/Education,The Australian ,Expense,Personal,Education,59,0,521,DR
26/11/2021,Spotlight /Expense/Leisure & Lifestyle/Hobbies,Spotlight ,Expense,Leisure & Lifestyle,Hobbies,24,0,497,DR
26/11/2021,ABC Reading Eggs /Expense/Personal/Education,ABC Reading Eggs ,Expense,Personal,Education,20,0,477,DR
26/11/2021,Adobe Creative Cloud /Expense/Leisure & Lifestyle/Hobbies,Adobe Creative Cloud ,Expense,Leisure & Lifestyle,Hobbies,22,0,455,DR
27/11/2021,Coles /Expense/Household/Groceries,Coles ,Expense,Household,Groceries,17,0,438,DR
27/11/2021,Rebel Sport /Expense/Personal/Fitness & Wellbeing,Rebel Sport ,Expense,Personal,Fitness & Wellbeing,33,0,405,DR
28/11/2021,Sydney Water /Expense/Household/Utilities,Sydney Water ,Expense,Household,Utilities,32,0,373,DR
1/12/2021,Monthly Income,Monthly Income,Income,Income,Wages,0,6000,6373,CR
2/12/2021,Myer /Expense/Personal/Clothing & Accessories,Myer ,Expense,Personal,Clothing & Accessories,596,0,5777,DR
2/12/2021,Big W /Expense/Personal/Children & Family,Big W ,Expense,Personal,Children & Family,411,0,5366,DR
2/12/2021,"Kayo Sports /Expense/Leisure & Lifestyle/Tv, Music & Streaming",Kayo Sports ,Expense,Leisure & Lifestyle,"Tv, Music & Streaming",192,0,5174,DR
2/12/2021,Cookie /Expense/Leisure & Lifestyle/Pubs & Bars,Cookie ,Expense,Leisure & Lifestyle,Pubs & Bars,335,0,4839,DR
3/12/2021,Melbourne Central Lion Hotel /Expense/Leisure & Lifestyle/Pubs & Bars,Melbourne Central Lion Hotel ,Expense,Leisure & Lifestyle,Pubs & Bars,364,0,4475,DR
4/12/2021,G8 Education /Expense/Personal/Children & Family,G8 Education ,Expense,Personal,Children & Family,376,0,4099,DR
4/12/2021,"Autobarn /Expense/Transport/Car Insurance, Rego & Maintenance",Autobarn ,Expense,Transport,"Car Insurance, Rego & Maintenance",81,0,4018,DR
4/12/2021,Origin Energy /Expense/Household/Utilities,Origin Energy ,Expense,Household,Utilities,220,0,3798,DR
5/12/2021, Brisbane City Council /Expense/Household/Rates & Insurance, Brisbane City Council ,Expense,Household,Rates & Insurance,145,0,3653,DR
6/12/2021,Sunburn Swimwear /Expense/Personal/Clothing & Accessories,Sunburn Swimwear ,Expense,Personal,Clothing & Accessories,18,0,3635,DR
6/12/2021,Booktopia /Expense/Leisure & Lifestyle/Hobbies,Booktopia ,Expense,Leisure & Lifestyle,Hobbies,236,0,3399,DR
6/12/2021,Fernwood Fitness /Expense/Personal/Fitness & Wellbeing,Fernwood Fitness ,Expense,Personal,Fitness & Wellbeing,319,0,3080,DR
7/12/2021,"JAX Tyres /Expense/Transport/Car Insurance, Rego & Maintenance",JAX Tyres ,Expense,Transport,"Car Insurance, Rego & Maintenance",50,0,3030,DR
7/12/2021,EnergyAustralia /Expense/Household/Utilities,EnergyAustralia ,Expense,Household,Utilities,156,0,2874,DR
7/12/2021,Local Hospital /Expense/Personal/Health & Medical,Local Hospital ,Expense,Personal,Health & Medical,79,0,2795,DR
9/12/2021,Costco /Expense/Household/Groceries,Costco ,Expense,Household,Groceries,30,0,2765,DR
10/12/2021,ABC Reading Eggs /Expense/Personal/Education,ABC Reading Eggs ,Expense,Personal,Education,177,0,2588,DR
10/12/2021,The Espy /Expense/Leisure & Lifestyle/Pubs & Bars,The Espy ,Expense,Leisure & Lifestyle,Pubs & Bars,187,0,2401,DR
10/12/2021,Target /Expense/Personal/Clothing & Accessories,Target ,Expense,Personal,Clothing & Accessories,26,0,2375,DR
11/12/2021,Eau De Vie /Expense/Leisure & Lifestyle/Pubs & Bars,Eau De Vie ,Expense,Leisure & Lifestyle,Pubs & Bars,178,0,2197,DR
11/12/2021,Target /Expense/Personal/Clothing & Accessories,Target ,Expense,Personal,Clothing & Accessories,90,0,2107,DR
12/12/2021,Decathlon /Expense/Personal/Fitness & Wellbeing,Decathlon ,Expense,Personal,Fitness & Wellbeing,182,0,1925,DR
12/12/2021,South East Water /Expense/Household/Utilities,South East Water ,Expense,Household,Utilities,126,0,1799,DR
13/12/2021,The Athlete's Foot /Expense/Personal/Clothing & Accessories,The Athlete's Foot ,Expense,Personal,Clothing & Accessories,33,0,1766,DR
13/12/2021,Muffin Break /Expense/Leisure & Lifestyle/Restaurants & Cafes,Muffin Break ,Expense,Leisure & Lifestyle,Restaurants & Cafes,145,0,1621,DR
15/12/2021,Costco /Expense/Household/Groceries,Costco ,Expense,Household,Groceries,132,0,1489,DR
15/12/2021,Freedom Furniture /Expense/Household/Maintenance & Improvements,Freedom Furniture ,Expense,Household,Maintenance & Improvements,52,0,1437,DR
17/12/2021,Specsavers /Expense/Personal/Health & Medical,Specsavers ,Expense,Personal,Health & Medical,57,0,1380,DR
18/12/2021,T2 Tea /Expense/Personal/Fitness & Wellbeing,T2 Tea ,Expense,Personal,Fitness & Wellbeing,51,0,1329,DR
18/12/2021,Sea Kayak Tours /Expense/Leisure & Lifestyle/Holidays & Travel,Sea Kayak Tours ,Expense,Leisure & Lifestyle,Holidays & Travel,79,0,1250,DR
18/12/2021,Jetts Fitness /Expense/Personal/Fitness & Wellbeing,Jetts Fitness ,Expense,Personal,Fitness & Wellbeing,35,0,1215,DR
18/12/2021,Muffin Break /Expense/Leisure & Lifestyle/Restaurants & Cafes,Muffin Break ,Expense,Leisure & Lifestyle,Restaurants & Cafes,26,0,1189,DR
18/12/2021,"The Good Guys /Expense/Household/Furniture, Electronics & Homewares",The Good Guys ,Expense,Household,"Furniture, Electronics & Homewares",80,0,1109,DR
19/12/2021,Music Academy /Expense/Leisure & Lifestyle/Hobbies,Music Academy ,Expense,Leisure & Lifestyle,Hobbies,78,0,1031,DR
19/12/2021,"Ultra Tune /Expense/Transport/Car Insurance, Rego & Maintenance",Ultra Tune ,Expense,Transport,"Car Insurance, Rego & Maintenance",39,0,992,DR
19/12/2021,Booktopia /Expense/Leisure & Lifestyle/Hobbies,Booktopia ,Expense,Leisure & Lifestyle,Hobbies,74,0,918,DR
19/12/2021,Country Road /Expense/Personal/Clothing & Accessories,Country Road ,Expense,Personal,Clothing & Accessories,35,0,883,DR
19/12/2021,Soccer Clubs /Expense/Personal/Fitness & Wellbeing,Soccer Clubs ,Expense,Personal,Fitness & Wellbeing,16,0,867,DR
20/12/2021,Uber /Expense/Transport/Taxies & Share Cars,Uber ,Expense,Transport,Taxies & Share Cars,46,0,821,DR
20/12/2021,Quay Restaurant /Expense/Leisure & Lifestyle/Pubs & Bars,Quay Restaurant ,Expense,Leisure & Lifestyle,Pubs & Bars,72,0,749,DR
20/12/2021,Optus /Expense/Personal/Mobile Phone,Optus ,Expense,Personal,Mobile Phone,42,0,707,DR
22/12/2021,Beacon Lighting /Expense/Household/Maintenance & Improvements,Beacon Lighting ,Expense,Household,Maintenance & Improvements,6,0,701,DR
22/12/2021,Anytime Fitness /Expense/Personal/Fitness & Wellbeing,Anytime Fitness ,Expense,Personal,Fitness & Wellbeing,41,0,660,DR
23/12/2021,T2 Tea /Expense/Personal/Fitness & Wellbeing,T2 Tea ,Expense,Personal,Fitness & Wellbeing,26,0,634,DR
23/12/2021,Sunnybank Hotel /Expense/Leisure & Lifestyle/Pubs & Bars,Sunnybank Hotel ,Expense,Leisure & Lifestyle,Pubs & Bars,32,0,602,DR
23/12/2021,Woolworths /Expense/Household/Groceries,Woolworths ,Expense,Household,Groceries,16,0,586,DR
24/12/2021,City Beach /Expense/Personal/Clothing & Accessories,City Beach ,Expense,Personal,Clothing & Accessories,29,0,557,DR
25/12/2021,G8 Education /Expense/Personal/Children & Family,G8 Education ,Expense,Personal,Children & Family,12,0,545,DR
25/12/2021,Music Academy /Expense/Leisure & Lifestyle/Hobbies,Music Academy ,Expense,Leisure & Lifestyle,Hobbies,40,0,505,DR
25/12/2021,Beach Café /Expense/Leisure & Lifestyle/Restaurants & Cafes,Beach Café ,Expense,Leisure & Lifestyle,Restaurants & Cafes,11,0,494,DR
26/12/2021,JB HiFi/Expense/Leisure & Lifestyle/Electronics,JB HiFi,Expense,Leisure & Lifestyle,Electronics,10,0,484,DR
26/12/2021,Spotlight /Expense/Leisure & Lifestyle/Hobbies,Spotlight ,Expense,Leisure & Lifestyle,Hobbies,40,0,444,DR
27/12/2021,SEQTA /Expense/Personal/Education,SEQTA ,Expense,Personal,Education,34,0,410,DR
27/12/2021,Physiotherapy Clinic /Expense/Personal/Health & Medical,Physiotherapy Clinic ,Expense,Personal,Health & Medical,7,0,403,DR
28/12/2021,Physiotherapy Clinic /Expense/Personal/Health & Medical,Physiotherapy Clinic ,Expense,Personal,Health & Medical,8,0,395,DR
28/12/2021,Upwork Freelancer Payment /Income/Income/Other Income,Upwork Freelancer Payment ,Income,Income,Other Income,15,0,380,DR
1/1/2022,Monthly Income,Monthly Income,Income,Income,Wages,0,6000,6380,CR
2/1/2022,Chiropractor /Expense/Personal/Health & Medical,Chiropractor ,Expense,Personal,Health & Medical,8,0,6372,DR
4/1/2022,The Baxter Inn /Expense/Leisure & Lifestyle/Pubs & Bars,The Baxter Inn ,Expense,Leisure & Lifestyle,Pubs & Bars,306,0,6066,DR
4/1/2022,BWS /Expense/Leisure & Lifestyle/Alcohol,BWS ,Expense,Leisure & Lifestyle,Alcohol,557,0,5509,DR
4/1/2022,McDonald’s /Expense/Leisure & Lifestyle/Takeaway,McDonald’s ,Expense,Leisure & Lifestyle,Takeaway,321,0,5188,DR
5/1/2022,AustralianSuper Pension /Income/Income/Other Income,AustralianSuper Pension ,Income,Income,Other Income,25,0,5163,DR
5/1/2022,"MyCar Tyre & Auto /Expense/Transport/Car Insurance, Rego & Maintenance",MyCar Tyre & Auto ,Expense,Transport,"Car Insurance, Rego & Maintenance",130,0,5033,DR
5/1/2022,South East Water /Expense/Household/Utilities,South East Water ,Expense,Household,Utilities,171,0,4862,DR
6/1/2022,Coles Express /Expense/Transport/Fuel,Coles Express ,Expense,Transport,Fuel,116,0,4746,DR
6/1/2022,Liquorland /Expense/Leisure & Lifestyle/Alcohol,Liquorland ,Expense,Leisure & Lifestyle,Alcohol,467,0,4279,DR
7/1/2022, Commonwealth Bank /Expense/Household/Rent & Mortgage, Commonwealth Bank ,Expense,Household,Rent & Mortgage,13,0,4266,DR
9/1/2022,"Spotify /Expense/Leisure & Lifestyle/Tv, Music & Streaming",Spotify ,Expense,Leisure & Lifestyle,"Tv, Music & Streaming",348,0,3918,DR
10/1/2022,Local Hospital /Expense/Personal/Health & Medical,Local Hospital ,Expense,Personal,Health & Medical,186,0,3732,DR
10/1/2022,BrewDog /Expense/Leisure & Lifestyle/Alcohol,BrewDog ,Expense,Leisure & Lifestyle,Alcohol,14,0,3718,DR
12/1/2022,T2 Tea /Expense/Personal/Fitness & Wellbeing,T2 Tea ,Expense,Personal,Fitness & Wellbeing,39,0,3679,DR
12/1/2022,Goodstart Early Learning /Expense/Personal/Children & Family,Goodstart Early Learning ,Expense,Personal,Children & Family,82,0,3597,DR
12/1/2022,"Bridgestone Select /Expense/Transport/Car Insurance, Rego & Maintenance",Bridgestone Select ,Expense,Transport,"Car Insurance, Rego & Maintenance",133,0,3464,DR
12/1/2022,Camp Australia /Expense/Leisure & Lifestyle/Hobbies,Camp Australia ,Expense,Leisure & Lifestyle,Hobbies,141,0,3323,DR
12/1/2022,ABC Reading Eggs /Expense/Personal/Education,ABC Reading Eggs ,Expense,Personal,Education,80,0,3243,DR
13/1/2022,CommSec Share Trading Gains /Income/Income/Investments,CommSec Share Trading Gains ,Income,Income,Investments,128,0,3115,DR
13/1/2022,Crown Perth /Expense/Leisure & Lifestyle/Pubs & Bars,Crown Perth ,Expense,Leisure & Lifestyle,Pubs & Bars,110,0,3005,DR
13/1/2022,Eat Street Northshore /Expense/Leisure & Lifestyle/Pubs & Bars,Eat Street Northshore ,Expense,Leisure & Lifestyle,Pubs & Bars,107,0,2898,DR
13/1/2022,PayPal Transfer from Sale /Income/Income/Other Income,PayPal Transfer from Sale ,Income,Income,Other Income,282,0,2616,DR
14/1/2022,EnergyAustralia /Expense/Household/Utilities,EnergyAustralia ,Expense,Household,Utilities,153,0,2463,DR
14/1/2022,AustralianSuper Pension /Income/Income/Other Income,AustralianSuper Pension ,Income,Income,Other Income,70,0,2393,DR
14/1/2022,Scouts Australia /Expense/Leisure & Lifestyle/Hobbies,Scouts Australia ,Expense,Leisure & Lifestyle,Hobbies,116,0,2277,DR
14/1/2022,Local Fish and Chips /Expense/Leisure & Lifestyle/Takeaway,Local Fish and Chips ,Expense,Leisure & Lifestyle,Takeaway,153,0,2124,DR
16/1/2022,Bulk Billing Doctor /Expense/Personal/Health & Medical,Bulk Billing Doctor ,Expense,Personal,Health & Medical,156,0,1968,DR
16/1/2022,Toys 'R' Us /Expense/Personal/CHildren & Family,Toys 'R' Us ,Expense,Personal,CHildren & Family,192,0,1776,DR
16/1/2022,T2 Tea /Expense/Personal/Fitness & Wellbeing,T2 Tea ,Expense,Personal,Fitness & Wellbeing,174,0,1602,DR
17/1/2022,Zarraffa's Coffee /Expense/Leisure & Lifestyle/Restaurants & Cafes,Zarraffa's Coffee ,Expense,Leisure & Lifestyle,Restaurants & Cafes,13,0,1589,DR
18/1/2022,VetLove /Expense/Household/Pets,VetLove ,Expense,Household,Pets,88,0,1501,DR
18/1/2022, Slater and Gordon Lawyers /Expense/Personal/Life Admin, Slater and Gordon Lawyers ,Expense,Personal,Life Admin,147,0,1354,DR
18/1/2022,Endota Spa /Expense/Personal/Fitness & Wellbeing,Endota Spa ,Expense,Personal,Fitness & Wellbeing,38,0,1316,DR
18/1/2022,Grill’d /Expense/Leisure & Lifestyle/Takeaway,Grill’d ,Expense,Leisure & Lifestyle,Takeaway,23,0,1293,DR
18/1/2022,Swim Australia /Expense/Personal/Fitness & Wellbeing,Swim Australia ,Expense,Personal,Fitness & Wellbeing,80,0,1213,DR
19/1/2022,Woolworths /Expense/Household/Groceries,Woolworths ,Expense,Household,Groceries,98,0,1115,DR
19/1/2022,Medicare Claim /Expense/Personal/Health & Medical,Medicare Claim ,Expense,Personal,Health & Medical,91,0,1024,DR
20/1/2022,Sydney Water /Expense/Household/Utilities,Sydney Water ,Expense,Household,Utilities,23,0,1001,DR
21/1/2022,McDonald’s /Expense/Leisure & Lifestyle/Takeaway,McDonald’s ,Expense,Leisure & Lifestyle,Takeaway,86,0,915,DR
21/1/2022,Uber /Expense/Transport/Taxies & Share Cars,Uber ,Expense,Transport,Taxies & Share Cars,86,0,829,DR
22/1/2022,McDonald’s /Expense/Leisure & Lifestyle/Takeaway,McDonald’s ,Expense,Leisure & Lifestyle,Takeaway,48,0,781,DR
22/1/2022,Dymocks /Expense/Leisure & Lifestyle/Hobbies,Dymocks ,Expense,Leisure & Lifestyle,Hobbies,54,0,727,DR
22/1/2022,The Ivy /Expense/Leisure & Lifestyle/Pubs & Bars,The Ivy ,Expense,Leisure & Lifestyle,Pubs & Bars,64,0,663,DR
22/1/2022,"Budget Direct Car Insurance /Expense/Transport/Car Insurance, Rego & Maintenance",Budget Direct Car Insurance ,Expense,Transport,"Car Insurance, Rego & Maintenance",16,0,647,DR
25/1/2022,Acupuncture Clinic /Expense/Personal/Health & Medical,Acupuncture Clinic ,Expense,Personal,Health & Medical,12,0,635,DR
26/1/2022,"Disney+ /Expense/Leisure & Lifestyle/Tv, Music & Streaming",Disney+ ,Expense,Leisure & Lifestyle,"Tv, Music & Streaming",45,0,590,DR
26/1/2022,"Harvey Norman /Expense/Household/Furniture, Electronics & Homewares",Harvey Norman ,Expense,Household,"Furniture, Electronics & Homewares",42,0,548,DR
28/1/2022, Jim's Mowing /Expense/Household/Maintenance & Improvements, Jim's Mowing ,Expense,Household,Maintenance & Improvements,43,0,505,DR
1/2/2022,Monthly Income,Monthly Income,Income,Income,Wages,0,6000,6505,CR
2/2/2022,Café Nero /Expense/Leisure & Lifestyle/Restaurants & Cafes,Café Nero ,Expense,Leisure & Lifestyle,Restaurants & Cafes,278,0,6227,DR
3/2/2022,Hungry Jack’s /Expense/Leisure & Lifestyle/Takeaway,Hungry Jack’s ,Expense,Leisure & Lifestyle,Takeaway,520,0,5707,DR
4/2/2022,Child Support Agency Deposit /Income/Income/Other Income,Child Support Agency Deposit ,Income,Income,Other Income,248,0,5459,DR
4/2/2022, Slater and Gordon Lawyers /Expense/Personal/Life Admin, Slater and Gordon Lawyers ,Expense,Personal,Life Admin,461,0,4998,DR
5/2/2022,Lorna Jane /Expense/Personal/Clothing & Accessories,Lorna Jane ,Expense,Personal,Clothing & Accessories,216,0,4782,DR
7/2/2022,Freedom Furniture /Expense/Household/Maintenance & Improvements,Freedom Furniture ,Expense,Household,Maintenance & Improvements,221,0,4561,DR
7/2/2022,Fernwood Fitness /Expense/Personal/Fitness & Wellbeing,Fernwood Fitness ,Expense,Personal,Fitness & Wellbeing,74,0,4487,DR
8/2/2022,Quay Restaurant /Expense/Leisure & Lifestyle/Pubs & Bars,Quay Restaurant ,Expense,Leisure & Lifestyle,Pubs & Bars,303,0,4184,DR
9/2/2022,Lorna Jane /Expense/Personal/Clothing & Accessories,Lorna Jane ,Expense,Personal,Clothing & Accessories,108,0,4076,DR
11/2/2022,KU Children's Services /Expense/Personal/Children & Family,KU Children's Services ,Expense,Personal,Children & Family,10,0,4066,DR
12/2/2022,VetLove /Expense/Household/Pets,VetLove ,Expense,Household,Pets,203,0,3863,DR
15/2/2022,"Audible /Expense/Leisure & Lifestyle/Tv, Music & Streaming",Audible ,Expense,Leisure & Lifestyle,"Tv, Music & Streaming",350,0,3513,DR
16/2/2022,Petbarn /Expense/Household/Pets,Petbarn ,Expense,Household,Pets,335,0,3178,DR
18/2/2022,Australian Veterinary Association /Expense/Household/Pets,Australian Veterinary Association ,Expense,Household,Pets,142,0,3036,DR
18/2/2022,Interest Payment from Commonwealth Bank /Income/Income/Investments,Interest Payment from Commonwealth Bank ,Income,Income,Investments,46,0,2990,DR
19/2/2022,Scouts Australia /Expense/Leisure & Lifestyle/Hobbies,Scouts Australia ,Expense,Leisure & Lifestyle,Hobbies,287,0,2703,DR
20/2/2022,Centrelink JobSeeker Payment /Income/Income/Other Income,Centrelink JobSeeker Payment ,Income,Income,Other Income,39,0,2664,DR
22/2/2022,The Brisbane Hotel /Expense/Leisure & Lifestyle/Pubs & Bars,The Brisbane Hotel ,Expense,Leisure & Lifestyle,Pubs & Bars,257,0,2407,DR
22/2/2022,CommSec Share Trading Gains /Income/Income/Investments,CommSec Share Trading Gains ,Income,Income,Investments,68,0,2339,DR
24/2/2022,Optus /Expense/Personal/Mobile Phone,Optus ,Expense,Personal,Mobile Phone,22,0,2317,DR
24/2/2022,Dymocks /Expense/Leisure & Lifestyle/Hobbies,Dymocks ,Expense,Leisure & Lifestyle,Hobbies,145,0,2172,DR
24/2/2022, Ray White Real Estate /Expense/Personal/Life Admin, Ray White Real Estate ,Expense,Personal,Life Admin,181,0,1991,DR
25/2/2022,Grill’d /Expense/Leisure & Lifestyle/Takeaway,Grill’d ,Expense,Leisure & Lifestyle,Takeaway,61,0,1930,DR
26/2/2022,Costco /Expense/Household/Groceries,Costco ,Expense,Household,Groceries,125,0,1805,DR
26/2/2022,National Hearing Care /Expense/Personal/Health & Medical,National Hearing Care ,Expense,Personal,Health & Medical,34,0,1771,DR
27/2/2022,Microsoft 365 /Expense/Personal/Education,Microsoft 365 ,Expense,Personal,Education,71,0,1700,DR
27/2/2022,Child Support Agency Deposit /Income/Income/Other Income,Child Support Agency Deposit ,Income,Income,Other Income,155,0,1545,DR
28/2/2022,Eau De Vie /Expense/Leisure & Lifestyle/Pubs & Bars,Eau De Vie ,Expense,Leisure & Lifestyle,Pubs & Bars,49,0,1496,DR
1/3/2022,Monthly Income,Monthly Income,Income,Income,Wages,0,6000,7496,CR
2/3/2022,Music Academy /Expense/Leisure & Lifestyle/Hobbies,Music Academy ,Expense,Leisure & Lifestyle,Hobbies,477,0,7019,DR
2/3/2022,Quay Restaurant /Expense/Leisure & Lifestyle/Pubs & Bars,Quay Restaurant ,Expense,Leisure & Lifestyle,Pubs & Bars,558,0,6461,DR
3/3/2022,KU Children's Services /Expense/Personal/Children & Family,KU Children's Services ,Expense,Personal,Children & Family,12,0,6449,DR
3/3/2022,Campion Education /Expense/Personal/Children & Family,Campion Education ,Expense,Personal,Children & Family,291,0,6158,DR
4/3/2022,Menulog /Expense/Leisure & Lifestyle/Takeaway,Menulog ,Expense,Leisure & Lifestyle,Takeaway,533,0,5625,DR
5/3/2022,Cookie /Expense/Leisure & Lifestyle/Pubs & Bars,Cookie ,Expense,Leisure & Lifestyle,Pubs & Bars,85,0,5540,DR
6/3/2022,Kumon /Expense/Personal/Education,Kumon ,Expense,Personal,Education,277,0,5263,DR
7/3/2022,Gardening Australia /Expense/Household/Maintenance & Improvements,Gardening Australia ,Expense,Household,Maintenance & Improvements,174,0,5089,DR
8/3/2022,AGL Energy /Expense/Household/Utilities,AGL Energy ,Expense,Household,Utilities,325,0,4764,DR
8/3/2022,Country Road /Expense/Personal/Clothing & Accessories,Country Road ,Expense,Personal,Clothing & Accessories,332,0,4432,DR
9/3/2022,Child Support Agency Deposit /Income/Income/Other Income,Child Support Agency Deposit ,Income,Income,Other Income,210,0,4222,DR
9/3/2022,Greencross Vets /Expense/Household/Pets,Greencross Vets ,Expense,Household,Pets,395,0,3827,DR
10/3/2022,Gold's Gym /Expense/Personal/Fitness & Wellbeing,Gold's Gym ,Expense,Personal,Fitness & Wellbeing,357,0,3470,DR
10/3/2022,Bunnings Warehouse /Expense/Household/Maintenance & Improvements,Bunnings Warehouse ,Expense,Household,Maintenance & Improvements,264,0,3206,DR
11/3/2022,City Beach /Expense/Personal/Clothing & Accessories,City Beach ,Expense,Personal,Clothing & Accessories,21,0,3185,DR
11/3/2022,Bunnings Warehouse /Expense/Household/Maintenance & Improvements,Bunnings Warehouse ,Expense,Household,Maintenance & Improvements,182,0,3003,DR
12/3/2022,Camp Australia /Expense/Leisure & Lifestyle/Hobbies,Camp Australia ,Expense,Leisure & Lifestyle,Hobbies,109,0,2894,DR
13/3/2022,Beachside Yoga Classes /Expense/Personal/Fitness & Wellbeing,Beachside Yoga Classes ,Expense,Personal,Fitness & Wellbeing,121,0,2773,DR
14/3/2022,"Ultra Tune /Expense/Transport/Car Insurance, Rego & Maintenance",Ultra Tune ,Expense,Transport,"Car Insurance, Rego & Maintenance",27,0,2746,DR
14/3/2022,Gold's Gym /Expense/Personal/Fitness & Wellbeing,Gold's Gym ,Expense,Personal,Fitness & Wellbeing,176,0,2570,DR
18/3/2022,Flight Centre /Expense/Leisure & Lifestyle/Holidays & Travel,Flight Centre ,Expense,Leisure & Lifestyle,Holidays & Travel,31,0,2539,DR
19/3/2022,Aqua Fun Park /Expense/Leisure & Lifestyle/Holidays & Travel,Aqua Fun Park ,Expense,Leisure & Lifestyle,Holidays & Travel,234,0,2305,DR
19/3/2022,TerryWhite Chemmart /Expense/Personal/Health & Medical,TerryWhite Chemmart ,Expense,Personal,Health & Medical,62,0,2243,DR
19/3/2022,Guzman y Gomez /Expense/Leisure & Lifestyle/Takeaway,Guzman y Gomez ,Expense,Leisure & Lifestyle,Takeaway,223,0,2020,DR
20/3/2022,Witchery /Expense/Personal/Clothing & Accessories,Witchery ,Expense,Personal,Clothing & Accessories,174,0,1846,DR
23/3/2022,Ladbrokes /Expense/Leisure & Lifestyle/Lottery & Gambling,Ladbrokes ,Expense,Leisure & Lifestyle,Lottery & Gambling,99,0,1747,DR
23/3/2022,School Locker /Expense/Personal/Children & Family,School Locker ,Expense,Personal,Children & Family,162,0,1585,DR
24/3/2022,Aqua Fun Park /Expense/Leisure & Lifestyle/Holidays & Travel,Aqua Fun Park ,Expense,Leisure & Lifestyle,Holidays & Travel,38,0,1547,DR
25/3/2022,Rental Deposit from RealEstate.com.au /Income/Income/Other Income,Rental Deposit from RealEstate.com.au ,Income,Income,Other Income,9,0,1538,DR
26/3/2022, BSA Ltd /Expense/Household/Maintenance & Improvements, BSA Ltd ,Expense,Household,Maintenance & Improvements,33,0,1505,DR
26/3/2022,Childcare Payments /Expense/Personal/Children & Family,Childcare Payments ,Expense,Personal,Children & Family,26,0,1479,DR
27/3/2022,Freedom Furniture /Expense/Household/Maintenance & Improvements,Freedom Furniture ,Expense,Household,Maintenance & Improvements,92,0,1387,DR
27/3/2022,Taronga Zoo /Expense/Leisure & Lifestyle/Entertainment,Taronga Zoo ,Expense,Leisure & Lifestyle,Entertainment,74,0,1313,DR
27/3/2022,Pathology Lab /Expense/Personal/Health & Medical,Pathology Lab ,Expense,Personal,Health & Medical,132,0,1181,DR
28/3/2022,Sydney Water /Expense/Household/Utilities,Sydney Water ,Expense,Household,Utilities,9,0,1172,DR
1/4/2022,Monthly Income,Monthly Income,Income,Income,Wages,0,6000,7172,CR
2/4/2022, Jim's Mowing /Expense/Household/Maintenance & Improvements, Jim's Mowing ,Expense,Household,Maintenance & Improvements,585,0,6587,DR
3/4/2022,Payday Advance /Income/Income/Other Income,Payday Advance ,Income,Income,Other Income,452,0,6135,DR
4/4/2022,Crown Perth /Expense/Leisure & Lifestyle/Pubs & Bars,Crown Perth ,Expense,Leisure & Lifestyle,Pubs & Bars,459,0,5676,DR
4/4/2022,The Baxter Inn /Expense/Leisure & Lifestyle/Pubs & Bars,The Baxter Inn ,Expense,Leisure & Lifestyle,Pubs & Bars,471,0,5205,DR
5/4/2022," The Good Guys /Expense/Household/Furniture, Electronics & Homewares", The Good Guys ,Expense,Household,"Furniture, Electronics & Homewares",239,0,4966,DR
6/4/2022,Pizza Hut /Expense/Leisure & Lifestyle/Takeaway,Pizza Hut ,Expense,Leisure & Lifestyle,Takeaway,70,0,4896,DR
7/4/2022,Mathnasium /Expense/Personal/Education,Mathnasium ,Expense,Personal,Education,87,0,4809,DR
7/4/2022,"Ultra Tune /Expense/Transport/Car Insurance, Rego & Maintenance",Ultra Tune ,Expense,Transport,"Car Insurance, Rego & Maintenance",436,0,4373,DR
9/4/2022,Caltex Woolworths /Expense/Transport/Fuel,Caltex Woolworths ,Expense,Transport,Fuel,186,0,4187,DR
10/4/2022,Mathnasium /Expense/Personal/Education,Mathnasium ,Expense,Personal,Education,183,0,4004,DR
10/4/2022,Payday Advance /Income/Income/Other Income,Payday Advance ,Income,Income,Other Income,325,0,3679,DR
12/4/2022,Soccer Clubs /Expense/Personal/Fitness & Wellbeing,Soccer Clubs ,Expense,Personal,Fitness & Wellbeing,230,0,3449,DR
13/4/2022,Sydney Water /Expense/Household/Utilities,Sydney Water ,Expense,Household,Utilities,289,0,3160,DR
14/4/2022,Child Support Agency Deposit /Income/Income/Other Income,Child Support Agency Deposit ,Income,Income,Other Income,74,0,3086,DR
14/4/2022,Zone Bowling /Expense/Leisure & Lifestyle/Entertainment,Zone Bowling ,Expense,Leisure & Lifestyle,Entertainment,289,0,2797,DR
15/4/2022,David Jones /Expense/Personal/Clothing & Accessories,David Jones ,Expense,Personal,Clothing & Accessories,152,0,2645,DR
15/4/2022,Decathlon /Expense/Personal/Fitness & Wellbeing,Decathlon ,Expense,Personal,Fitness & Wellbeing,104,0,2541,DR
16/4/2022,Spotlight /Expense/Leisure & Lifestyle/Hobbies,Spotlight ,Expense,Leisure & Lifestyle,Hobbies,84,0,2457,DR
17/4/2022,Microsoft 365 /Expense/Personal/Education,Microsoft 365 ,Expense,Personal,Education,8,0,2449,DR
18/4/2022,Coles /Expense/Household/Groceries,Coles ,Expense,Household,Groceries,156,0,2293,DR
18/4/2022,Dental Clinic /Expense/Personal/Health & Medical,Dental Clinic ,Expense,Personal,Health & Medical,155,0,2138,DR
19/4/2022,Optometrist /Expense/Personal/Health & Medical,Optometrist ,Expense,Personal,Health & Medical,111,0,2027,DR
19/4/2022,The Iconic /Expense/Personal/Clothing & Accessories,The Iconic ,Expense,Personal,Clothing & Accessories,41,0,1986,DR
19/4/2022,"NRMA Roadside Assistance /Expense/Transport/Car Insurance, Rego & Maintenance",NRMA Roadside Assistance ,Expense,Transport,"Car Insurance, Rego & Maintenance",141,0,1845,DR
20/4/2022,"Binge /Expense/Leisure & Lifestyle/Tv, Music & Streaming",Binge ,Expense,Leisure & Lifestyle,"Tv, Music & Streaming",13,0,1832,DR
20/4/2022,Freedom Furniture /Expense/Household/Maintenance & Improvements,Freedom Furniture ,Expense,Household,Maintenance & Improvements,102,0,1730,DR
20/4/2022,Rental Deposit from RealEstate.com.au /Income/Income/Other Income,Rental Deposit from RealEstate.com.au ,Income,Income,Other Income,166,0,1564,DR
21/4/2022,"Foxtel /Expense/Leisure & Lifestyle/Tv, Music & Streaming",Foxtel ,Expense,Leisure & Lifestyle,"Tv, Music & Streaming",55,0,1509,DR
21/4/2022,"The Good Guys /Expense/Household/Furniture, Electronics & Homewares",The Good Guys ,Expense,Household,"Furniture, Electronics & Homewares",111,0,1398,DR
21/4/2022,"VicRoads /Expense/Transport/Car Insurance, Rego & Maintenance",VicRoads ,Expense,Transport,"Car Insurance, Rego & Maintenance",135,0,1263,DR
21/4/2022,The Ivy /Expense/Leisure & Lifestyle/Pubs & Bars,The Ivy ,Expense,Leisure & Lifestyle,Pubs & Bars,97,0,1166,DR
24/4/2022,Crown Perth /Expense/Leisure & Lifestyle/Pubs & Bars,Crown Perth ,Expense,Leisure & Lifestyle,Pubs & Bars,71,0,1095,DR
24/4/2022,Jetts Fitness /Expense/Personal/Fitness & Wellbeing,Jetts Fitness ,Expense,Personal,Fitness & Wellbeing,110,0,985,DR
25/4/2022,Pathology Lab /Expense/Personal/Health & Medical,Pathology Lab ,Expense,Personal,Health & Medical,87,0,898,DR
27/4/2022, Jim's Mowing /Expense/Household/Maintenance & Improvements, Jim's Mowing ,Expense,Household,Maintenance & Improvements,44,0,854,DR
27/4/2022,Beacon Lighting /Expense/Household/Maintenance & Improvements,Beacon Lighting ,Expense,Household,Maintenance & Improvements,51,0,803,DR
1/5/2022,Monthly Income,Monthly Income,Income,Income,Wages,0,6000,6803,CR
2/5/2022,Little Athletics /Expense/Personal/Fitness & Wellbeing,Little Athletics ,Expense,Personal,Fitness & Wellbeing,59,0,6744,DR
2/5/2022,Guardian Childcare & Education /Expense/Personal/Children & Family,Guardian Childcare & Education ,Expense,Personal,Children & Family,469,0,6275,DR
2/5/2022, Metricon /Expense/Household/Maintenance & Improvements, Metricon ,Expense,Household,Maintenance & Improvements,211,0,6064,DR
4/5/2022,"Barbeques Galore /Expense/Household/Furniture, Electronics & Homewares",Barbeques Galore ,Expense,Household,"Furniture, Electronics & Homewares",468,0,5596,DR
6/5/2022,Café Nero /Expense/Leisure & Lifestyle/Restaurants & Cafes,Café Nero ,Expense,Leisure & Lifestyle,Restaurants & Cafes,64,0,5532,DR
6/5/2022,Fernwood Fitness /Expense/Personal/Fitness & Wellbeing,Fernwood Fitness ,Expense,Personal,Fitness & Wellbeing,6,0,5526,DR
7/5/2022,Mathnasium /Expense/Personal/Education,Mathnasium ,Expense,Personal,Education,545,0,4981,DR
9/5/2022,Snap Fitness /Expense/Personal/Fitness & Wellbeing,Snap Fitness ,Expense,Personal,Fitness & Wellbeing,185,0,4796,DR
9/5/2022,Freedom Furniture /Expense/Household/Maintenance & Improvements,Freedom Furniture ,Expense,Household,Maintenance & Improvements,213,0,4583,DR
9/5/2022,School Locker /Expense/Personal/Children & Family,School Locker ,Expense,Personal,Children & Family,15,0,4568,DR
9/5/2022,Officeworks /Expense/Personal/Life Admin,Officeworks ,Expense,Personal,Life Admin,311,0,4257,DR
10/5/2022," The Good Guys /Expense/Household/Furniture, Electronics & Homewares", The Good Guys ,Expense,Household,"Furniture, Electronics & Homewares",384,0,3873,DR
10/5/2022,Greencross Vets /Expense/Household/Pets,Greencross Vets ,Expense,Household,Pets,372,0,3501,DR
11/5/2022,Platypus Shoes /Expense/Personal/Clothing & Accessories,Platypus Shoes ,Expense,Personal,Clothing & Accessories,24,0,3477,DR
12/5/2022," The Good Guys /Expense/Household/Furniture, Electronics & Homewares", The Good Guys ,Expense,Household,"Furniture, Electronics & Homewares",323,0,3154,DR
12/5/2022,Dan Murphy’s /Expense/Leisure & Lifestyle/Alcohol,Dan Murphy’s ,Expense,Leisure & Lifestyle,Alcohol,295,0,2859,DR
13/5/2022,Salary Deposit from Woolworths Group /Income/Income/Wages,Salary Deposit from Woolworths Group ,Income,Income,Wages,25,0,2834,DR
13/5/2022,Medicare Claim /Expense/Personal/Health & Medical,Medicare Claim ,Expense,Personal,Health & Medical,79,0,2755,DR
14/5/2022,Kumon /Expense/Personal/Education,Kumon ,Expense,Personal,Education,255,0,2500,DR
14/5/2022,Village Cinemas /Expense/Leisure & Lifestyle/Entertainment,Village Cinemas ,Expense,Leisure & Lifestyle,Entertainment,206,0,2294,DR
14/5/2022,"JAX Tyres /Expense/Transport/Car Insurance, Rego & Maintenance",JAX Tyres ,Expense,Transport,"Car Insurance, Rego & Maintenance",53,0,2241,DR
14/5/2022,F45 Training /Expense/Personal/Fitness & Wellbeing,F45 Training ,Expense,Personal,Fitness & Wellbeing,148,0,2093,DR
15/5/2022,TerryWhite Chemmart /Expense/Personal/Health & Medical,TerryWhite Chemmart ,Expense,Personal,Health & Medical,98,0,1995,DR
15/5/2022, Metricon /Expense/Household/Maintenance & Improvements, Metricon ,Expense,Household,Maintenance & Improvements,161,0,1834,DR
17/5/2022,Shell V Power/Expense/Transport/Fuel,Shell V Power,Expense,Transport,Fuel,79,0,1755,DR
17/5/2022,The Baxter Inn /Expense/Leisure & Lifestyle/Pubs & Bars,The Baxter Inn ,Expense,Leisure & Lifestyle,Pubs & Bars,57,0,1698,DR
17/5/2022,Sylvan Learning /Expense/Personal/Education,Sylvan Learning ,Expense,Personal,Education,23,0,1675,DR
18/5/2022,Eau De Vie /Expense/Leisure & Lifestyle/Pubs & Bars,Eau De Vie ,Expense,Leisure & Lifestyle,Pubs & Bars,19,0,1656,DR
18/5/2022,Grill’d /Expense/Leisure & Lifestyle/Takeaway,Grill’d ,Expense,Leisure & Lifestyle,Takeaway,66,0,1590,DR
18/5/2022,Zone Bowling /Expense/Leisure & Lifestyle/Entertainment,Zone Bowling ,Expense,Leisure & Lifestyle,Entertainment,66,0,1524,DR
18/5/2022, Brisbane City Council /Expense/Household/Rates & Insurance, Brisbane City Council ,Expense,Household,Rates & Insurance,129,0,1395,DR
18/5/2022,Rip Curl /Expense/Personal/Clothing & Accessories,Rip Curl ,Expense,Personal,Clothing & Accessories,46,0,1349,DR
20/5/2022,"Harvey Norman /Expense/Household/Furniture, Electronics & Homewares",Harvey Norman ,Expense,Household,"Furniture, Electronics & Homewares",116,0,1233,DR
21/5/2022, NRMA Insurance /Expense/Household/Rates & Insurance, NRMA Insurance ,Expense,Household,Rates & Insurance,52,0,1181,DR
22/5/2022,Priceline Pharmacy /Expense/Personal/Health & Medical,Priceline Pharmacy ,Expense,Personal,Health & Medical,118,0,1063,DR
22/5/2022,Beachfront Markets /Expense/Personal/Clothing & Accessories,Beachfront Markets ,Expense,Personal,Clothing & Accessories,96,0,967,DR
23/5/2022,"Binge /Expense/Leisure & Lifestyle/Tv, Music & Streaming",Binge ,Expense,Leisure & Lifestyle,"Tv, Music & Streaming",57,0,910,DR
23/5/2022,Westpac Dividend Deposit /Income/Income/Investments,Westpac Dividend Deposit ,Income,Income,Investments,11,0,899,DR
23/5/2022,Culture Kings /Expense/Personal/Clothing & Accessories,Culture Kings ,Expense,Personal,Clothing & Accessories,23,0,876,DR
24/5/2022,The Athlete's Foot /Expense/Personal/Clothing & Accessories,The Athlete's Foot ,Expense,Personal,Clothing & Accessories,24,0,852,DR
24/5/2022,The Body Shop /Expense/Personal/Hair & Beauty,The Body Shop ,Expense,Personal,Hair & Beauty,43,0,809,DR
24/5/2022,Vodafone Prepaid /Expense/Personal/Mobile Phone,Vodafone Prepaid ,Expense,Personal,Mobile Phone,24,0,785,DR
26/5/2022,Aqua Fun Park /Expense/Leisure & Lifestyle/Holidays & Travel,Aqua Fun Park ,Expense,Leisure & Lifestyle,Holidays & Travel,64,0,721,DR
26/5/2022,Sea Kayak Tours /Expense/Leisure & Lifestyle/Holidays & Travel,Sea Kayak Tours ,Expense,Leisure & Lifestyle,Holidays & Travel,32,0,689,DR
26/5/2022,Freedom Furniture /Expense/Household/Maintenance & Improvements,Freedom Furniture ,Expense,Household,Maintenance & Improvements,6,0,683,DR
27/5/2022,The Brisbane Hotel /Expense/Leisure & Lifestyle/Pubs & Bars,The Brisbane Hotel ,Expense,Leisure & Lifestyle,Pubs & Bars,24,0,659,DR
27/5/2022,AMF Bowling /Expense/Leisure & Lifestyle/Entertainment,AMF Bowling ,Expense,Leisure & Lifestyle,Entertainment,21,0,638,DR
28/5/2022,Rip Curl /Expense/Personal/Clothing & Accessories,Rip Curl ,Expense,Personal,Clothing & Accessories,43,0,595,DR
28/5/2022,Grill’d /Expense/Leisure & Lifestyle/Takeaway,Grill’d ,Expense,Leisure & Lifestyle,Takeaway,21,0,574,DR
1/6/2022,Monthly Income,Monthly Income,Income,Income,Wages,0,6000,6574,CR
3/6/2022,"Supercheap Auto /Expense/Transport/Car Insurance, Rego & Maintenance",Supercheap Auto ,Expense,Transport,"Car Insurance, Rego & Maintenance",490,0,6084,DR
3/6/2022,Country Road /Expense/Personal/Clothing & Accessories,Country Road ,Expense,Personal,Clothing & Accessories,340,0,5744,DR
7/6/2022,The Baxter Inn /Expense/Leisure & Lifestyle/Pubs & Bars,The Baxter Inn ,Expense,Leisure & Lifestyle,Pubs & Bars,239,0,5505,DR
7/6/2022,Event Cinemas /Expense/Leisure & Lifestyle/Entertainment,Event Cinemas ,Expense,Leisure & Lifestyle,Entertainment,428,0,5077,DR
8/6/2022,Fernwood Fitness /Expense/Personal/Fitness & Wellbeing,Fernwood Fitness ,Expense,Personal,Fitness & Wellbeing,415,0,4662,DR
9/6/2022,"Adairs /Expense/Household/Furniture, Electronics & Homewares",Adairs ,Expense,Household,"Furniture, Electronics & Homewares",104,0,4558,DR
9/6/2022,"Binge /Expense/Leisure & Lifestyle/Tv, Music & Streaming",Binge ,Expense,Leisure & Lifestyle,"Tv, Music & Streaming",253,0,4305,DR
10/6/2022,The Sydney Morning Herald /Expense/Personal/Education,The Sydney Morning Herald ,Expense,Personal,Education,92,0,4213,DR
10/6/2022,"The Good Guys /Expense/Household/Furniture, Electronics & Homewares",The Good Guys ,Expense,Household,"Furniture, Electronics & Homewares",197,0,4016,DR
10/6/2022,Kmart /Expense/Personal/Children & Family,Kmart ,Expense,Personal,Children & Family,200,0,3816,DR
11/6/2022,T2 Tea /Expense/Personal/Fitness & Wellbeing,T2 Tea ,Expense,Personal,Fitness & Wellbeing,98,0,3718,DR
12/6/2022,Myer /Expense/Personal/Clothing & Accessories,Myer ,Expense,Personal,Clothing & Accessories,185,0,3533,DR
15/6/2022,Dental Clinic /Expense/Personal/Health & Medical,Dental Clinic ,Expense,Personal,Health & Medical,165,0,3368,DR
16/6/2022,Platypus Shoes /Expense/Personal/Clothing & Accessories,Platypus Shoes ,Expense,Personal,Clothing & Accessories,162,0,3206,DR
18/6/2022,"Netflix /Expense/Leisure & Lifestyle/Tv, Music & Streaming",Netflix ,Expense,Leisure & Lifestyle,"Tv, Music & Streaming",123,0,3083,DR
19/6/2022, Commonwealth Bank /Expense/Household/Rent & Mortgage, Commonwealth Bank ,Expense,Household,Rent & Mortgage,277,0,2806,DR
19/6/2022,David Jones /Expense/Personal/Clothing & Accessories,David Jones ,Expense,Personal,Clothing & Accessories,168,0,2638,DR
21/6/2022,Guzman y Gomez /Expense/Leisure & Lifestyle/Takeaway,Guzman y Gomez ,Expense,Leisure & Lifestyle,Takeaway,103,0,2535,DR
22/6/2022,eBay Sales Proceeds /Income/Income/Other Income,eBay Sales Proceeds ,Income,Income,Other Income,102,0,2433,DR
25/6/2022,"JAX Tyres /Expense/Transport/Car Insurance, Rego & Maintenance",JAX Tyres ,Expense,Transport,"Car Insurance, Rego & Maintenance",74,0,2359,DR
26/6/2022,Music Academy /Expense/Leisure & Lifestyle/Hobbies,Music Academy ,Expense,Leisure & Lifestyle,Hobbies,45,0,2314,DR
27/6/2022, EnergyAustralia /Expense/Household/Utilities, EnergyAustralia ,Expense,Household,Utilities,16,0,2298,DR
27/6/2022,Montessori Schools /Expense/Personal/Education,Montessori Schools ,Expense,Personal,Education,156,0,2142,DR
1/7/2022,Monthly Income,Monthly Income,Income,Income,Wages,0,6000,8142,CR
2/7/2022," The Good Guys /Expense/Household/Furniture, Electronics & Homewares", The Good Guys ,Expense,Household,"Furniture, Electronics & Homewares",220,0,7922,DR
2/7/2022,Catholic Education Office /Expense/Personal/Education,Catholic Education Office ,Expense,Personal,Education,41,0,7881,DR
3/7/2022,Crown Perth /Expense/Leisure & Lifestyle/Pubs & Bars,Crown Perth ,Expense,Leisure & Lifestyle,Pubs & Bars,386,0,7495,DR
3/7/2022,"EB Games /Expense/Leisure & Lifestyle/Apps, Games & Software",EB Games ,Expense,Leisure & Lifestyle,"Apps, Games & Software",171,0,7324,DR
4/7/2022,Swim Australia /Expense/Personal/Fitness & Wellbeing,Swim Australia ,Expense,Personal,Fitness & Wellbeing,368,0,6956,DR
5/7/2022,Woolworths /Expense/Household/Groceries,Woolworths ,Expense,Household,Groceries,228,0,6728,DR
5/7/2022,"Autobarn /Expense/Transport/Car Insurance, Rego & Maintenance",Autobarn ,Expense,Transport,"Car Insurance, Rego & Maintenance",150,0,6578,DR
6/7/2022,EnergyAustralia /Expense/Household/Utilities,EnergyAustralia ,Expense,Household,Utilities,116,0,6462,DR
7/7/2022,"JAX Tyres /Expense/Transport/Car Insurance, Rego & Maintenance",JAX Tyres ,Expense,Transport,"Car Insurance, Rego & Maintenance",228,0,6234,DR
7/7/2022,Surf Dive 'n Ski /Expense/Personal/Clothing & Accessories,Surf Dive 'n Ski ,Expense,Personal,Clothing & Accessories,542,0,5692,DR
7/7/2022,Costco /Expense/Household/Groceries,Costco ,Expense,Household,Groceries,371,0,5321,DR
9/7/2022,Mathnasium /Expense/Personal/Education,Mathnasium ,Expense,Personal,Education,334,0,4987,DR
12/7/2022,Sydney Water /Expense/Household/Utilities,Sydney Water ,Expense,Household,Utilities,39,0,4948,DR
12/7/2022,Child Support Agency Deposit /Income/Income/Other Income,Child Support Agency Deposit ,Income,Income,Other Income,320,0,4628,DR
12/7/2022, Rentokil /Expense/Household/Maintenance & Improvements, Rentokil ,Expense,Household,Maintenance & Improvements,184,0,4444,DR
13/7/2022,School Locker /Expense/Personal/Children & Family,School Locker ,Expense,Personal,Children & Family,180,0,4264,DR
13/7/2022,Culture Kings /Expense/Personal/Clothing & Accessories,Culture Kings ,Expense,Personal,Clothing & Accessories,306,0,3958,DR
13/7/2022,David Jones /Expense/Personal/Clothing & Accessories,David Jones ,Expense,Personal,Clothing & Accessories,70,0,3888,DR
15/7/2022,Fitness First /Expense/Personal/Fitness & Wellbeing,Fitness First ,Expense,Personal,Fitness & Wellbeing,239,0,3649,DR
15/7/2022,Pizza Hut /Expense/Leisure & Lifestyle/Takeaway,Pizza Hut ,Expense,Leisure & Lifestyle,Takeaway,103,0,3546,DR
17/7/2022,Queensland Urban Utilities /Expense/Household/Utilities,Queensland Urban Utilities ,Expense,Household,Utilities,225,0,3321,DR
17/7/2022,"Bridgestone Select /Expense/Transport/Car Insurance, Rego & Maintenance",Bridgestone Select ,Expense,Transport,"Car Insurance, Rego & Maintenance",303,0,3018,DR
17/7/2022,Pizza Hut /Expense/Leisure & Lifestyle/Takeaway,Pizza Hut ,Expense,Leisure & Lifestyle,Takeaway,26,0,2992,DR
18/7/2022, Commonwealth Bank /Expense/Household/Rent & Mortgage, Commonwealth Bank ,Expense,Household,Rent & Mortgage,91,0,2901,DR
18/7/2022,"NRMA Roadside Assistance /Expense/Transport/Car Insurance, Rego & Maintenance",NRMA Roadside Assistance ,Expense,Transport,"Car Insurance, Rego & Maintenance",160,0,2741,DR
19/7/2022, Ray White Real Estate /Expense/Personal/Life Admin, Ray White Real Estate ,Expense,Personal,Life Admin,58,0,2683,DR
21/7/2022,Optometrist /Expense/Personal/Health & Medical,Optometrist ,Expense,Personal,Health & Medical,125,0,2558,DR
22/7/2022,Health Food Store /Expense/Personal/Fitness & Wellbeing,Health Food Store ,Expense,Personal,Fitness & Wellbeing,100,0,2458,DR
23/7/2022,Kmart /Expense/Personal/Children & Family,Kmart ,Expense,Personal,Children & Family,153,0,2305,DR
23/7/2022,SEQTA /Expense/Personal/Education,SEQTA ,Expense,Personal,Education,65,0,2240,DR
23/7/2022,Snap Fitness /Expense/Personal/Fitness & Wellbeing,Snap Fitness ,Expense,Personal,Fitness & Wellbeing,89,0,2151,DR
24/7/2022,Childcare Payments /Expense/Personal/Children & Family,Childcare Payments ,Expense,Personal,Children & Family,198,0,1953,DR
24/7/2022,Flight Centre /Expense/Leisure & Lifestyle/Holidays & Travel,Flight Centre ,Expense,Leisure & Lifestyle,Holidays & Travel,126,0,1827,DR
24/7/2022,Dymocks /Expense/Leisure & Lifestyle/Hobbies,Dymocks ,Expense,Leisure & Lifestyle,Hobbies,45,0,1782,DR
25/7/2022,Airbnb Host Income /Income/Income/Other Income,Airbnb Host Income ,Income,Income,Other Income,68,0,1714,DR
25/7/2022,Soccer Clubs /Expense/Personal/Fitness & Wellbeing,Soccer Clubs ,Expense,Personal,Fitness & Wellbeing,59,0,1655,DR
25/7/2022,Witchery /Expense/Personal/Clothing & Accessories,Witchery ,Expense,Personal,Clothing & Accessories,104,0,1551,DR
25/7/2022,The Australian /Expense/Personal/Education,The Australian ,Expense,Personal,Education,57,0,1494,DR
26/7/2022,Aqua Fun Park /Expense/Leisure & Lifestyle/Holidays & Travel,Aqua Fun Park ,Expense,Leisure & Lifestyle,Holidays & Travel,101,0,1393,DR
26/7/2022,Sea Life Aquarium /Expense/Leisure & Lifestyle/Entertainment,Sea Life Aquarium ,Expense,Leisure & Lifestyle,Entertainment,17,0,1376,DR
27/7/2022,Sunnybank Hotel /Expense/Leisure & Lifestyle/Pubs & Bars,Sunnybank Hotel ,Expense,Leisure & Lifestyle,Pubs & Bars,58,0,1318,DR
28/7/2022, EnergyAustralia /Expense/Household/Utilities, EnergyAustralia ,Expense,Household,Utilities,95,0,1223,DR
28/7/2022,Coles /Expense/Household/Groceries,Coles ,Expense,Household,Groceries,21,0,1202,DR
1/8/2022,Monthly Income,Monthly Income,Income,Income,Wages,0,6000,7202,CR
2/8/2022,Scouts Australia /Expense/Leisure & Lifestyle/Hobbies,Scouts Australia ,Expense,Leisure & Lifestyle,Hobbies,303,0,6899,DR
2/8/2022,Sunnybank Hotel /Expense/Leisure & Lifestyle/Pubs & Bars,Sunnybank Hotel ,Expense,Leisure & Lifestyle,Pubs & Bars,358,0,6541,DR
4/8/2022,Centrelink JobSeeker Payment /Income/Income/Other Income,Centrelink JobSeeker Payment ,Income,Income,Other Income,426,0,6115,DR
4/8/2022,"Repco /Expense/Transport/Car Insurance, Rego & Maintenance",Repco ,Expense,Transport,"Car Insurance, Rego & Maintenance",438,0,5677,DR
5/8/2022,TerryWhite Chemmart /Expense/Personal/Health & Medical,TerryWhite Chemmart ,Expense,Personal,Health & Medical,523,0,5154,DR
5/8/2022, Brisbane City Council /Expense/Household/Rates & Insurance, Brisbane City Council ,Expense,Household,Rates & Insurance,343,0,4811,DR
5/8/2022,Camp Australia /Expense/Leisure & Lifestyle/Hobbies,Camp Australia ,Expense,Leisure & Lifestyle,Hobbies,76,0,4735,DR
5/8/2022,Kmart /Expense/Personal/Children & Family,Kmart ,Expense,Personal,Children & Family,54,0,4681,DR
5/8/2022, BSA Ltd /Expense/Household/Maintenance & Improvements, BSA Ltd ,Expense,Household,Maintenance & Improvements,155,0,4526,DR
7/8/2022,Priceline Pharmacy /Expense/Personal/Health & Medical,Priceline Pharmacy ,Expense,Personal,Health & Medical,153,0,4373,DR
7/8/2022,"Autobarn /Expense/Transport/Car Insurance, Rego & Maintenance",Autobarn ,Expense,Transport,"Car Insurance, Rego & Maintenance",395,0,3978,DR
7/8/2022,Uber /Expense/Transport/Taxies & Share Cars,Uber ,Expense,Transport,Taxies & Share Cars,16,0,3962,DR
7/8/2022,Melbourne Central Lion Hotel /Expense/Leisure & Lifestyle/Pubs & Bars,Melbourne Central Lion Hotel ,Expense,Leisure & Lifestyle,Pubs & Bars,150,0,3812,DR
8/8/2022,F45 Training /Expense/Personal/Fitness & Wellbeing,F45 Training ,Expense,Personal,Fitness & Wellbeing,41,0,3771,DR
8/8/2022,Jetts Fitness /Expense/Personal/Fitness & Wellbeing,Jetts Fitness ,Expense,Personal,Fitness & Wellbeing,204,0,3567,DR
9/8/2022,ATO Tax Refund /Income/Income/Other Income,ATO Tax Refund ,Income,Income,Other Income,78,0,3489,DR
10/8/2022,Boost Juice Bars /Expense/Leisure & Lifestyle/Takeaway,Boost Juice Bars ,Expense,Leisure & Lifestyle,Takeaway,213,0,3276,DR
12/8/2022,PayPal Transfer from Sale /Income/Income/Other Income,PayPal Transfer from Sale ,Income,Income,Other Income,123,0,3153,DR
12/8/2022,Big W /Expense/Personal/Children & Family,Big W ,Expense,Personal,Children & Family,307,0,2846,DR
14/8/2022,Pathology Lab /Expense/Personal/Health & Medical,Pathology Lab ,Expense,Personal,Health & Medical,251,0,2595,DR
15/8/2022,Culture Kings /Expense/Personal/Clothing & Accessories,Culture Kings ,Expense,Personal,Clothing & Accessories,255,0,2340,DR
15/8/2022, Jim’s Building Inspections /Expense/Household/Maintenance & Improvements, Jim’s Building Inspections ,Expense,Household,Maintenance & Improvements,204,0,2136,DR
15/8/2022,Chiropractor /Expense/Personal/Health & Medical,Chiropractor ,Expense,Personal,Health & Medical,80,0,2056,DR
16/8/2022,Domino’s Pizza /Expense/Leisure & Lifestyle/Takeaway,Domino’s Pizza ,Expense,Leisure & Lifestyle,Takeaway,70,0,1986,DR
17/8/2022,Catholic Education Office /Expense/Personal/Education,Catholic Education Office ,Expense,Personal,Education,95,0,1891,DR
17/8/2022,Medicare Claim /Expense/Personal/Health & Medical,Medicare Claim ,Expense,Personal,Health & Medical,122,0,1769,DR
18/8/2022,Café Nero /Expense/Leisure & Lifestyle/Restaurants & Cafes,Café Nero ,Expense,Leisure & Lifestyle,Restaurants & Cafes,18,0,1751,DR
19/8/2022,Westpac Dividend Deposit /Income/Income/Investments,Westpac Dividend Deposit ,Income,Income,Investments,89,0,1662,DR
20/8/2022,Culture Kings /Expense/Personal/Clothing & Accessories,Culture Kings ,Expense,Personal,Clothing & Accessories,131,0,1531,DR
20/8/2022,CommSec Share Trading Gains /Income/Income/Investments,CommSec Share Trading Gains ,Income,Income,Investments,145,0,1386,DR
23/8/2022,Crown Perth /Expense/Leisure & Lifestyle/Pubs & Bars,Crown Perth ,Expense,Leisure & Lifestyle,Pubs & Bars,87,0,1299,DR
23/8/2022,Rip Curl /Expense/Personal/Clothing & Accessories,Rip Curl ,Expense,Personal,Clothing & Accessories,80,0,1219,DR
24/8/2022,Catholic Education Office /Expense/Personal/Education,Catholic Education Office ,Expense,Personal,Education,49,0,1170,DR
24/8/2022,Scouts Australia /Expense/Leisure & Lifestyle/Hobbies,Scouts Australia ,Expense,Leisure & Lifestyle,Hobbies,109,0,1061,DR
25/8/2022,"MyCar Tyre & Auto /Expense/Transport/Car Insurance, Rego & Maintenance",MyCar Tyre & Auto ,Expense,Transport,"Car Insurance, Rego & Maintenance",56,0,1005,DR
26/8/2022,Music Academy /Expense/Leisure & Lifestyle/Hobbies,Music Academy ,Expense,Leisure & Lifestyle,Hobbies,38,0,967,DR
26/8/2022,Bulk Billing Doctor /Expense/Personal/Health & Medical,Bulk Billing Doctor ,Expense,Personal,Health & Medical,57,0,910,DR
27/8/2022,Swim Australia /Expense/Personal/Fitness & Wellbeing,Swim Australia ,Expense,Personal,Fitness & Wellbeing,30,0,880,DR
28/8/2022,David Jones /Expense/Personal/Clothing & Accessories,David Jones ,Expense,Personal,Clothing & Accessories,27,0,853,DR
1/9/2022,Monthly Income,Monthly Income,Income,Income,Wages,0,6000,6853,CR
2/9/2022,Eat Street Northshore /Expense/Leisure & Lifestyle/Pubs & Bars,Eat Street Northshore ,Expense,Leisure & Lifestyle,Pubs & Bars,635,0,6218,DR
2/9/2022,Harris Farm Markets /Expense/Household/Groceries,Harris Farm Markets ,Expense,Household,Groceries,309,0,5909,DR
2/9/2022,Airbnb Host Income /Income/Income/Other Income,Airbnb Host Income ,Income,Income,Other Income,47,0,5862,DR
3/9/2022,Coles Express /Expense/Transport/Fuel,Coles Express ,Expense,Transport,Fuel,544,0,5318,DR
3/9/2022,The Iconic /Expense/Personal/Clothing & Accessories,The Iconic ,Expense,Personal,Clothing & Accessories,377,0,4941,DR
3/9/2022,JB HiFi/Expense/Leisure & Lifestyle/Electronics,JB HiFi,Expense,Leisure & Lifestyle,Electronics,464,0,4477,DR
5/9/2022,YMCA /Expense/Personal/Fitness & Wellbeing,YMCA ,Expense,Personal,Fitness & Wellbeing,381,0,4096,DR
5/9/2022,Culture Kings /Expense/Personal/Clothing & Accessories,Culture Kings ,Expense,Personal,Clothing & Accessories,176,0,3920,DR
6/9/2022,Eat Street Northshore /Expense/Leisure & Lifestyle/Pubs & Bars,Eat Street Northshore ,Expense,Leisure & Lifestyle,Pubs & Bars,338,0,3582,DR
7/9/2022,Guzman y Gomez /Expense/Leisure & Lifestyle/Takeaway,Guzman y Gomez ,Expense,Leisure & Lifestyle,Takeaway,249,0,3333,DR
7/9/2022,CommSec Share Trading Gains /Income/Income/Investments,CommSec Share Trading Gains ,Income,Income,Investments,242,0,3091,DR
8/9/2022,The Coffee Club /Expense/Leisure & Lifestyle/Restaurants & Cafes,The Coffee Club ,Expense,Leisure & Lifestyle,Restaurants & Cafes,197,0,2894,DR
9/9/2022,Zarraffa's Coffee /Expense/Leisure & Lifestyle/Restaurants & Cafes,Zarraffa's Coffee ,Expense,Leisure & Lifestyle,Restaurants & Cafes,156,0,2738,DR
9/9/2022, EnergyAustralia /Expense/Household/Utilities, EnergyAustralia ,Expense,Household,Utilities,84,0,2654,DR
9/9/2022,Myer /Expense/Personal/Clothing & Accessories,Myer ,Expense,Personal,Clothing & Accessories,119,0,2535,DR
10/9/2022,Cookie /Expense/Leisure & Lifestyle/Pubs & Bars,Cookie ,Expense,Leisure & Lifestyle,Pubs & Bars,86,0,2449,DR
11/9/2022,School Locker /Expense/Personal/Children & Family,School Locker ,Expense,Personal,Children & Family,190,0,2259,DR
11/9/2022,Ice Cream Parlour /Expense/Leisure & Lifestyle/Takeaway,Ice Cream Parlour ,Expense,Leisure & Lifestyle,Takeaway,199,0,2060,DR
12/9/2022,Village Cinemas /Expense/Leisure & Lifestyle/Entertainment,Village Cinemas ,Expense,Leisure & Lifestyle,Entertainment,114,0,1946,DR
12/9/2022,Country Road /Expense/Personal/Clothing & Accessories,Country Road ,Expense,Personal,Clothing & Accessories,137,0,1809,DR
12/9/2022,Westpac Dividend Deposit /Income/Income/Investments,Westpac Dividend Deposit ,Income,Income,Investments,104,0,1705,DR
13/9/2022,Gold's Gym /Expense/Personal/Fitness & Wellbeing,Gold's Gym ,Expense,Personal,Fitness & Wellbeing,44,0,1661,DR
13/9/2022,"Disney+ /Expense/Leisure & Lifestyle/Tv, Music & Streaming",Disney+ ,Expense,Leisure & Lifestyle,"Tv, Music & Streaming",104,0,1557,DR
13/9/2022,Snap Fitness /Expense/Personal/Fitness & Wellbeing,Snap Fitness ,Expense,Personal,Fitness & Wellbeing,124,0,1433,DR
13/9/2022,The Baxter Inn /Expense/Leisure & Lifestyle/Pubs & Bars,The Baxter Inn ,Expense,Leisure & Lifestyle,Pubs & Bars,100,0,1333,DR
13/9/2022,David Jones /Expense/Personal/Clothing & Accessories,David Jones ,Expense,Personal,Clothing & Accessories,91,0,1242,DR
14/9/2022,Westpac Dividend Deposit /Income/Income/Investments,Westpac Dividend Deposit ,Income,Income,Investments,22,0,1220,DR
16/9/2022,Sunnybank Hotel /Expense/Leisure & Lifestyle/Pubs & Bars,Sunnybank Hotel ,Expense,Leisure & Lifestyle,Pubs & Bars,9,0,1211,DR
17/9/2022,Goodstart Early Learning /Expense/Personal/Children & Family,Goodstart Early Learning ,Expense,Personal,Children & Family,77,0,1134,DR
18/9/2022,Chiropractor /Expense/Personal/Health & Medical,Chiropractor ,Expense,Personal,Health & Medical,84,0,1050,DR
19/9/2022,Airbnb Host Income /Income/Income/Other Income,Airbnb Host Income ,Income,Income,Other Income,74,0,976,DR
19/9/2022,Salary Deposit from Woolworths Group /Income/Income/Wages,Salary Deposit from Woolworths Group ,Income,Income,Wages,24,0,952,DR
20/9/2022,"Netflix /Expense/Leisure & Lifestyle/Tv, Music & Streaming",Netflix ,Expense,Leisure & Lifestyle,"Tv, Music & Streaming",19,0,933,DR
20/9/2022,Event Cinemas /Expense/Leisure & Lifestyle/Entertainment,Event Cinemas ,Expense,Leisure & Lifestyle,Entertainment,36,0,897,DR
20/9/2022,Sunburn Swimwear /Expense/Personal/Clothing & Accessories,Sunburn Swimwear ,Expense,Personal,Clothing & Accessories,58,0,839,DR
20/9/2022,Kmart /Expense/Personal/Children & Family,Kmart ,Expense,Personal,Children & Family,12,0,827,DR
21/9/2022,PayPal Transfer from Sale /Income/Income/Other Income,PayPal Transfer from Sale ,Income,Income,Other Income,77,0,750,DR
21/9/2022, Slater and Gordon Lawyers /Expense/Personal/Life Admin, Slater and Gordon Lawyers ,Expense,Personal,Life Admin,68,0,682,DR
22/9/2022,National Hearing Care /Expense/Personal/Health & Medical,National Hearing Care ,Expense,Personal,Health & Medical,68,0,614,DR
22/9/2022,"Le Creuset /Expense/Household/Furniture, Electronics & Homewares",Le Creuset ,Expense,Household,"Furniture, Electronics & Homewares",36,0,578,DR
24/9/2022,Australian Veterinary Association /Expense/Household/Pets,Australian Veterinary Association ,Expense,Household,Pets,38,0,540,DR
24/9/2022,"Netflix /Expense/Leisure & Lifestyle/Tv, Music & Streaming",Netflix ,Expense,Leisure & Lifestyle,"Tv, Music & Streaming",16,0,524,DR
25/9/2022,eBay Sales Proceeds /Income/Income/Other Income,eBay Sales Proceeds ,Income,Income,Other Income,39,0,485,DR
28/9/2022,Dental Clinic /Expense/Personal/Health & Medical,Dental Clinic ,Expense,Personal,Health & Medical,34,0,451,DR
1/10/2022,Monthly Income,Monthly Income,Income,Income,Wages,0,6000,6451,CR
2/10/2022,Beacon Lighting /Expense/Household/Maintenance & Improvements,Beacon Lighting ,Expense,Household,Maintenance & Improvements,510,0,5941,DR
2/10/2022,Pathology Lab /Expense/Personal/Health & Medical,Pathology Lab ,Expense,Personal,Health & Medical,115,0,5826,DR
4/10/2022,The Sydney Morning Herald /Expense/Personal/Education,The Sydney Morning Herald ,Expense,Personal,Education,316,0,5510,DR
5/10/2022,Scouts Australia /Expense/Leisure & Lifestyle/Hobbies,Scouts Australia ,Expense,Leisure & Lifestyle,Hobbies,98,0,5412,DR
5/10/2022,Priceline Pharmacy /Expense/Personal/Health & Medical,Priceline Pharmacy ,Expense,Personal,Health & Medical,478,0,4934,DR
10/10/2022,Mathnasium /Expense/Personal/Education,Mathnasium ,Expense,Personal,Education,227,0,4707,DR
12/10/2022,"VicRoads /Expense/Transport/Car Insurance, Rego & Maintenance",VicRoads ,Expense,Transport,"Car Insurance, Rego & Maintenance",362,0,4345,DR
14/10/2022,BWS /Expense/Leisure & Lifestyle/Alcohol,BWS ,Expense,Leisure & Lifestyle,Alcohol,374,0,3971,DR
15/10/2022,Goodstart Early Learning /Expense/Personal/Children & Family,Goodstart Early Learning ,Expense,Personal,Children & Family,75,0,3896,DR
16/10/2022,Domino’s Pizza /Expense/Leisure & Lifestyle/Takeaway,Domino’s Pizza ,Expense,Leisure & Lifestyle,Takeaway,285,0,3611,DR
17/10/2022,Sunburn Swimwear /Expense/Personal/Clothing & Accessories,Sunburn Swimwear ,Expense,Personal,Clothing & Accessories,295,0,3316,DR
18/10/2022,Liquorland /Expense/Leisure & Lifestyle/Alcohol,Liquorland ,Expense,Leisure & Lifestyle,Alcohol,209,0,3107,DR
18/10/2022, Meriton Apartments /Expense/Household/Rates & Insurance, Meriton Apartments ,Expense,Household,Rates & Insurance,156,0,2951,DR
19/10/2022,Greencross Vets /Expense/Household/Pets,Greencross Vets ,Expense,Household,Pets,58,0,2893,DR
19/10/2022,Fitness First /Expense/Personal/Fitness & Wellbeing,Fitness First ,Expense,Personal,Fitness & Wellbeing,221,0,2672,DR
19/10/2022,Soccer Clubs /Expense/Personal/Fitness & Wellbeing,Soccer Clubs ,Expense,Personal,Fitness & Wellbeing,134,0,2538,DR
24/10/2022,Pizza Hut /Expense/Leisure & Lifestyle/Takeaway,Pizza Hut ,Expense,Leisure & Lifestyle,Takeaway,169,0,2369,DR
27/10/2022,Camp Australia /Expense/Leisure & Lifestyle/Hobbies,Camp Australia ,Expense,Leisure & Lifestyle,Hobbies,154,0,2215,DR
28/10/2022,Australian Veterinary Association /Expense/Household/Pets,Australian Veterinary Association ,Expense,Household,Pets,190,0,2025,DR
28/10/2022,Rooftop Bar /Expense/Leisure & Lifestyle/Pubs & Bars,Rooftop Bar ,Expense,Leisure & Lifestyle,Pubs & Bars,26,0,1999,DR
1/11/2022,Monthly Income,Monthly Income,Income,Income,Wages,0,6000,7999,CR
4/11/2022,Beacon Lighting /Expense/Household/Maintenance & Improvements,Beacon Lighting ,Expense,Household,Maintenance & Improvements,58,0,7941,DR
4/11/2022,"Service NSW /Expense/Transport/Car Insurance, Rego & Maintenance",Service NSW ,Expense,Transport,"Car Insurance, Rego & Maintenance",427,0,7514,DR
7/11/2022,Melbourne Central Lion Hotel /Expense/Leisure & Lifestyle/Pubs & Bars,Melbourne Central Lion Hotel ,Expense,Leisure & Lifestyle,Pubs & Bars,41,0,7473,DR
7/11/2022,AustralianSuper Pension /Income/Income/Other Income,AustralianSuper Pension ,Income,Income,Other Income,270,0,7203,DR
7/11/2022,"MyCar Tyre & Auto /Expense/Transport/Car Insurance, Rego & Maintenance",MyCar Tyre & Auto ,Expense,Transport,"Car Insurance, Rego & Maintenance",422,0,6781,DR
8/11/2022,Chiropractor /Expense/Personal/Health & Medical,Chiropractor ,Expense,Personal,Health & Medical,470,0,6311,DR
10/11/2022,Physiotherapy Clinic /Expense/Personal/Health & Medical,Physiotherapy Clinic ,Expense,Personal,Health & Medical,151,0,6160,DR
10/11/2022,Karate for Kids /Expense/Personal/Fitness & Wellbeing,Karate for Kids ,Expense,Personal,Fitness & Wellbeing,70,0,6090,DR
10/11/2022,VetLove /Expense/Household/Pets,VetLove ,Expense,Household,Pets,56,0,6034,DR
11/11/2022,The Coffee Club /Expense/Leisure & Lifestyle/Restaurants & Cafes,The Coffee Club ,Expense,Leisure & Lifestyle,Restaurants & Cafes,524,0,5510,DR
12/11/2022,The Iconic /Expense/Personal/Clothing & Accessories,The Iconic ,Expense,Personal,Clothing & Accessories,106,0,5404,DR
12/11/2022,Goodstart Early Learning /Expense/Personal/Children & Family,Goodstart Early Learning ,Expense,Personal,Children & Family,382,0,5022,DR
12/11/2022,Sunburn Swimwear /Expense/Personal/Clothing & Accessories,Sunburn Swimwear ,Expense,Personal,Clothing & Accessories,460,0,4562,DR
14/11/2022,Priceline Pharmacy /Expense/Personal/Health & Medical,Priceline Pharmacy ,Expense,Personal,Health & Medical,140,0,4422,DR
14/11/2022,Westpac Dividend Deposit /Income/Income/Investments,Westpac Dividend Deposit ,Income,Income,Investments,393,0,4029,DR
14/11/2022,Sylvan Learning /Expense/Personal/Education,Sylvan Learning ,Expense,Personal,Education,203,0,3826,DR
15/11/2022,Rip Curl /Expense/Personal/Clothing & Accessories,Rip Curl ,Expense,Personal,Clothing & Accessories,136,0,3690,DR
16/11/2022,Gold's Gym /Expense/Personal/Fitness & Wellbeing,Gold's Gym ,Expense,Personal,Fitness & Wellbeing,98,0,3592,DR
16/11/2022,"JAX Tyres /Expense/Transport/Car Insurance, Rego & Maintenance",JAX Tyres ,Expense,Transport,"Car Insurance, Rego & Maintenance",7,0,3585,DR
17/11/2022,City Beach /Expense/Personal/Clothing & Accessories,City Beach ,Expense,Personal,Clothing & Accessories,105,0,3480,DR
18/11/2022,"Binge /Expense/Leisure & Lifestyle/Tv, Music & Streaming",Binge ,Expense,Leisure & Lifestyle,"Tv, Music & Streaming",7,0,3473,DR
22/11/2022,Childcare Payments /Expense/Personal/Children & Family,Childcare Payments ,Expense,Personal,Children & Family,225,0,3248,DR
22/11/2022,"MyCar Tyre & Auto /Expense/Transport/Car Insurance, Rego & Maintenance",MyCar Tyre & Auto ,Expense,Transport,"Car Insurance, Rego & Maintenance",225,0,3023,DR
22/11/2022," Fantastic Furniture /Expense/Household/Furniture, Electronics & Homewares", Fantastic Furniture ,Expense,Household,"Furniture, Electronics & Homewares",177,0,2846,DR
23/11/2022,Camp Australia /Expense/Leisure & Lifestyle/Hobbies,Camp Australia ,Expense,Leisure & Lifestyle,Hobbies,67,0,2779,DR
23/11/2022,YMCA /Expense/Personal/Fitness & Wellbeing,YMCA ,Expense,Personal,Fitness & Wellbeing,208,0,2571,DR
23/11/2022,VetLove /Expense/Household/Pets,VetLove ,Expense,Household,Pets,248,0,2323,DR
23/11/2022, NSW Land Registry Services /Expense/Personal/Life Admin, NSW Land Registry Services ,Expense,Personal,Life Admin,40,0,2283,DR
25/11/2022,Catholic Education Office /Expense/Personal/Education,Catholic Education Office ,Expense,Personal,Education,120,0,2163,DR
25/11/2022,"Adairs /Expense/Household/Furniture, Electronics & Homewares",Adairs ,Expense,Household,"Furniture, Electronics & Homewares",43,0,2120,DR
25/11/2022,The Body Shop /Expense/Personal/Hair & Beauty,The Body Shop ,Expense,Personal,Hair & Beauty,147,0,1973,DR
25/11/2022,Lorna Jane /Expense/Personal/Clothing & Accessories,Lorna Jane ,Expense,Personal,Clothing & Accessories,33,0,1940,DR
26/11/2022,The Ivy /Expense/Leisure & Lifestyle/Pubs & Bars,The Ivy ,Expense,Leisure & Lifestyle,Pubs & Bars,102,0,1838,DR
26/11/2022,Soccer Clubs /Expense/Personal/Fitness & Wellbeing,Soccer Clubs ,Expense,Personal,Fitness & Wellbeing,167,0,1671,DR
27/11/2022,The Body Shop /Expense/Personal/Hair & Beauty,The Body Shop ,Expense,Personal,Hair & Beauty,89,0,1582,DR
27/11/2022,"Audible /Expense/Leisure & Lifestyle/Tv, Music & Streaming",Audible ,Expense,Leisure & Lifestyle,"Tv, Music & Streaming",76,0,1506,DR
27/11/2022,Coles Express /Expense/Transport/Fuel,Coles Express ,Expense,Transport,Fuel,88,0,1418,DR
27/11/2022,Fernwood Fitness /Expense/Personal/Fitness & Wellbeing,Fernwood Fitness ,Expense,Personal,Fitness & Wellbeing,17,0,1401,DR
27/11/2022,Hungry Jack’s /Expense/Leisure & Lifestyle/Takeaway,Hungry Jack’s ,Expense,Leisure & Lifestyle,Takeaway,11,0,1390,DR
1/12/2022,Monthly Income,Monthly Income,Income,Income,Wages,0,6000,7390,CR
2/12/2022,Mathnasium /Expense/Personal/Education,Mathnasium ,Expense,Personal,Education,110,0,7280,DR
3/12/2022,"The Good Guys /Expense/Household/Furniture, Electronics & Homewares",The Good Guys ,Expense,Household,"Furniture, Electronics & Homewares",724,0,6556,DR
3/12/2022, BSA Ltd /Expense/Household/Maintenance & Improvements, BSA Ltd ,Expense,Household,Maintenance & Improvements,155,0,6401,DR
4/12/2022,Local Fish and Chips /Expense/Leisure & Lifestyle/Takeaway,Local Fish and Chips ,Expense,Leisure & Lifestyle,Takeaway,635,0,5766,DR
4/12/2022,Chemist Warehouse /Expense/Personal/Health & Medical,Chemist Warehouse ,Expense,Personal,Health & Medical,425,0,5341,DR
4/12/2022,Who Gives A Crap /Expense/Household/Groceries,Who Gives A Crap ,Expense,Household,Groceries,151,0,5190,DR
4/12/2022,Local Hospital /Expense/Personal/Health & Medical,Local Hospital ,Expense,Personal,Health & Medical,225,0,4965,DR
4/12/2022,Melbourne Central Lion Hotel /Expense/Leisure & Lifestyle/Pubs & Bars,Melbourne Central Lion Hotel ,Expense,Leisure & Lifestyle,Pubs & Bars,99,0,4866,DR
4/12/2022,Dental Clinic /Expense/Personal/Health & Medical,Dental Clinic ,Expense,Personal,Health & Medical,107,0,4759,DR
4/12/2022,Rental Deposit from RealEstate.com.au /Income/Income/Other Income,Rental Deposit from RealEstate.com.au ,Income,Income,Other Income,324,0,4435,DR
5/12/2022,"Stan /Expense/Leisure & Lifestyle/Tv, Music & Streaming",Stan ,Expense,Leisure & Lifestyle,"Tv, Music & Streaming",335,0,4100,DR
5/12/2022,"Spotify /Expense/Leisure & Lifestyle/Tv, Music & Streaming",Spotify ,Expense,Leisure & Lifestyle,"Tv, Music & Streaming",80,0,4020,DR
6/12/2022,Big W /Expense/Personal/Children & Family,Big W ,Expense,Personal,Children & Family,349,0,3671,DR
6/12/2022,Airbnb Host Income /Income/Income/Other Income,Airbnb Host Income ,Income,Income,Other Income,118,0,3553,DR
6/12/2022,Zarraffa's Coffee /Expense/Leisure & Lifestyle/Restaurants & Cafes,Zarraffa's Coffee ,Expense,Leisure & Lifestyle,Restaurants & Cafes,120,0,3433,DR
7/12/2022,Ladbrokes /Expense/Leisure & Lifestyle/Lottery & Gambling,Ladbrokes ,Expense,Leisure & Lifestyle,Lottery & Gambling,5,0,3428,DR
7/12/2022,"Service NSW /Expense/Transport/Car Insurance, Rego & Maintenance",Service NSW ,Expense,Transport,"Car Insurance, Rego & Maintenance",94,0,3334,DR
8/12/2022,Campion Education /Expense/Personal/Children & Family,Campion Education ,Expense,Personal,Children & Family,334,0,3000,DR
8/12/2022,Sunnybank Hotel /Expense/Leisure & Lifestyle/Pubs & Bars,Sunnybank Hotel ,Expense,Leisure & Lifestyle,Pubs & Bars,241,0,2759,DR
9/12/2022,Chemist Warehouse /Expense/Personal/Health & Medical,Chemist Warehouse ,Expense,Personal,Health & Medical,75,0,2684,DR
9/12/2022,Acupuncture Clinic /Expense/Personal/Health & Medical,Acupuncture Clinic ,Expense,Personal,Health & Medical,191,0,2493,DR
9/12/2022,Ballet Schools /Expense/Personal/Fitness & Wellbeing,Ballet Schools ,Expense,Personal,Fitness & Wellbeing,69,0,2424,DR
9/12/2022,PayPal Transfer from Sale /Income/Income/Other Income,PayPal Transfer from Sale ,Income,Income,Other Income,204,0,2220,DR
9/12/2022,Petbarn /Expense/Household/Pets,Petbarn ,Expense,Household,Pets,36,0,2184,DR
10/12/2022,AGL Energy /Expense/Household/Utilities,AGL Energy ,Expense,Household,Utilities,18,0,2166,DR
10/12/2022,Australian Veterinary Association /Expense/Household/Pets,Australian Veterinary Association ,Expense,Household,Pets,138,0,2028,DR
11/12/2022,Massage Therapy Center /Expense/Personal/Health & Medical,Massage Therapy Center ,Expense,Personal,Health & Medical,130,0,1898,DR
11/12/2022,KU Children's Services /Expense/Personal/Children & Family,KU Children's Services ,Expense,Personal,Children & Family,181,0,1717,DR
12/12/2022,The Rocks Bar and Pub /Expense/Leisure & Lifestyle/Pubs & Bars,The Rocks Bar and Pub ,Expense,Leisure & Lifestyle,Pubs & Bars,74,0,1643,DR
12/12/2022,"Kmart Tyre & Auto Service /Expense/Transport/Car Insurance, Rego & Maintenance",Kmart Tyre & Auto Service ,Expense,Transport,"Car Insurance, Rego & Maintenance",92,0,1551,DR
12/12/2022, NSW Land Registry Services /Expense/Personal/Life Admin, NSW Land Registry Services ,Expense,Personal,Life Admin,127,0,1424,DR
12/12/2022,City Beach /Expense/Personal/Clothing & Accessories,City Beach ,Expense,Personal,Clothing & Accessories,112,0,1312,DR
13/12/2022,Booktopia /Expense/Leisure & Lifestyle/Hobbies,Booktopia ,Expense,Leisure & Lifestyle,Hobbies,21,0,1291,DR
14/12/2022,Sylvan Learning /Expense/Personal/Education,Sylvan Learning ,Expense,Personal,Education,30,0,1261,DR
14/12/2022,QBE Insurance Claim Payout /Income/Income/Other Income,QBE Insurance Claim Payout ,Income,Income,Other Income,109,0,1152,DR
15/12/2022,Domino’s Pizza /Expense/Leisure & Lifestyle/Takeaway,Domino’s Pizza ,Expense,Leisure & Lifestyle,Takeaway,29,0,1123,DR
16/12/2022, Meriton Apartments /Expense/Household/Rates & Insurance, Meriton Apartments ,Expense,Household,Rates & Insurance,9,0,1114,DR
17/12/2022,Snap Fitness /Expense/Personal/Fitness & Wellbeing,Snap Fitness ,Expense,Personal,Fitness & Wellbeing,10,0,1104,DR
18/12/2022,YMCA /Expense/Personal/Fitness & Wellbeing,YMCA ,Expense,Personal,Fitness & Wellbeing,85,0,1019,DR
19/12/2022,Rebel Sport /Expense/Personal/Fitness & Wellbeing,Rebel Sport ,Expense,Personal,Fitness & Wellbeing,76,0,943,DR
19/12/2022,T2 Tea /Expense/Personal/Fitness & Wellbeing,T2 Tea ,Expense,Personal,Fitness & Wellbeing,63,0,880,DR
19/12/2022, Brisbane City Council /Expense/Household/Rates & Insurance, Brisbane City Council ,Expense,Household,Rates & Insurance,76,0,804,DR
20/12/2022,Country Road /Expense/Personal/Clothing & Accessories,Country Road ,Expense,Personal,Clothing & Accessories,7,0,797,DR
20/12/2022,Menulog /Expense/Leisure & Lifestyle/Takeaway,Menulog ,Expense,Leisure & Lifestyle,Takeaway,27,0,770,DR
20/12/2022,Jetts Fitness /Expense/Personal/Fitness & Wellbeing,Jetts Fitness ,Expense,Personal,Fitness & Wellbeing,6,0,764,DR
20/12/2022,King Swim /Expense/Personal/Fitness & Wellbeing,King Swim ,Expense,Personal,Fitness & Wellbeing,47,0,717,DR
21/12/2022,Fitness First /Expense/Personal/Fitness & Wellbeing,Fitness First ,Expense,Personal,Fitness & Wellbeing,47,0,670,DR
21/12/2022,EnergyAustralia /Expense/Household/Utilities,EnergyAustralia ,Expense,Household,Utilities,47,0,623,DR
21/12/2022,Gardening Australia /Expense/Household/Maintenance & Improvements,Gardening Australia ,Expense,Household,Maintenance & Improvements,54,0,569,DR
22/12/2022,Westpac Dividend Deposit /Income/Income/Investments,Westpac Dividend Deposit ,Income,Income,Investments,11,0,558,DR
22/12/2022,Surf Dive 'n Ski /Expense/Personal/Clothing & Accessories,Surf Dive 'n Ski ,Expense,Personal,Clothing & Accessories,26,0,532,DR
23/12/2022,Café Nero /Expense/Leisure & Lifestyle/Restaurants & Cafes,Café Nero ,Expense,Leisure & Lifestyle,Restaurants & Cafes,5,0,527,DR
24/12/2022,Queensland Urban Utilities /Expense/Household/Utilities,Queensland Urban Utilities ,Expense,Household,Utilities,12,0,515,DR
24/12/2022,Kmart /Expense/Personal/Children & Family,Kmart ,Expense,Personal,Children & Family,43,0,472,DR
24/12/2022,School Locker /Expense/Personal/Children & Family,School Locker ,Expense,Personal,Children & Family,13,0,459,DR
25/12/2022,"Kayo Sports /Expense/Leisure & Lifestyle/Tv, Music & Streaming",Kayo Sports ,Expense,Leisure & Lifestyle,"Tv, Music & Streaming",14,0,445,DR
25/12/2022,Medicare Claim /Expense/Personal/Health & Medical,Medicare Claim ,Expense,Personal,Health & Medical,44,0,401,DR
26/12/2022,The Ivy /Expense/Leisure & Lifestyle/Pubs & Bars,The Ivy ,Expense,Leisure & Lifestyle,Pubs & Bars,36,0,365,DR
26/12/2022,Fernwood Fitness /Expense/Personal/Fitness & Wellbeing,Fernwood Fitness ,Expense,Personal,Fitness & Wellbeing,27,0,338,DR
1/1/2023,Monthly Income,Monthly Income,Income,Income,Wages,0,6000,6338,CR
2/1/2023,The Coffee Club /Expense/Leisure & Lifestyle/Restaurants & Cafes,The Coffee Club ,Expense,Leisure & Lifestyle,Restaurants & Cafes,132,0,6206,DR
3/1/2023,"Le Creuset /Expense/Household/Furniture, Electronics & Homewares",Le Creuset ,Expense,Household,"Furniture, Electronics & Homewares",100,0,6106,DR
3/1/2023,Melbourne Central Lion Hotel /Expense/Leisure & Lifestyle/Pubs & Bars,Melbourne Central Lion Hotel ,Expense,Leisure & Lifestyle,Pubs & Bars,194,0,5912,DR
5/1/2023,The Australian /Expense/Personal/Education,The Australian ,Expense,Personal,Education,429,0,5483,DR
5/1/2023,Freedom Furniture /Expense/Household/Maintenance & Improvements,Freedom Furniture ,Expense,Household,Maintenance & Improvements,441,0,5042,DR
5/1/2023,"Ultra Tune /Expense/Transport/Car Insurance, Rego & Maintenance",Ultra Tune ,Expense,Transport,"Car Insurance, Rego & Maintenance",337,0,4705,DR
7/1/2023,Menulog /Expense/Leisure & Lifestyle/Takeaway,Menulog ,Expense,Leisure & Lifestyle,Takeaway,347,0,4358,DR
8/1/2023,Surf Dive 'n Ski /Expense/Personal/Clothing & Accessories,Surf Dive 'n Ski ,Expense,Personal,Clothing & Accessories,14,0,4344,DR
10/1/2023,"Bridgestone Select /Expense/Transport/Car Insurance, Rego & Maintenance",Bridgestone Select ,Expense,Transport,"Car Insurance, Rego & Maintenance",137,0,4207,DR
13/1/2023,BP /Expense/Transport/Fuel,BP ,Expense,Transport,Fuel,265,0,3942,DR
14/1/2023,Officeworks /Expense/Personal/Life Admin,Officeworks ,Expense,Personal,Life Admin,115,0,3827,DR
15/1/2023,Stand Up Paddleboard Rental /Expense/Personal/Fitness & Wellbeing,Stand Up Paddleboard Rental ,Expense,Personal,Fitness & Wellbeing,86,0,3741,DR
16/1/2023,"Foxtel /Expense/Leisure & Lifestyle/Tv, Music & Streaming",Foxtel ,Expense,Leisure & Lifestyle,"Tv, Music & Streaming",247,0,3494,DR
16/1/2023,"Green Slip Insurance /Expense/Transport/Car Insurance, Rego & Maintenance",Green Slip Insurance ,Expense,Transport,"Car Insurance, Rego & Maintenance",67,0,3427,DR
16/1/2023,Microsoft 365 /Expense/Personal/Education,Microsoft 365 ,Expense,Personal,Education,281,0,3146,DR
18/1/2023,Acupuncture Clinic /Expense/Personal/Health & Medical,Acupuncture Clinic ,Expense,Personal,Health & Medical,93,0,3053,DR
18/1/2023,Anytime Fitness /Expense/Personal/Fitness & Wellbeing,Anytime Fitness ,Expense,Personal,Fitness & Wellbeing,93,0,2960,DR
18/1/2023,"Barbeques Galore /Expense/Household/Furniture, Electronics & Homewares",Barbeques Galore ,Expense,Household,"Furniture, Electronics & Homewares",143,0,2817,DR
19/1/2023,Greencross Vets /Expense/Household/Pets,Greencross Vets ,Expense,Household,Pets,235,0,2582,DR
20/1/2023,The Australian /Expense/Personal/Education,The Australian ,Expense,Personal,Education,171,0,2411,DR
20/1/2023,Centrelink JobSeeker Payment /Income/Income/Other Income,Centrelink JobSeeker Payment ,Income,Income,Other Income,215,0,2196,DR
21/1/2023,The Victory Hotel /Expense/Leisure & Lifestyle/Pubs & Bars,The Victory Hotel ,Expense,Leisure & Lifestyle,Pubs & Bars,107,0,2089,DR
24/1/2023,The Body Shop /Expense/Personal/Hair & Beauty,The Body Shop ,Expense,Personal,Hair & Beauty,173,0,1916,DR
25/1/2023,ALDI /Expense/Household/Groceries,ALDI ,Expense,Household,Groceries,83,0,1833,DR
25/1/2023,Apple Store /Expense/Leisure & Lifestyle/Electronics,Apple Store ,Expense,Leisure & Lifestyle,Electronics,184,0,1649,DR
26/1/2023,Medicare Claim /Expense/Personal/Health & Medical,Medicare Claim ,Expense,Personal,Health & Medical,53,0,1596,DR
27/1/2023,KU Children's Services /Expense/Personal/Children & Family,KU Children's Services ,Expense,Personal,Children & Family,45,0,1551,DR
27/1/2023,Café Nero /Expense/Leisure & Lifestyle/Restaurants & Cafes,Café Nero ,Expense,Leisure & Lifestyle,Restaurants & Cafes,43,0,1508,DR
28/1/2023,"Le Creuset /Expense/Household/Furniture, Electronics & Homewares",Le Creuset ,Expense,Household,"Furniture, Electronics & Homewares",141,0,1367,DR
28/1/2023,"Ultra Tune /Expense/Transport/Car Insurance, Rego & Maintenance",Ultra Tune ,Expense,Transport,"Car Insurance, Rego & Maintenance",69,0,1298,DR
1/2/2023,Monthly Income,Monthly Income,Income,Income,Wages,0,6000,7298,CR
2/2/2023,Kumon /Expense/Personal/Education,Kumon ,Expense,Personal,Education,519,0,6779,DR
2/2/2023, EnergyAustralia /Expense/Household/Utilities, EnergyAustralia ,Expense,Household,Utilities,256,0,6523,DR
2/2/2023,"Harvey Norman /Expense/Household/Furniture, Electronics & Homewares",Harvey Norman ,Expense,Household,"Furniture, Electronics & Homewares",482,0,6041,DR
2/2/2023,Rip Curl /Expense/Personal/Clothing & Accessories,Rip Curl ,Expense,Personal,Clothing & Accessories,241,0,5800,DR
3/2/2023,The Body Shop /Expense/Personal/Hair & Beauty,The Body Shop ,Expense,Personal,Hair & Beauty,356,0,5444,DR
3/2/2023,Karate for Kids /Expense/Personal/Fitness & Wellbeing,Karate for Kids ,Expense,Personal,Fitness & Wellbeing,332,0,5112,DR
3/2/2023,Timezone /Expense/Leisure & Lifestyle/Entertainment,Timezone ,Expense,Leisure & Lifestyle,Entertainment,238,0,4874,DR
3/2/2023,Decathlon /Expense/Personal/Fitness & Wellbeing,Decathlon ,Expense,Personal,Fitness & Wellbeing,118,0,4756,DR
3/2/2023,Aqua Fun Park /Expense/Leisure & Lifestyle/Holidays & Travel,Aqua Fun Park ,Expense,Leisure & Lifestyle,Holidays & Travel,96,0,4660,DR
3/2/2023,Stand Up Paddleboard Rental /Expense/Personal/Fitness & Wellbeing,Stand Up Paddleboard Rental ,Expense,Personal,Fitness & Wellbeing,403,0,4257,DR
3/2/2023,Little Athletics /Expense/Personal/Fitness & Wellbeing,Little Athletics ,Expense,Personal,Fitness & Wellbeing,288,0,3969,DR
4/2/2023,Westpac Dividend Deposit /Income/Income/Investments,Westpac Dividend Deposit ,Income,Income,Investments,262,0,3707,DR
5/2/2023,The Brisbane Hotel /Expense/Leisure & Lifestyle/Pubs & Bars,The Brisbane Hotel ,Expense,Leisure & Lifestyle,Pubs & Bars,50,0,3657,DR
5/2/2023,"Barbeques Galore /Expense/Household/Furniture, Electronics & Homewares",Barbeques Galore ,Expense,Household,"Furniture, Electronics & Homewares",340,0,3317,DR
5/2/2023,Westpac Dividend Deposit /Income/Income/Investments,Westpac Dividend Deposit ,Income,Income,Investments,267,0,3050,DR
7/2/2023,"Apple Music /Expense/Leisure & Lifestyle/Tv, Music & Streaming",Apple Music ,Expense,Leisure & Lifestyle,"Tv, Music & Streaming",213,0,2837,DR
7/2/2023,Origin Energy /Expense/Household/Utilities,Origin Energy ,Expense,Household,Utilities,99,0,2738,DR
8/2/2023,Dymocks /Expense/Leisure & Lifestyle/Hobbies,Dymocks ,Expense,Leisure & Lifestyle,Hobbies,244,0,2494,DR
8/2/2023,"MyCar Tyre & Auto /Expense/Transport/Car Insurance, Rego & Maintenance",MyCar Tyre & Auto ,Expense,Transport,"Car Insurance, Rego & Maintenance",73,0,2421,DR
8/2/2023,Officeworks /Expense/Personal/Life Admin,Officeworks ,Expense,Personal,Life Admin,104,0,2317,DR
8/2/2023,Witchery /Expense/Personal/Clothing & Accessories,Witchery ,Expense,Personal,Clothing & Accessories,109,0,2208,DR
8/2/2023,EnergyAustralia /Expense/Household/Utilities,EnergyAustralia ,Expense,Household,Utilities,8,0,2200,DR
9/2/2023, National Bank /Expense/Personal/Fees & Charges, National Bank ,Expense,Personal,Fees & Charges,141,0,2059,DR
9/2/2023, Rentokil /Expense/Household/Maintenance & Improvements, Rentokil ,Expense,Household,Maintenance & Improvements,146,0,1913,DR
9/2/2023,Swim Australia /Expense/Personal/Fitness & Wellbeing,Swim Australia ,Expense,Personal,Fitness & Wellbeing,111,0,1802,DR
9/2/2023, Metricon /Expense/Household/Maintenance & Improvements, Metricon ,Expense,Household,Maintenance & Improvements,79,0,1723,DR
10/2/2023,Woolworths /Expense/Household/Groceries,Woolworths ,Expense,Household,Groceries,105,0,1618,DR
10/2/2023,Endota Spa /Expense/Personal/Fitness & Wellbeing,Endota Spa ,Expense,Personal,Fitness & Wellbeing,37,0,1581,DR
11/2/2023,Sunburn Swimwear /Expense/Personal/Clothing & Accessories,Sunburn Swimwear ,Expense,Personal,Clothing & Accessories,14,0,1567,DR
11/2/2023,Kumon /Expense/Personal/Education,Kumon ,Expense,Personal,Education,72,0,1495,DR
14/2/2023,Dan Murphy’s /Expense/Leisure & Lifestyle/Alcohol,Dan Murphy’s ,Expense,Leisure & Lifestyle,Alcohol,38,0,1457,DR
14/2/2023,"The Good Guys /Expense/Household/Furniture, Electronics & Homewares",The Good Guys ,Expense,Household,"Furniture, Electronics & Homewares",121,0,1336,DR
15/2/2023,Menulog /Expense/Leisure & Lifestyle/Takeaway,Menulog ,Expense,Leisure & Lifestyle,Takeaway,39,0,1297,DR
15/2/2023,"Green Slip Insurance /Expense/Transport/Car Insurance, Rego & Maintenance",Green Slip Insurance ,Expense,Transport,"Car Insurance, Rego & Maintenance",24,0,1273,DR
15/2/2023,Beachside Caravan Park /Expense/Leisure & Lifestyle/Holidays & Travel,Beachside Caravan Park ,Expense,Leisure & Lifestyle,Holidays & Travel,82,0,1191,DR
15/2/2023,BP /Expense/Transport/Fuel,BP ,Expense,Transport,Fuel,95,0,1096,DR
15/2/2023,Booktopia /Expense/Leisure & Lifestyle/Hobbies,Booktopia ,Expense,Leisure & Lifestyle,Hobbies,108,0,988,DR
16/2/2023, Jim's Mowing /Expense/Household/Maintenance & Improvements, Jim's Mowing ,Expense,Household,Maintenance & Improvements,95,0,893,DR
17/2/2023, Ray White Real Estate /Expense/Personal/Life Admin, Ray White Real Estate ,Expense,Personal,Life Admin,90,0,803,DR
17/2/2023,Beach Café /Expense/Leisure & Lifestyle/Restaurants & Cafes,Beach Café ,Expense,Leisure & Lifestyle,Restaurants & Cafes,47,0,756,DR
17/2/2023,The Australian /Expense/Personal/Education,The Australian ,Expense,Personal,Education,20,0,736,DR
17/2/2023,The Coffee Club /Expense/Leisure & Lifestyle/Restaurants & Cafes,The Coffee Club ,Expense,Leisure & Lifestyle,Restaurants & Cafes,51,0,685,DR
18/2/2023, Jim's Mowing /Expense/Household/Maintenance & Improvements, Jim's Mowing ,Expense,Household,Maintenance & Improvements,47,0,638,DR
19/2/2023,Flight Centre /Expense/Leisure & Lifestyle/Holidays & Travel,Flight Centre ,Expense,Leisure & Lifestyle,Holidays & Travel,37,0,601,DR
19/2/2023,Eau De Vie /Expense/Leisure & Lifestyle/Pubs & Bars,Eau De Vie ,Expense,Leisure & Lifestyle,Pubs & Bars,14,0,587,DR
19/2/2023,Chemist Warehouse /Expense/Personal/Health & Medical,Chemist Warehouse ,Expense,Personal,Health & Medical,29,0,558,DR
19/2/2023,Toys 'R' Us /Expense/Personal/CHildren & Family,Toys 'R' Us ,Expense,Personal,CHildren & Family,49,0,509,DR
19/2/2023,Pizza Hut /Expense/Leisure & Lifestyle/Takeaway,Pizza Hut ,Expense,Leisure & Lifestyle,Takeaway,15,0,494,DR
20/2/2023,Optometrist /Expense/Personal/Health & Medical,Optometrist ,Expense,Personal,Health & Medical,22,0,472,DR
21/2/2023, National Bank /Expense/Personal/Fees & Charges, National Bank ,Expense,Personal,Fees & Charges,5,0,467,DR
21/2/2023,"Service NSW /Expense/Transport/Car Insurance, Rego & Maintenance",Service NSW ,Expense,Transport,"Car Insurance, Rego & Maintenance",44,0,423,DR
24/2/2023,Gold's Gym /Expense/Personal/Fitness & Wellbeing,Gold's Gym ,Expense,Personal,Fitness & Wellbeing,41,0,382,DR
24/2/2023,Local Hospital /Expense/Personal/Health & Medical,Local Hospital ,Expense,Personal,Health & Medical,26,0,356,DR
24/2/2023,"NRMA Roadside Assistance /Expense/Transport/Car Insurance, Rego & Maintenance",NRMA Roadside Assistance ,Expense,Transport,"Car Insurance, Rego & Maintenance",18,0,338,DR
24/2/2023,Catholic Education Office /Expense/Personal/Education,Catholic Education Office ,Expense,Personal,Education,9,0,329,DR
24/2/2023,Spotlight /Expense/Leisure & Lifestyle/Hobbies,Spotlight ,Expense,Leisure & Lifestyle,Hobbies,15,0,314,DR
24/2/2023," The Good Guys /Expense/Household/Furniture, Electronics & Homewares", The Good Guys ,Expense,Household,"Furniture, Electronics & Homewares",8,0,306,DR
27/2/2023,Australian Veterinary Association /Expense/Household/Pets,Australian Veterinary Association ,Expense,Household,Pets,17,0,289,DR
27/2/2023,"VicRoads /Expense/Transport/Car Insurance, Rego & Maintenance",VicRoads ,Expense,Transport,"Car Insurance, Rego & Maintenance",15,0,274,DR
28/2/2023,VetLove /Expense/Household/Pets,VetLove ,Expense,Household,Pets,7,0,267,DR
1/3/2023,Monthly Income,Monthly Income,Income,Income,Wages,0,6000,6267,CR
4/3/2023," Fantastic Furniture /Expense/Household/Furniture, Electronics & Homewares", Fantastic Furniture ,Expense,Household,"Furniture, Electronics & Homewares",300,0,5967,DR
4/3/2023,OfficeMax /Expense/Personal/Life Admin,OfficeMax ,Expense,Personal,Life Admin,562,0,5405,DR
4/3/2023,Upwork Freelancer Payment /Income/Income/Other Income,Upwork Freelancer Payment ,Income,Income,Other Income,444,0,4961,DR
5/3/2023, Jim’s Building Inspections /Expense/Household/Maintenance & Improvements, Jim’s Building Inspections ,Expense,Household,Maintenance & Improvements,60,0,4901,DR
5/3/2023,Fitness First /Expense/Personal/Fitness & Wellbeing,Fitness First ,Expense,Personal,Fitness & Wellbeing,123,0,4778,DR
5/3/2023,Chinatown Night Market /Expense/Leisure & Lifestyle/Pubs & Bars,Chinatown Night Market ,Expense,Leisure & Lifestyle,Pubs & Bars,311,0,4467,DR
6/3/2023,Chiropractor /Expense/Personal/Health & Medical,Chiropractor ,Expense,Personal,Health & Medical,193,0,4274,DR
6/3/2023,VetLove /Expense/Household/Pets,VetLove ,Expense,Household,Pets,49,0,4225,DR
7/3/2023,Ladbrokes /Expense/Leisure & Lifestyle/Lottery & Gambling,Ladbrokes ,Expense,Leisure & Lifestyle,Lottery & Gambling,19,0,4206,DR
7/3/2023,Grill'd /Expense/Leisure & Lifestyle/Takeaway,Grill'd ,Expense,Leisure & Lifestyle,Takeaway,206,0,4000,DR
9/3/2023,"Adairs /Expense/Household/Furniture, Electronics & Homewares",Adairs ,Expense,Household,"Furniture, Electronics & Homewares",6,0,3994,DR
11/3/2023,Quay Restaurant /Expense/Leisure & Lifestyle/Pubs & Bars,Quay Restaurant ,Expense,Leisure & Lifestyle,Pubs & Bars,256,0,3738,DR
12/3/2023,Zarraffa's Coffee /Expense/Leisure & Lifestyle/Restaurants & Cafes,Zarraffa's Coffee ,Expense,Leisure & Lifestyle,Restaurants & Cafes,112,0,3626,DR
12/3/2023,Coles /Expense/Household/Groceries,Coles ,Expense,Household,Groceries,143,0,3483,DR
13/3/2023,Country Road /Expense/Personal/Clothing & Accessories,Country Road ,Expense,Personal,Clothing & Accessories,308,0,3175,DR
13/3/2023,"Repco /Expense/Transport/Car Insurance, Rego & Maintenance",Repco ,Expense,Transport,"Car Insurance, Rego & Maintenance",13,0,3162,DR
13/3/2023,Palace Cinemas /Expense/Leisure & Lifestyle/Entertainment,Palace Cinemas ,Expense,Leisure & Lifestyle,Entertainment,191,0,2971,DR
14/3/2023,Coles /Expense/Household/Groceries,Coles ,Expense,Household,Groceries,60,0,2911,DR
14/3/2023,Sunnybank Hotel /Expense/Leisure & Lifestyle/Pubs & Bars,Sunnybank Hotel ,Expense,Leisure & Lifestyle,Pubs & Bars,17,0,2894,DR
15/3/2023,Coles Express /Expense/Transport/Fuel,Coles Express ,Expense,Transport,Fuel,216,0,2678,DR
15/3/2023,Pizza Hut /Expense/Leisure & Lifestyle/Takeaway,Pizza Hut ,Expense,Leisure & Lifestyle,Takeaway,89,0,2589,DR
16/3/2023,Camp Australia /Expense/Leisure & Lifestyle/Hobbies,Camp Australia ,Expense,Leisure & Lifestyle,Hobbies,120,0,2469,DR
16/3/2023,Rooftop Bar /Expense/Leisure & Lifestyle/Pubs & Bars,Rooftop Bar ,Expense,Leisure & Lifestyle,Pubs & Bars,43,0,2426,DR
16/3/2023, Jim's Mowing /Expense/Household/Maintenance & Improvements, Jim's Mowing ,Expense,Household,Maintenance & Improvements,114,0,2312,DR
19/3/2023,Music Academy /Expense/Leisure & Lifestyle/Hobbies,Music Academy ,Expense,Leisure & Lifestyle,Hobbies,186,0,2126,DR
22/3/2023,PayPal Transfer from Sale /Income/Income/Other Income,PayPal Transfer from Sale ,Income,Income,Other Income,46,0,2080,DR
22/3/2023,Little Athletics /Expense/Personal/Fitness & Wellbeing,Little Athletics ,Expense,Personal,Fitness & Wellbeing,88,0,1992,DR
22/3/2023,The Coffee Club /Expense/Leisure & Lifestyle/Restaurants & Cafes,The Coffee Club ,Expense,Leisure & Lifestyle,Restaurants & Cafes,63,0,1929,DR
24/3/2023,Shell V Power/Expense/Transport/Fuel,Shell V Power,Expense,Transport,Fuel,152,0,1777,DR
24/3/2023,Zarraffa's Coffee /Expense/Leisure & Lifestyle/Restaurants & Cafes,Zarraffa's Coffee ,Expense,Leisure & Lifestyle,Restaurants & Cafes,105,0,1672,DR
24/3/2023,Chemist Warehouse /Expense/Personal/Health & Medical,Chemist Warehouse ,Expense,Personal,Health & Medical,36,0,1636,DR
25/3/2023,Ice Cream Parlour /Expense/Leisure & Lifestyle/Takeaway,Ice Cream Parlour ,Expense,Leisure & Lifestyle,Takeaway,149,0,1487,DR
25/3/2023,Beach Café /Expense/Leisure & Lifestyle/Restaurants & Cafes,Beach Café ,Expense,Leisure & Lifestyle,Restaurants & Cafes,56,0,1431,DR
25/3/2023,The Iconic /Expense/Personal/Clothing & Accessories,The Iconic ,Expense,Personal,Clothing & Accessories,114,0,1317,DR
26/3/2023, BSA Ltd /Expense/Household/Maintenance & Improvements, BSA Ltd ,Expense,Household,Maintenance & Improvements,11,0,1306,DR
26/3/2023,Petbarn /Expense/Household/Pets,Petbarn ,Expense,Household,Pets,129,0,1177,DR
26/3/2023,Rip Curl /Expense/Personal/Clothing & Accessories,Rip Curl ,Expense,Personal,Clothing & Accessories,93,0,1084,DR
27/3/2023,Airbnb Host Income /Income/Income/Other Income,Airbnb Host Income ,Income,Income,Other Income,69,0,1015,DR
28/3/2023,David Jones /Expense/Personal/Clothing & Accessories,David Jones ,Expense,Personal,Clothing & Accessories,31,0,984,DR
28/3/2023,Vodafone Prepaid /Expense/Personal/Mobile Phone,Vodafone Prepaid ,Expense,Personal,Mobile Phone,8,0,976,DR
28/3/2023,Coles Express /Expense/Transport/Fuel,Coles Express ,Expense,Transport,Fuel,57,0,919,DR
1/4/2023,Monthly Income,Monthly Income,Income,Income,Wages,0,6000,6919,CR
2/4/2023, Brisbane City Council /Expense/Household/Rates & Insurance, Brisbane City Council ,Expense,Household,Rates & Insurance,378,0,6541,DR
4/4/2023,Anytime Fitness /Expense/Personal/Fitness & Wellbeing,Anytime Fitness ,Expense,Personal,Fitness & Wellbeing,594,0,5947,DR
6/4/2023,The Baxter Inn /Expense/Leisure & Lifestyle/Pubs & Bars,The Baxter Inn ,Expense,Leisure & Lifestyle,Pubs & Bars,160,0,5787,DR
6/4/2023,Muffin Break /Expense/Leisure & Lifestyle/Restaurants & Cafes,Muffin Break ,Expense,Leisure & Lifestyle,Restaurants & Cafes,562,0,5225,DR
7/4/2023,Endota Spa /Expense/Personal/Fitness & Wellbeing,Endota Spa ,Expense,Personal,Fitness & Wellbeing,190,0,5035,DR
7/4/2023,Coles /Expense/Household/Groceries,Coles ,Expense,Household,Groceries,184,0,4851,DR
7/4/2023,KU Children's Services /Expense/Personal/Children & Family,KU Children's Services ,Expense,Personal,Children & Family,69,0,4782,DR
8/4/2023,"Foxtel /Expense/Leisure & Lifestyle/Tv, Music & Streaming",Foxtel ,Expense,Leisure & Lifestyle,"Tv, Music & Streaming",192,0,4590,DR
8/4/2023,Soccer Clubs /Expense/Personal/Fitness & Wellbeing,Soccer Clubs ,Expense,Personal,Fitness & Wellbeing,43,0,4547,DR
8/4/2023,AMF Bowling /Expense/Leisure & Lifestyle/Entertainment,AMF Bowling ,Expense,Leisure & Lifestyle,Entertainment,279,0,4268,DR
11/4/2023,"Kmart Tyre & Auto Service /Expense/Transport/Car Insurance, Rego & Maintenance",Kmart Tyre & Auto Service ,Expense,Transport,"Car Insurance, Rego & Maintenance",321,0,3947,DR
11/4/2023,"VicRoads /Expense/Transport/Car Insurance, Rego & Maintenance",VicRoads ,Expense,Transport,"Car Insurance, Rego & Maintenance",158,0,3789,DR
11/4/2023,Dan Murphy’s /Expense/Leisure & Lifestyle/Alcohol,Dan Murphy’s ,Expense,Leisure & Lifestyle,Alcohol,165,0,3624,DR
12/4/2023,"Service NSW /Expense/Transport/Car Insurance, Rego & Maintenance",Service NSW ,Expense,Transport,"Car Insurance, Rego & Maintenance",17,0,3607,DR
13/4/2023,South East Water /Expense/Household/Utilities,South East Water ,Expense,Household,Utilities,163,0,3444,DR
14/4/2023,Queensland Urban Utilities /Expense/Household/Utilities,Queensland Urban Utilities ,Expense,Household,Utilities,181,0,3263,DR
15/4/2023,"Le Creuset /Expense/Household/Furniture, Electronics & Homewares",Le Creuset ,Expense,Household,"Furniture, Electronics & Homewares",181,0,3082,DR
15/4/2023,CommSec Share Trading Gains /Income/Income/Investments,CommSec Share Trading Gains ,Income,Income,Investments,9,0,3073,DR
18/4/2023,Queensland Urban Utilities /Expense/Household/Utilities,Queensland Urban Utilities ,Expense,Household,Utilities,105,0,2968,DR
19/4/2023,Ice Cream Parlour /Expense/Leisure & Lifestyle/Takeaway,Ice Cream Parlour ,Expense,Leisure & Lifestyle,Takeaway,57,0,2911,DR
19/4/2023,South East Water /Expense/Household/Utilities,South East Water ,Expense,Household,Utilities,192,0,2719,DR
19/4/2023,Endota Spa /Expense/Personal/Fitness & Wellbeing,Endota Spa ,Expense,Personal,Fitness & Wellbeing,86,0,2633,DR
20/4/2023,Freedom Furniture /Expense/Household/Maintenance & Improvements,Freedom Furniture ,Expense,Household,Maintenance & Improvements,37,0,2596,DR
21/4/2023,Microsoft 365 /Expense/Personal/Education,Microsoft 365 ,Expense,Personal,Education,208,0,2388,DR
21/4/2023,Hungry Jack’s /Expense/Leisure & Lifestyle/Takeaway,Hungry Jack’s ,Expense,Leisure & Lifestyle,Takeaway,6,0,2382,DR
23/4/2023,Endota Spa /Expense/Personal/Fitness & Wellbeing,Endota Spa ,Expense,Personal,Fitness & Wellbeing,60,0,2322,DR
23/4/2023,"Repco /Expense/Transport/Car Insurance, Rego & Maintenance",Repco ,Expense,Transport,"Car Insurance, Rego & Maintenance",141,0,2181,DR
23/4/2023,Physiotherapy Clinic /Expense/Personal/Health & Medical,Physiotherapy Clinic ,Expense,Personal,Health & Medical,135,0,2046,DR
23/4/2023,Child Support Agency Deposit /Income/Income/Other Income,Child Support Agency Deposit ,Income,Income,Other Income,28,0,2018,DR
25/4/2023,Kumon /Expense/Personal/Education,Kumon ,Expense,Personal,Education,39,0,1979,DR
25/4/2023,Flight Centre /Expense/Leisure & Lifestyle/Holidays & Travel,Flight Centre ,Expense,Leisure & Lifestyle,Holidays & Travel,29,0,1950,DR
26/4/2023,The Sydney Morning Herald /Expense/Personal/Education,The Sydney Morning Herald ,Expense,Personal,Education,78,0,1872,DR
26/4/2023, Brisbane City Council /Expense/Household/Rates & Insurance, Brisbane City Council ,Expense,Household,Rates & Insurance,150,0,1722,DR
28/4/2023,"JAX Tyres /Expense/Transport/Car Insurance, Rego & Maintenance",JAX Tyres ,Expense,Transport,"Car Insurance, Rego & Maintenance",132,0,1590,DR