Date,Transaction Description,Debit,Credit,Balance,Category 1,Category 2,Category 3,DR/CR
2022-01-01,Monthly Income,0,6542,6542,Income,Income,Wages,CR
2022-01-02,Tennis Australia ,129,0,6413,Expense,Personal,Fitness & Wellbeing,DR
2022-01-02,Stand Up Paddleboard Rental ,85,0,6328,Expense,Personal,Fitness & Wellbeing,DR
2022-01-02,Karate for Kids ,180,0,6148,Expense,Personal,Fitness & Wellbeing,DR
2022-01-04,Repco ,246,0,5902,Expense,Transport,"Car Insurance, Rego & Maintenance",DR
2022-01-06,JAX Tyres ,578,0,5324,Expense,Transport,"Car Insurance, Rego & Maintenance",DR
2022-01-06,Karate for Kids ,315,0,5009,Expense,Personal,Fitness & Wellbeing,DR
2022-01-06,Taronga Zoo ,223,0,4786,Expense,Leisure & Lifestyle,Entertainment,DR
2022-01-06,Stan ,177,0,4609,Expense,Leisure & Lifestyle,"Tv, Music & Streaming",DR
2022-01-07,Childcare Payments ,360,0,4249,Expense,Personal,Children & Family,DR
2022-01-07,Snap Fitness ,250,0,3999,Expense,Personal,Fitness & Wellbeing,DR
2022-01-07,Upwork Freelancer Payment ,36,0,3963,Income,Income,Other Income,DR
2022-01-09,Freedom Furniture ,101,0,3862,Expense,Household,Maintenance & Improvements,DR
2022-01-09,Kmart ,339,0,3523,Expense,Personal,Children & Family,DR
2022-01-11,Barbeques Galore ,78,0,3445,Expense,Household,"Furniture, Electronics & Homewares",DR
2022-01-11,EnergyAustralia ,187,0,3258,Expense,Household,Utilities,DR
2022-01-12,Campion Education ,173,0,3085,Expense,Personal,Children & Family,DR
2022-01-14,Chemist Warehouse ,19,0,3066,Expense,Personal,Health & Medical,DR
2022-01-14,Massage Therapy Center ,191,0,2875,Expense,Personal,Health & Medical,DR
2022-01-14,Beach Café ,155,0,2720,Expense,Leisure & Lifestyle,Restaurants & Cafes,DR
2022-01-15,Tennis Australia ,20,0,2700,Expense,Personal,Fitness & Wellbeing,DR
2022-01-15,The Good Guys ,41,0,2659,Expense,Household,"Furniture, Electronics & Homewares",DR
2022-01-15,Payday Advance ,265,0,2394,Income,Income,Other Income,DR
2022-01-16,Liquorland ,92,0,2302,Expense,Leisure & Lifestyle,Alcohol,DR
2022-01-16,Ballet Schools ,51,0,2251,Expense,Personal,Fitness & Wellbeing,DR
2022-01-16, Jim's Mowing ,198,0,2053,Expense,Household,Maintenance & Improvements,DR
2022-01-16,Centrelink JobSeeker Payment ,123,0,1930,Income,Income,Other Income,DR
2022-01-16,Fitness First ,80,0,1850,Expense,Personal,Fitness & Wellbeing,DR
2022-01-17,OfficeMax ,131,0,1719,Expense,Personal,Life Admin,DR
2022-01-17,The Baxter Inn ,122,0,1597,Expense,Leisure & Lifestyle,Pubs & Bars,DR
2022-01-18,Adairs ,11,0,1586,Expense,Household,"Furniture, Electronics & Homewares",DR
2022-01-18,BrewDog ,154,0,1432,Expense,Leisure & Lifestyle,Alcohol,DR
2022-01-18, National Bank ,78,0,1354,Expense,Personal,Fees & Charges,DR
2022-01-18,MyCar Tyre & Auto ,133,0,1221,Expense,Transport,"Car Insurance, Rego & Maintenance",DR
2022-01-19,Surf Dive 'n Ski ,60,0,1161,Expense,Personal,Clothing & Accessories,DR
2022-01-19,McDonald’s ,47,0,1114,Expense,Leisure & Lifestyle,Takeaway,DR
2022-01-20,The Espy ,78,0,1036,Expense,Leisure & Lifestyle,Pubs & Bars,DR
2022-01-20, EnergyAustralia ,76,0,960,Expense,Household,Utilities,DR
2022-01-21,OfficeMax ,55,0,905,Expense,Personal,Life Admin,DR
2022-01-22,AustralianSuper Pension ,57,0,848,Income,Income,Other Income,DR
2022-01-22,Montessori Schools ,52,0,796,Expense,Personal,Education,DR
2022-01-22,Disney+ ,32,0,764,Expense,Leisure & Lifestyle,"Tv, Music & Streaming",DR
2022-01-22,Child Support Agency Deposit ,23,0,741,Income,Income,Other Income,DR
2022-01-23,Airbnb Host Income ,41,0,700,Income,Income,Other Income,DR
2022-01-23,Medicare Claim ,61,0,639,Expense,Personal,Health & Medical,DR
2022-01-23,Bridgestone Select ,52,0,587,Expense,Transport,"Car Insurance, Rego & Maintenance",DR
2022-01-23,Camp Australia ,8,0,579,Expense,Leisure & Lifestyle,Hobbies,DR
2022-01-24,Kmart ,29,0,550,Expense,Personal,Children & Family,DR
2022-01-24, Jim's Mowing ,28,0,522,Expense,Household,Maintenance & Improvements,DR
2022-01-25,Westpac Dividend Deposit ,9,0,513,Income,Income,Investments,DR
2022-01-25,Westpac Dividend Deposit ,8,0,505,Income,Income,Investments,DR
2022-01-25,Service NSW ,30,0,475,Expense,Transport,"Car Insurance, Rego & Maintenance",DR
2022-01-25,Binge ,18,0,457,Expense,Leisure & Lifestyle,"Tv, Music & Streaming",DR
2022-01-27,VetLove ,20,0,437,Expense,Household,Pets,DR
2022-01-27,Hobart Brewing Company ,42,0,395,Expense,Leisure & Lifestyle,Pubs & Bars,DR
2022-01-27,The Australian ,5,0,390,Expense,Personal,Education,DR
2022-01-28,Surfstitch ,27,0,363,Expense,Personal,Clothing & Accessories,DR
2022-01-28,The Coffee Club ,8,0,355,Expense,Leisure & Lifestyle,Restaurants & Cafes,DR
2022-01-28,Culture Kings ,33,0,322,Expense,Personal,Clothing & Accessories,DR
2022-02-01,Monthly Income,0,6542,6864,Income,Income,Wages,CR
2022-02-04,F45 Training ,26,0,6838,Expense,Personal,Fitness & Wellbeing,DR
2022-02-04,Priceline Pharmacy ,585,0,6253,Expense,Personal,Health & Medical,DR
2022-02-05,Swim Australia ,75,0,6178,Expense,Personal,Fitness & Wellbeing,DR
2022-02-06,Payday Advance ,9,0,6169,Income,Income,Other Income,DR
2022-02-06,Eat Street Northshore ,343,0,5826,Expense,Leisure & Lifestyle,Pubs & Bars,DR
2022-02-07,Massage Therapy Center ,182,0,5644,Expense,Personal,Health & Medical,DR
2022-02-08,Endota Spa ,53,0,5591,Expense,Personal,Fitness & Wellbeing,DR
2022-02-09,F45 Training ,288,0,5303,Expense,Personal,Fitness & Wellbeing,DR
2022-02-09,Karate for Kids ,266,0,5037,Expense,Personal,Fitness & Wellbeing,DR
2022-02-10,Endota Spa ,444,0,4593,Expense,Personal,Fitness & Wellbeing,DR
2022-02-10,South East Water ,35,0,4558,Expense,Household,Utilities,DR
2022-02-11,City Beach ,409,0,4149,Expense,Personal,Clothing & Accessories,DR
2022-02-11,G8 Education ,251,0,3898,Expense,Personal,Children & Family,DR
2022-02-11, Jim's Mowing ,89,0,3809,Expense,Household,Maintenance & Improvements,DR
2022-02-14,PayPal Transfer from Sale ,70,0,3739,Income,Income,Other Income,DR
2022-02-15,Barbeques Galore ,356,0,3383,Expense,Household,"Furniture, Electronics & Homewares",DR
2022-02-16,Disney+ ,226,0,3157,Expense,Leisure & Lifestyle,"Tv, Music & Streaming",DR
2022-02-17, Ray White Real Estate ,32,0,3125,Expense,Personal,Life Admin,DR
2022-02-17,Surf Dive 'n Ski ,304,0,2821,Expense,Personal,Clothing & Accessories,DR
2022-02-18,Origin Energy ,159,0,2662,Expense,Household,Utilities,DR
2022-02-18,KU Children's Services ,41,0,2621,Expense,Personal,Children & Family,DR
2022-02-19,Specsavers ,5,0,2616,Expense,Personal,Health & Medical,DR
2022-02-20,King Swim ,62,0,2554,Expense,Personal,Fitness & Wellbeing,DR
2022-02-20,Witchery ,102,0,2452,Expense,Personal,Clothing & Accessories,DR
2022-02-20,Microsoft 365 ,210,0,2242,Expense,Personal,Education,DR
2022-02-20,The Athlete's Foot ,221,0,2021,Expense,Personal,Clothing & Accessories,DR
2022-02-21,Repco ,42,0,1979,Expense,Transport,"Car Insurance, Rego & Maintenance",DR
2022-02-21,Beachfront Markets ,55,0,1924,Expense,Personal,Clothing & Accessories,DR
2022-02-22,VetLove ,164,0,1760,Expense,Household,Pets,DR
2022-02-22,Greencross Vets ,146,0,1614,Expense,Household,Pets,DR
2022-02-22,Chemist Warehouse ,106,0,1508,Expense,Personal,Health & Medical,DR
2022-02-23,Optus ,93,0,1415,Expense,Personal,Mobile Phone,DR
2022-02-23,City Beach ,131,0,1284,Expense,Personal,Clothing & Accessories,DR
2022-02-24,Endota Spa ,8,0,1276,Expense,Personal,Fitness & Wellbeing,DR
2022-02-25,Microsoft 365 ,75,0,1201,Expense,Personal,Education,DR
2022-02-26,Jetts Fitness ,117,0,1084,Expense,Personal,Fitness & Wellbeing,DR
2022-02-28,Kayo Sports ,52,0,1032,Expense,Leisure & Lifestyle,"Tv, Music & Streaming",DR
2022-02-28,Harris Farm Markets ,16,0,1016,Expense,Household,Groceries,DR
2022-02-28,Disney+ ,86,0,930,Expense,Leisure & Lifestyle,"Tv, Music & Streaming",DR
2022-03-01,Monthly Income,0,6542,7472,Income,Income,Wages,CR
2022-03-03,Quay Restaurant ,545,0,6927,Expense,Leisure & Lifestyle,Pubs & Bars,DR
2022-03-03,Karate for Kids ,44,0,6883,Expense,Personal,Fitness & Wellbeing,DR
2022-03-03,Telstra ,157,0,6726,Expense,Personal,Mobile Phone,DR
2022-03-03,Boost Juice Bars ,171,0,6555,Expense,Leisure & Lifestyle,Takeaway,DR
2022-03-04,Adairs ,622,0,5933,Expense,Household,"Furniture, Electronics & Homewares",DR
2022-03-05,Acupuncture Clinic ,394,0,5539,Expense,Personal,Health & Medical,DR
2022-03-06,Costco ,270,0,5269,Expense,Household,Groceries,DR
2022-03-06,Endota Spa ,129,0,5140,Expense,Personal,Fitness & Wellbeing,DR
2022-03-07,Fernwood Fitness ,471,0,4669,Expense,Personal,Fitness & Wellbeing,DR
2022-03-07,Queensland Urban Utilities ,274,0,4395,Expense,Household,Utilities,DR
2022-03-07,Endota Spa ,383,0,4012,Expense,Personal,Fitness & Wellbeing,DR
2022-03-07,Origin Energy ,133,0,3879,Expense,Household,Utilities,DR
2022-03-07,Ultra Tune ,88,0,3791,Expense,Transport,"Car Insurance, Rego & Maintenance",DR
2022-03-08,Surfstitch ,52,0,3739,Expense,Personal,Clothing & Accessories,DR
2022-03-08,Airbnb Host Income ,13,0,3726,Income,Income,Other Income,DR
2022-03-09,Camp Australia ,333,0,3393,Expense,Leisure & Lifestyle,Hobbies,DR
2022-03-09, Brisbane City Council ,224,0,3169,Expense,Household,Rates & Insurance,DR
2022-03-09,Timezone ,162,0,3007,Expense,Leisure & Lifestyle,Entertainment,DR
2022-03-10,Café Nero ,99,0,2908,Expense,Leisure & Lifestyle,Restaurants & Cafes,DR
2022-03-12,Cookie ,155,0,2753,Expense,Leisure & Lifestyle,Pubs & Bars,DR
2022-03-12,Centrelink JobSeeker Payment ,26,0,2727,Income,Income,Other Income,DR
2022-03-13,Beachside Yoga Classes ,209,0,2518,Expense,Personal,Fitness & Wellbeing,DR
2022-03-14,Target ,194,0,2324,Expense,Personal,Clothing & Accessories,DR
2022-03-16,Muffin Break ,116,0,2208,Expense,Leisure & Lifestyle,Restaurants & Cafes,DR
2022-03-16,Acupuncture Clinic ,187,0,2021,Expense,Personal,Health & Medical,DR
2022-03-17,QBE Insurance Claim Payout ,202,0,1819,Income,Income,Other Income,DR
2022-03-17,Stand Up Paddleboard Rental ,22,0,1797,Expense,Personal,Fitness & Wellbeing,DR
2022-03-17,Eat Street Northshore ,166,0,1631,Expense,Leisure & Lifestyle,Pubs & Bars,DR
2022-03-17,Who Gives A Crap ,131,0,1500,Expense,Household,Groceries,DR
2022-03-17,Cookie ,87,0,1413,Expense,Leisure & Lifestyle,Pubs & Bars,DR
2022-03-17,Physiotherapy Clinic ,19,0,1394,Expense,Personal,Health & Medical,DR
2022-03-18,The Australian ,40,0,1354,Expense,Personal,Education,DR
2022-03-18,Le Creuset ,5,0,1349,Expense,Household,"Furniture, Electronics & Homewares",DR
2022-03-18,Airbnb Host Income ,85,0,1264,Income,Income,Other Income,DR
2022-03-18,Pathology Lab ,25,0,1239,Expense,Personal,Health & Medical,DR
2022-03-18,G8 Education ,84,0,1155,Expense,Personal,Children & Family,DR
2022-03-19,EnergyAustralia ,67,0,1088,Expense,Household,Utilities,DR
2022-03-19,Menulog ,93,0,995,Expense,Leisure & Lifestyle,Takeaway,DR
2022-03-19,BWS ,9,0,986,Expense,Leisure & Lifestyle,Alcohol,DR
2022-03-19,Acupuncture Clinic ,13,0,973,Expense,Personal,Health & Medical,DR
2022-03-19,Muffin Break ,52,0,921,Expense,Leisure & Lifestyle,Restaurants & Cafes,DR
2022-03-20,Origin Energy ,65,0,856,Expense,Household,Utilities,DR
2022-03-21,Foxtel ,51,0,805,Expense,Leisure & Lifestyle,"Tv, Music & Streaming",DR
2022-03-21,Ice Cream Parlour ,54,0,751,Expense,Leisure & Lifestyle,Takeaway,DR
2022-03-21,Domino’s Pizza ,52,0,699,Expense,Leisure & Lifestyle,Takeaway,DR
2022-03-22,Eau De Vie ,61,0,638,Expense,Leisure & Lifestyle,Pubs & Bars,DR
2022-03-24,Domino’s Pizza ,50,0,588,Expense,Leisure & Lifestyle,Takeaway,DR
2022-03-25,Apple Music ,38,0,550,Expense,Leisure & Lifestyle,"Tv, Music & Streaming",DR
2022-03-26,F45 Training ,25,0,525,Expense,Personal,Fitness & Wellbeing,DR
2022-03-27,Billabong ,42,0,483,Expense,Personal,Clothing & Accessories,DR
2022-03-28,Mathnasium ,9,0,474,Expense,Personal,Education,DR
2022-04-01,Monthly Income,0,6542,7016,Income,Income,Wages,CR
2022-04-02,Repco ,296,0,6720,Expense,Transport,"Car Insurance, Rego & Maintenance",DR
2022-04-02,Microsoft 365 ,68,0,6652,Expense,Personal,Education,DR
2022-04-03,VetLove ,397,0,6255,Expense,Household,Pets,DR
2022-04-04,Woolworths ,552,0,5703,Expense,Household,Groceries,DR
2022-04-04,The Iconic ,125,0,5578,Expense,Personal,Clothing & Accessories,DR
2022-04-06,Service NSW ,273,0,5305,Expense,Transport,"Car Insurance, Rego & Maintenance",DR
2022-04-07, NSW Land Registry Services ,188,0,5117,Expense,Personal,Life Admin,DR
2022-04-07,Interest Payment from Commonwealth Bank ,407,0,4710,Income,Income,Investments,DR
2022-04-07,Sunnybank Hotel ,455,0,4255,Expense,Leisure & Lifestyle,Pubs & Bars,DR
2022-04-08,Airbnb Host Income ,314,0,3941,Income,Income,Other Income,DR
2022-04-09,PayPal Transfer from Sale ,232,0,3709,Income,Income,Other Income,DR
2022-04-10,AGL Energy ,232,0,3477,Expense,Household,Utilities,DR
2022-04-11,Optus ,121,0,3356,Expense,Personal,Mobile Phone,DR
2022-04-11,Booktopia ,42,0,3314,Expense,Leisure & Lifestyle,Hobbies,DR
2022-04-12,Local Hospital ,180,0,3134,Expense,Personal,Health & Medical,DR
2022-04-12,Stan ,201,0,2933,Expense,Leisure & Lifestyle,"Tv, Music & Streaming",DR
2022-04-13,Optometrist ,166,0,2767,Expense,Personal,Health & Medical,DR
2022-04-13,VetLove ,187,0,2580,Expense,Household,Pets,DR
2022-04-14,David Jones ,210,0,2370,Expense,Personal,Clothing & Accessories,DR
2022-04-14, The Good Guys ,70,0,2300,Expense,Household,"Furniture, Electronics & Homewares",DR
2022-04-14,Domino’s Pizza ,29,0,2271,Expense,Leisure & Lifestyle,Takeaway,DR
2022-04-15,Green Slip Insurance ,126,0,2145,Expense,Transport,"Car Insurance, Rego & Maintenance",DR
2022-04-15,Centrelink JobSeeker Payment ,14,0,2131,Income,Income,Other Income,DR
2022-04-15,The Body Shop ,10,0,2121,Expense,Personal,Hair & Beauty,DR
2022-04-16,AustralianSuper Pension ,98,0,2023,Income,Income,Other Income,DR
2022-04-16,F45 Training ,136,0,1887,Expense,Personal,Fitness & Wellbeing,DR
2022-04-16,Medicare Claim ,179,0,1708,Expense,Personal,Health & Medical,DR
2022-04-16,Soccer Clubs ,106,0,1602,Expense,Personal,Fitness & Wellbeing,DR
2022-04-17,The Espy ,128,0,1474,Expense,Leisure & Lifestyle,Pubs & Bars,DR
2022-04-19, Meriton Apartments ,33,0,1441,Expense,Household,Rates & Insurance,DR
2022-04-21,Specsavers ,130,0,1311,Expense,Personal,Health & Medical,DR
2022-04-22,Audible ,66,0,1245,Expense,Leisure & Lifestyle,"Tv, Music & Streaming",DR
2022-04-23,Hungry Jack’s ,23,0,1222,Expense,Leisure & Lifestyle,Takeaway,DR
2022-04-23,Jetts Fitness ,18,0,1204,Expense,Personal,Fitness & Wellbeing,DR
2022-04-23,Kayo Sports ,15,0,1189,Expense,Leisure & Lifestyle,"Tv, Music & Streaming",DR
2022-04-24,The Iconic ,71,0,1118,Expense,Personal,Clothing & Accessories,DR
2022-04-24,Surf Dive 'n Ski ,9,0,1109,Expense,Personal,Clothing & Accessories,DR
2022-04-25,Billabong ,7,0,1102,Expense,Personal,Clothing & Accessories,DR
2022-04-25,Lorna Jane ,32,0,1070,Expense,Personal,Clothing & Accessories,DR
2022-04-26,Repco ,83,0,987,Expense,Transport,"Car Insurance, Rego & Maintenance",DR
2022-04-26,Greencross Vets ,47,0,940,Expense,Household,Pets,DR
2022-04-27,The Ivy ,73,0,867,Expense,Leisure & Lifestyle,Pubs & Bars,DR
2022-04-27,Sunburn Swimwear ,66,0,801,Expense,Personal,Clothing & Accessories,DR
2022-04-28,Autobarn ,35,0,766,Expense,Transport,"Car Insurance, Rego & Maintenance",DR
2022-05-01,Monthly Income,0,6542,7308,Income,Income,Wages,CR
2022-05-02,McDonald’s ,251,0,7057,Expense,Leisure & Lifestyle,Takeaway,DR
2022-05-02,eBay Sales Proceeds ,700,0,6357,Income,Income,Other Income,DR
2022-05-02,Grill’d ,33,0,6324,Expense,Leisure & Lifestyle,Takeaway,DR
2022-05-02,Harvey Norman ,441,0,5883,Expense,Household,"Furniture, Electronics & Homewares",DR
2022-05-02,Westpac Dividend Deposit ,58,0,5825,Income,Income,Investments,DR
2022-05-03,The Espy ,208,0,5617,Expense,Leisure & Lifestyle,Pubs & Bars,DR
2022-05-03,Netflix ,445,0,5172,Expense,Leisure & Lifestyle,"Tv, Music & Streaming",DR
2022-05-04,EnergyAustralia ,385,0,4787,Expense,Household,Utilities,DR
2022-05-04,ABC Reading Eggs ,111,0,4676,Expense,Personal,Education,DR
2022-05-05,Kumon ,412,0,4264,Expense,Personal,Education,DR
2022-05-05,Ice Cream Parlour ,228,0,4036,Expense,Leisure & Lifestyle,Takeaway,DR
2022-05-06,Guzman y Gomez ,391,0,3645,Expense,Leisure & Lifestyle,Takeaway,DR
2022-05-06,Harvey Norman ,305,0,3340,Expense,Household,"Furniture, Electronics & Homewares",DR
2022-05-06,Guardian Childcare & Education ,277,0,3063,Expense,Personal,Children & Family,DR
2022-05-07,David Jones ,42,0,3021,Expense,Personal,Clothing & Accessories,DR
2022-05-08,Caltex ,215,0,2806,Expense,Transport,Fuel,DR
2022-05-09,The Good Guys ,147,0,2659,Expense,Household,"Furniture, Electronics & Homewares",DR
2022-05-09,Zarraffa's Coffee ,238,0,2421,Expense,Leisure & Lifestyle,Restaurants & Cafes,DR
2022-05-09,Little Athletics ,14,0,2407,Expense,Personal,Fitness & Wellbeing,DR
2022-05-09,Pizza Hut ,23,0,2384,Expense,Leisure & Lifestyle,Takeaway,DR
2022-05-10,Health Food Store ,228,0,2156,Expense,Personal,Fitness & Wellbeing,DR
2022-05-10,Repco ,22,0,2134,Expense,Transport,"Car Insurance, Rego & Maintenance",DR
2022-05-10,Ballet Schools ,175,0,1959,Expense,Personal,Fitness & Wellbeing,DR
2022-05-10, Meriton Apartments ,15,0,1944,Expense,Household,Rates & Insurance,DR
2022-05-10,Mathnasium ,170,0,1774,Expense,Personal,Education,DR
2022-05-11,Tennis Australia ,125,0,1649,Expense,Personal,Fitness & Wellbeing,DR
2022-05-11,Fernwood Fitness ,64,0,1585,Expense,Personal,Fitness & Wellbeing,DR
2022-05-11,Disney+ ,75,0,1510,Expense,Leisure & Lifestyle,"Tv, Music & Streaming",DR
2022-05-12,Dymocks ,30,0,1480,Expense,Leisure & Lifestyle,Hobbies,DR
2022-05-12,Sydney Water ,93,0,1387,Expense,Household,Utilities,DR
2022-05-13,VetLove ,37,0,1350,Expense,Household,Pets,DR
2022-05-14, Brisbane City Council ,14,0,1336,Expense,Household,Rates & Insurance,DR
2022-05-15,Chinatown Night Market ,11,0,1325,Expense,Leisure & Lifestyle,Pubs & Bars,DR
2022-05-15,Witchery ,132,0,1193,Expense,Personal,Clothing & Accessories,DR
2022-05-15,Beachside Yoga Classes ,26,0,1167,Expense,Personal,Fitness & Wellbeing,DR
2022-05-16,Microsoft 365 ,18,0,1149,Expense,Personal,Education,DR
2022-05-16,BWS ,88,0,1061,Expense,Leisure & Lifestyle,Alcohol,DR
2022-05-17,EB Games ,60,0,1001,Expense,Leisure & Lifestyle,"Apps, Games & Software",DR
2022-05-19,National Hearing Care ,16,0,985,Expense,Personal,Health & Medical,DR
2022-05-19,Costco ,12,0,973,Expense,Household,Groceries,DR
2022-05-19,Physiotherapy Clinic ,68,0,905,Expense,Personal,Health & Medical,DR
2022-05-19,Apple Music ,79,0,826,Expense,Leisure & Lifestyle,"Tv, Music & Streaming",DR
2022-05-21, Brisbane City Council ,44,0,782,Expense,Household,Rates & Insurance,DR
2022-05-21,Catholic Education Office ,27,0,755,Expense,Personal,Education,DR
2022-05-22,Liquorland ,12,0,743,Expense,Leisure & Lifestyle,Alcohol,DR
2022-05-22,Beachside Yoga Classes ,38,0,705,Expense,Personal,Fitness & Wellbeing,DR
2022-05-22,TerryWhite Chemmart ,19,0,686,Expense,Personal,Health & Medical,DR
2022-05-24,Muffin Break ,10,0,676,Expense,Leisure & Lifestyle,Restaurants & Cafes,DR
2022-05-24,Adobe Creative Cloud ,11,0,665,Expense,Leisure & Lifestyle,Hobbies,DR
2022-05-24,Priceline Pharmacy ,62,0,603,Expense,Personal,Health & Medical,DR
2022-05-26,Sydney Water ,44,0,559,Expense,Household,Utilities,DR
2022-05-26,Caltex ,44,0,515,Expense,Transport,Fuel,DR
2022-05-26,Kmart ,26,0,489,Expense,Personal,Children & Family,DR
2022-05-27,Guzman y Gomez ,22,0,467,Expense,Leisure & Lifestyle,Takeaway,DR
2022-05-27,Melbourne Central Lion Hotel ,28,0,439,Expense,Leisure & Lifestyle,Pubs & Bars,DR
2022-05-27,Officeworks ,32,0,407,Expense,Personal,Life Admin,DR
2022-05-28,Australian Veterinary Association ,39,0,368,Expense,Household,Pets,DR
2022-05-28,Petbarn ,29,0,339,Expense,Household,Pets,DR
2022-06-01,Monthly Income,0,6542,6881,Income,Income,Wages,CR
2022-06-02,Caltex Woolworths ,206,0,6675,Expense,Transport,Fuel,DR
2022-06-02,Zarraffa's Coffee ,290,0,6385,Expense,Leisure & Lifestyle,Restaurants & Cafes,DR
2022-06-02,Beachside Yoga Classes ,62,0,6323,Expense,Personal,Fitness & Wellbeing,DR
2022-06-02,Soccer Clubs ,238,0,6085,Expense,Personal,Fitness & Wellbeing,DR
2022-06-03,Dan Murphy’s ,268,0,5817,Expense,Leisure & Lifestyle,Alcohol,DR
2022-06-03,Surfstitch ,36,0,5781,Expense,Personal,Clothing & Accessories,DR
2022-06-03,Netflix ,323,0,5458,Expense,Leisure & Lifestyle,"Tv, Music & Streaming",DR
2022-06-06,Zarraffa's Coffee ,368,0,5090,Expense,Leisure & Lifestyle,Restaurants & Cafes,DR
2022-06-06,Crown Perth ,250,0,4840,Expense,Leisure & Lifestyle,Pubs & Bars,DR
2022-06-07,KU Children's Services ,48,0,4792,Expense,Personal,Children & Family,DR
2022-06-07,Upwork Freelancer Payment ,329,0,4463,Income,Income,Other Income,DR
2022-06-09,Shell V Power,361,0,4102,Expense,Transport,Fuel,DR
2022-06-09,Montessori Schools ,183,0,3919,Expense,Personal,Education,DR
2022-06-10,Kayo Sports ,221,0,3698,Expense,Leisure & Lifestyle,"Tv, Music & Streaming",DR
2022-06-10, EnergyAustralia ,69,0,3629,Expense,Household,Utilities,DR
2022-06-10,Snap Fitness ,92,0,3537,Expense,Personal,Fitness & Wellbeing,DR
2022-06-11,Witchery ,162,0,3375,Expense,Personal,Clothing & Accessories,DR
2022-06-12,Hungry Jack’s ,228,0,3147,Expense,Leisure & Lifestyle,Takeaway,DR
2022-06-12,Childcare Payments ,262,0,2885,Expense,Personal,Children & Family,DR
2022-06-12,Australian Veterinary Association ,226,0,2659,Expense,Household,Pets,DR
2022-06-13,The Ivy ,231,0,2428,Expense,Leisure & Lifestyle,Pubs & Bars,DR
2022-06-13,Service NSW ,114,0,2314,Expense,Transport,"Car Insurance, Rego & Maintenance",DR
2022-06-14, National Bank ,209,0,2105,Expense,Personal,Fees & Charges,DR
2022-06-15,NRMA Roadside Assistance ,31,0,2074,Expense,Transport,"Car Insurance, Rego & Maintenance",DR
2022-06-16,Little Athletics ,180,0,1894,Expense,Personal,Fitness & Wellbeing,DR
2022-06-18,Zone Bowling ,152,0,1742,Expense,Leisure & Lifestyle,Entertainment,DR
2022-06-18,BrewDog ,158,0,1584,Expense,Leisure & Lifestyle,Alcohol,DR
2022-06-19,Rooftop Bar ,144,0,1440,Expense,Leisure & Lifestyle,Pubs & Bars,DR
2022-06-20,Kmart ,13,0,1427,Expense,Personal,Children & Family,DR
2022-06-21,Goodstart Early Learning ,88,0,1339,Expense,Personal,Children & Family,DR
2022-06-22,BP ,93,0,1246,Expense,Transport,Fuel,DR
2022-06-22,Bridgestone Select ,30,0,1216,Expense,Transport,"Car Insurance, Rego & Maintenance",DR
2022-06-23, Meriton Apartments ,31,0,1185,Expense,Household,Rates & Insurance,DR
2022-06-24, Jim’s Building Inspections ,16,0,1169,Expense,Household,Maintenance & Improvements,DR
2022-06-24,Spotify ,40,0,1129,Expense,Leisure & Lifestyle,"Tv, Music & Streaming",DR
2022-06-24, Slater and Gordon Lawyers ,62,0,1067,Expense,Personal,Life Admin,DR
2022-06-25,Booktopia ,79,0,988,Expense,Leisure & Lifestyle,Hobbies,DR
2022-06-25,Guzman y Gomez ,75,0,913,Expense,Leisure & Lifestyle,Takeaway,DR
2022-06-25,Hobart Brewing Company ,81,0,832,Expense,Leisure & Lifestyle,Pubs & Bars,DR
2022-06-25,Fitness First ,15,0,817,Expense,Personal,Fitness & Wellbeing,DR
2022-06-25,Beacon Lighting ,75,0,742,Expense,Household,Maintenance & Improvements,DR
2022-06-26,Anytime Fitness ,41,0,701,Expense,Personal,Fitness & Wellbeing,DR
2022-06-26,School Locker ,43,0,658,Expense,Personal,Children & Family,DR
2022-06-26,Westpac Dividend Deposit ,60,0,598,Income,Income,Investments,DR
2022-07-01,Monthly Income,0,6542,7140,Income,Income,Wages,CR
2022-07-02,Queensland Urban Utilities ,485,0,6655,Expense,Household,Utilities,DR
2022-07-02,City Beach ,116,0,6539,Expense,Personal,Clothing & Accessories,DR
2022-07-02,Childcare Payments ,397,0,6142,Expense,Personal,Children & Family,DR
2022-07-02,Dan Murphy’s ,419,0,5723,Expense,Leisure & Lifestyle,Alcohol,DR
2022-07-02,The Body Shop ,535,0,5188,Expense,Personal,Hair & Beauty,DR
2022-07-03,Myer ,38,0,5150,Expense,Personal,Clothing & Accessories,DR
2022-07-04,Palace Cinemas ,397,0,4753,Expense,Leisure & Lifestyle,Entertainment,DR
2022-07-05,Optometrist ,375,0,4378,Expense,Personal,Health & Medical,DR
2022-07-05,Sea Kayak Tours ,197,0,4181,Expense,Leisure & Lifestyle,Holidays & Travel,DR
2022-07-06,Ice Cream Parlour ,260,0,3921,Expense,Leisure & Lifestyle,Takeaway,DR
2022-07-06,Liquorland ,89,0,3832,Expense,Leisure & Lifestyle,Alcohol,DR
2022-07-07,Guardian Childcare & Education ,380,0,3452,Expense,Personal,Children & Family,DR
2022-07-07,Medicare Claim ,46,0,3406,Expense,Personal,Health & Medical,DR
2022-07-08,Beachside Caravan Park ,25,0,3381,Expense,Leisure & Lifestyle,Holidays & Travel,DR
2022-07-08, NRMA Insurance ,247,0,3134,Expense,Household,Rates & Insurance,DR
2022-07-09,Mathnasium ,57,0,3077,Expense,Personal,Education,DR
2022-07-10,Swim Australia ,110,0,2967,Expense,Personal,Fitness & Wellbeing,DR
2022-07-10,AGL Energy ,274,0,2693,Expense,Household,Utilities,DR
2022-07-11,National Hearing Care ,166,0,2527,Expense,Personal,Health & Medical,DR
2022-07-12,G8 Education ,29,0,2498,Expense,Personal,Children & Family,DR
2022-07-12,Salary Deposit from Woolworths Group ,229,0,2269,Income,Income,Wages,DR
2022-07-13,Grill'd ,211,0,2058,Expense,Leisure & Lifestyle,Takeaway,DR
2022-07-13, Jim’s Building Inspections ,139,0,1919,Expense,Household,Maintenance & Improvements,DR
2022-07-13,Rip Curl ,22,0,1897,Expense,Personal,Clothing & Accessories,DR
2022-07-13,Green Slip Insurance ,179,0,1718,Expense,Transport,"Car Insurance, Rego & Maintenance",DR
2022-07-14,Cookie ,19,0,1699,Expense,Leisure & Lifestyle,Pubs & Bars,DR
2022-07-17,Service NSW ,97,0,1602,Expense,Transport,"Car Insurance, Rego & Maintenance",DR
2022-07-17,Guardian Childcare & Education ,82,0,1520,Expense,Personal,Children & Family,DR
2022-07-18,Amazon Prime ,136,0,1384,Expense,Leisure & Lifestyle,"Tv, Music & Streaming",DR
2022-07-18,Liquorland ,68,0,1316,Expense,Leisure & Lifestyle,Alcohol,DR
2022-07-18,VetLove ,125,0,1191,Expense,Household,Pets,DR
2022-07-19,The Baxter Inn ,68,0,1123,Expense,Leisure & Lifestyle,Pubs & Bars,DR
2022-07-20,Physiotherapy Clinic ,33,0,1090,Expense,Personal,Health & Medical,DR
2022-07-20,Surf Dive 'n Ski ,92,0,998,Expense,Personal,Clothing & Accessories,DR
2022-07-20,Fitness First ,16,0,982,Expense,Personal,Fitness & Wellbeing,DR
2022-07-21, Brisbane City Council ,7,0,975,Expense,Household,Rates & Insurance,DR
2022-07-22,Microsoft 365 ,96,0,879,Expense,Personal,Education,DR
2022-07-24,Local Hospital ,70,0,809,Expense,Personal,Health & Medical,DR
2022-07-24, Slater and Gordon Lawyers ,15,0,794,Expense,Personal,Life Admin,DR
2022-07-25, NSW Land Registry Services ,35,0,759,Expense,Personal,Life Admin,DR
2022-07-27,VicRoads ,46,0,713,Expense,Transport,"Car Insurance, Rego & Maintenance",DR
2022-07-27,Beachfront Markets ,19,0,694,Expense,Personal,Clothing & Accessories,DR
2022-07-28,Karate for Kids ,26,0,668,Expense,Personal,Fitness & Wellbeing,DR
2022-08-01,Monthly Income,0,6542,7210,Income,Income,Wages,CR
2022-08-02,Ultra Tune ,465,0,6745,Expense,Transport,"Car Insurance, Rego & Maintenance",DR
2022-08-02,Stand Up Paddleboard Rental ,301,0,6444,Expense,Personal,Fitness & Wellbeing,DR
2022-08-02, Rentokil ,99,0,6345,Expense,Household,Maintenance & Improvements,DR
2022-08-02,Pathology Lab ,101,0,6244,Expense,Personal,Health & Medical,DR
2022-08-04,Pathology Lab ,377,0,5867,Expense,Personal,Health & Medical,DR
2022-08-04,Grill'd ,406,0,5461,Expense,Leisure & Lifestyle,Takeaway,DR
2022-08-04,Boost Juice Bars ,378,0,5083,Expense,Leisure & Lifestyle,Takeaway,DR
2022-08-05,Caltex ,276,0,4807,Expense,Transport,Fuel,DR
2022-08-07,Shell V Power,9,0,4798,Expense,Transport,Fuel,DR
2022-08-08,Kayo Sports ,22,0,4776,Expense,Leisure & Lifestyle,"Tv, Music & Streaming",DR
2022-08-08,Coles Express ,38,0,4738,Expense,Transport,Fuel,DR
2022-08-08,The Victory Hotel ,143,0,4595,Expense,Leisure & Lifestyle,Pubs & Bars,DR
2022-08-08, Jim's Mowing ,30,0,4565,Expense,Household,Maintenance & Improvements,DR
2022-08-10,The Rocks Bar and Pub ,211,0,4354,Expense,Leisure & Lifestyle,Pubs & Bars,DR
2022-08-10,Eat Street Northshore ,43,0,4311,Expense,Leisure & Lifestyle,Pubs & Bars,DR
2022-08-11,The Victory Hotel ,53,0,4258,Expense,Leisure & Lifestyle,Pubs & Bars,DR
2022-08-11,Beachside Yoga Classes ,221,0,4037,Expense,Personal,Fitness & Wellbeing,DR
2022-08-12,The Athlete's Foot ,194,0,3843,Expense,Personal,Clothing & Accessories,DR
2022-08-12,Vodafone Prepaid ,311,0,3532,Expense,Personal,Mobile Phone,DR
2022-08-12,Zarraffa's Coffee ,70,0,3462,Expense,Leisure & Lifestyle,Restaurants & Cafes,DR
2022-08-13,The Rocks Bar and Pub ,204,0,3258,Expense,Leisure & Lifestyle,Pubs & Bars,DR
2022-08-13,Woolworths ,75,0,3183,Expense,Household,Groceries,DR
2022-08-14,Sunnybank Hotel ,213,0,2970,Expense,Leisure & Lifestyle,Pubs & Bars,DR
2022-08-14,Guardian Childcare & Education ,130,0,2840,Expense,Personal,Children & Family,DR
2022-08-15,Sea Life Aquarium ,140,0,2700,Expense,Leisure & Lifestyle,Entertainment,DR
2022-08-15,David Jones ,136,0,2564,Expense,Personal,Clothing & Accessories,DR
2022-08-15,Apple Store ,41,0,2523,Expense,Leisure & Lifestyle,Electronics,DR
2022-08-15,Guzman y Gomez ,200,0,2323,Expense,Leisure & Lifestyle,Takeaway,DR
2022-08-15,BP ,111,0,2212,Expense,Transport,Fuel,DR
2022-08-15, BSA Ltd ,167,0,2045,Expense,Household,Maintenance & Improvements,DR
2022-08-18,Jetts Fitness ,15,0,2030,Expense,Personal,Fitness & Wellbeing,DR
2022-08-19,BP ,87,0,1943,Expense,Transport,Fuel,DR
2022-08-22,King Swim ,176,0,1767,Expense,Personal,Fitness & Wellbeing,DR
2022-08-22,Toys 'R' Us ,82,0,1685,Expense,Personal,CHildren & Family,DR
2022-08-22, National Bank ,54,0,1631,Expense,Personal,Fees & Charges,DR
2022-08-22, BSA Ltd ,161,0,1470,Expense,Household,Maintenance & Improvements,DR
2022-08-23,Little Athletics ,111,0,1359,Expense,Personal,Fitness & Wellbeing,DR
2022-08-23,Scouts Australia ,47,0,1312,Expense,Leisure & Lifestyle,Hobbies,DR
2022-08-24,Rooftop Bar ,98,0,1214,Expense,Leisure & Lifestyle,Pubs & Bars,DR
2022-08-24,Palace Cinemas ,99,0,1115,Expense,Leisure & Lifestyle,Entertainment,DR
2022-08-25,Guzman y Gomez ,26,0,1089,Expense,Leisure & Lifestyle,Takeaway,DR
2022-08-26,Menulog ,74,0,1015,Expense,Leisure & Lifestyle,Takeaway,DR
2022-08-27, Slater and Gordon Lawyers ,88,0,927,Expense,Personal,Life Admin,DR
2022-08-28,Sydney Water ,14,0,913,Expense,Household,Utilities,DR
2022-08-28,Green Slip Insurance ,40,0,873,Expense,Transport,"Car Insurance, Rego & Maintenance",DR
2022-08-28,BrewDog ,5,0,868,Expense,Leisure & Lifestyle,Alcohol,DR
2022-09-01,Monthly Income,0,6542,7410,Income,Income,Wages,CR
2022-09-02,Medicare Claim ,704,0,6706,Expense,Personal,Health & Medical,DR
2022-09-02,Local Hospital ,528,0,6178,Expense,Personal,Health & Medical,DR
2022-09-03,Dan Murphy’s ,218,0,5960,Expense,Leisure & Lifestyle,Alcohol,DR
2022-09-03,South East Water ,418,0,5542,Expense,Household,Utilities,DR
2022-09-04,Rip Curl ,43,0,5499,Expense,Personal,Clothing & Accessories,DR
2022-09-05,PayPal Transfer from Sale ,223,0,5276,Income,Income,Other Income,DR
2022-09-09,Pizza Hut ,168,0,5108,Expense,Leisure & Lifestyle,Takeaway,DR
2022-09-10,Menulog ,376,0,4732,Expense,Leisure & Lifestyle,Takeaway,DR
2022-09-11,Ladbrokes ,64,0,4668,Expense,Leisure & Lifestyle,Lottery & Gambling,DR
2022-09-13,VicRoads ,218,0,4450,Expense,Transport,"Car Insurance, Rego & Maintenance",DR
2022-09-14,Telstra ,182,0,4268,Expense,Personal,Mobile Phone,DR
2022-09-15,CommSec Share Trading Gains ,122,0,4146,Income,Income,Investments,DR
2022-09-16, EnergyAustralia ,390,0,3756,Expense,Household,Utilities,DR
2022-09-16,EnergyAustralia ,13,0,3743,Expense,Household,Utilities,DR
2022-09-18,EnergyAustralia ,274,0,3469,Expense,Household,Utilities,DR
2022-09-20,Binge ,342,0,3127,Expense,Leisure & Lifestyle,"Tv, Music & Streaming",DR
2022-09-20,David Jones ,304,0,2823,Expense,Personal,Clothing & Accessories,DR
2022-09-22,Chinatown Night Market ,7,0,2816,Expense,Leisure & Lifestyle,Pubs & Bars,DR
2022-09-23,Autobarn ,185,0,2631,Expense,Transport,"Car Insurance, Rego & Maintenance",DR
2022-09-23,Event Cinemas ,125,0,2506,Expense,Leisure & Lifestyle,Entertainment,DR
2022-09-24,AMF Bowling ,225,0,2281,Expense,Leisure & Lifestyle,Entertainment,DR
2022-09-24,YMCA ,161,0,2120,Expense,Personal,Fitness & Wellbeing,DR
2022-09-24,The Good Guys ,202,0,1918,Expense,Household,"Furniture, Electronics & Homewares",DR
2022-09-24,Hungry Jack’s ,78,0,1840,Expense,Leisure & Lifestyle,Takeaway,DR
2022-09-24,BP ,177,0,1663,Expense,Transport,Fuel,DR
2022-09-25,Beachfront Markets ,38,0,1625,Expense,Personal,Clothing & Accessories,DR
2022-09-26,Local Fish and Chips ,100,0,1525,Expense,Leisure & Lifestyle,Takeaway,DR
2022-09-27, National Bank ,76,0,1449,Expense,Personal,Fees & Charges,DR
2022-09-28,The Sydney Morning Herald ,49,0,1400,Expense,Personal,Education,DR
2022-10-01,Monthly Income,0,6542,7942,Income,Income,Wages,CR
2022-10-02,Decathlon ,159,0,7783,Expense,Personal,Fitness & Wellbeing,DR
2022-10-02,City Beach ,42,0,7741,Expense,Personal,Clothing & Accessories,DR
2022-10-03,BP ,26,0,7715,Expense,Transport,Fuel,DR
2022-10-03,Stand Up Paddleboard Rental ,757,0,6958,Expense,Personal,Fitness & Wellbeing,DR
2022-10-05, Fantastic Furniture ,129,0,6829,Expense,Household,"Furniture, Electronics & Homewares",DR
2022-10-05,Spotlight ,68,0,6761,Expense,Leisure & Lifestyle,Hobbies,DR
2022-10-06,Surf Dive 'n Ski ,319,0,6442,Expense,Personal,Clothing & Accessories,DR
2022-10-06,Beachside Caravan Park ,623,0,5819,Expense,Leisure & Lifestyle,Holidays & Travel,DR
2022-10-07,Chiropractor ,541,0,5278,Expense,Personal,Health & Medical,DR
2022-10-08,F45 Training ,505,0,4773,Expense,Personal,Fitness & Wellbeing,DR
2022-10-09,The Good Guys ,215,0,4558,Expense,Household,"Furniture, Electronics & Homewares",DR
2022-10-10,Vodafone Prepaid ,216,0,4342,Expense,Personal,Mobile Phone,DR
2022-10-11,VetLove ,268,0,4074,Expense,Household,Pets,DR
2022-10-12,Physiotherapy Clinic ,250,0,3824,Expense,Personal,Health & Medical,DR
2022-10-12,VetLove ,67,0,3757,Expense,Household,Pets,DR
2022-10-13,AGL Energy ,364,0,3393,Expense,Household,Utilities,DR
2022-10-13,Rip Curl ,146,0,3247,Expense,Personal,Clothing & Accessories,DR
2022-10-15,Kayo Sports ,208,0,3039,Expense,Leisure & Lifestyle,"Tv, Music & Streaming",DR
2022-10-15,Guardian Childcare & Education ,98,0,2941,Expense,Personal,Children & Family,DR
2022-10-15,SEQTA ,28,0,2913,Expense,Personal,Education,DR
2022-10-16,Mathnasium ,50,0,2863,Expense,Personal,Education,DR
2022-10-20,Stand Up Paddleboard Rental ,124,0,2739,Expense,Personal,Fitness & Wellbeing,DR
2022-10-20,F45 Training ,258,0,2481,Expense,Personal,Fitness & Wellbeing,DR
2022-10-20,Rip Curl ,231,0,2250,Expense,Personal,Clothing & Accessories,DR
2022-10-21,Grill'd ,73,0,2177,Expense,Leisure & Lifestyle,Takeaway,DR
2022-10-21,BrewDog ,150,0,2027,Expense,Leisure & Lifestyle,Alcohol,DR
2022-10-22,Palace Cinemas ,78,0,1949,Expense,Leisure & Lifestyle,Entertainment,DR
2022-10-23,The Brisbane Hotel ,188,0,1761,Expense,Leisure & Lifestyle,Pubs & Bars,DR
2022-10-23,The Baxter Inn ,171,0,1590,Expense,Leisure & Lifestyle,Pubs & Bars,DR
2022-10-24,Café Nero ,34,0,1556,Expense,Leisure & Lifestyle,Restaurants & Cafes,DR
2022-10-24,Stan ,85,0,1471,Expense,Leisure & Lifestyle,"Tv, Music & Streaming",DR
2022-10-24,Snap Fitness ,6,0,1465,Expense,Personal,Fitness & Wellbeing,DR
2022-10-26,Guardian Childcare & Education ,109,0,1356,Expense,Personal,Children & Family,DR
2022-10-27,Ice Cream Parlour ,21,0,1335,Expense,Leisure & Lifestyle,Takeaway,DR
2022-10-27,BP ,68,0,1267,Expense,Transport,Fuel,DR
2022-11-01,Monthly Income,0,6542,7809,Income,Income,Wages,CR
2022-11-02,Priceline Pharmacy ,295,0,7514,Expense,Personal,Health & Medical,DR
2022-11-02,Local Fish and Chips ,150,0,7364,Expense,Leisure & Lifestyle,Takeaway,DR
2022-11-04,Airbnb Host Income ,606,0,6758,Income,Income,Other Income,DR
2022-11-04,Chemist Warehouse ,313,0,6445,Expense,Personal,Health & Medical,DR
2022-11-04,Platypus Shoes ,235,0,6210,Expense,Personal,Clothing & Accessories,DR
2022-11-05,Grill'd ,287,0,5923,Expense,Leisure & Lifestyle,Takeaway,DR
2022-11-05,Beacon Lighting ,76,0,5847,Expense,Household,Maintenance & Improvements,DR
2022-11-05, EnergyAustralia ,330,0,5517,Expense,Household,Utilities,DR
2022-11-06,NRMA Roadside Assistance ,146,0,5371,Expense,Transport,"Car Insurance, Rego & Maintenance",DR
2022-11-06,The Brisbane Hotel ,312,0,5059,Expense,Leisure & Lifestyle,Pubs & Bars,DR
2022-11-07,Woolworths ,432,0,4627,Expense,Household,Groceries,DR
2022-11-07,Toys 'R' Us ,303,0,4324,Expense,Personal,CHildren & Family,DR
2022-11-07,Green Slip Insurance ,177,0,4147,Expense,Transport,"Car Insurance, Rego & Maintenance",DR
2022-11-08,Harvey Norman ,187,0,3960,Expense,Household,"Furniture, Electronics & Homewares",DR
2022-11-08,Repco ,128,0,3832,Expense,Transport,"Car Insurance, Rego & Maintenance",DR
2022-11-08,Flight Centre ,68,0,3764,Expense,Leisure & Lifestyle,Holidays & Travel,DR
2022-11-10,Health Food Store ,155,0,3609,Expense,Personal,Fitness & Wellbeing,DR
2022-11-11,Guzman y Gomez ,229,0,3380,Expense,Leisure & Lifestyle,Takeaway,DR
2022-11-12,Kmart Tyre & Auto Service ,60,0,3320,Expense,Transport,"Car Insurance, Rego & Maintenance",DR
2022-11-12,Event Cinemas ,219,0,3101,Expense,Leisure & Lifestyle,Entertainment,DR
2022-11-16,Platypus Shoes ,189,0,2912,Expense,Personal,Clothing & Accessories,DR
2022-11-17,Guzman y Gomez ,144,0,2768,Expense,Leisure & Lifestyle,Takeaway,DR
2022-11-17,CommSec Share Trading Gains ,66,0,2702,Income,Income,Investments,DR
2022-11-17,Autobarn ,137,0,2565,Expense,Transport,"Car Insurance, Rego & Maintenance",DR
2022-11-17,Caltex Woolworths ,74,0,2491,Expense,Transport,Fuel,DR
2022-11-17,Apple Music ,133,0,2358,Expense,Leisure & Lifestyle,"Tv, Music & Streaming",DR
2022-11-18,Binge ,205,0,2153,Expense,Leisure & Lifestyle,"Tv, Music & Streaming",DR
2022-11-18,Target ,20,0,2133,Expense,Personal,Clothing & Accessories,DR
2022-11-18,Culture Kings ,161,0,1972,Expense,Personal,Clothing & Accessories,DR
2022-11-20,ABC Reading Eggs ,71,0,1901,Expense,Personal,Education,DR
2022-11-20,CommSec Share Trading Gains ,76,0,1825,Income,Income,Investments,DR
2022-11-21,Crown Perth ,17,0,1808,Expense,Leisure & Lifestyle,Pubs & Bars,DR
2022-11-23,Rooftop Bar ,121,0,1687,Expense,Leisure & Lifestyle,Pubs & Bars,DR
2022-11-23,Specsavers ,29,0,1658,Expense,Personal,Health & Medical,DR
2022-11-23,Toys 'R' Us ,150,0,1508,Expense,Personal,CHildren & Family,DR
2022-11-23,CommSec Share Trading Gains ,97,0,1411,Income,Income,Investments,DR
2022-11-23,Country Road ,27,0,1384,Expense,Personal,Clothing & Accessories,DR
2022-11-24,Childcare Payments ,37,0,1347,Expense,Personal,Children & Family,DR
2022-11-25,Beachfront Markets ,81,0,1266,Expense,Personal,Clothing & Accessories,DR
2022-11-26,Specsavers ,60,0,1206,Expense,Personal,Health & Medical,DR
2022-11-26,Kumon ,24,0,1182,Expense,Personal,Education,DR
2022-11-26,eBay Sales Proceeds ,99,0,1083,Income,Income,Other Income,DR
2022-11-26,Grill’d ,67,0,1016,Expense,Leisure & Lifestyle,Takeaway,DR
2022-11-26,Ladbrokes ,9,0,1007,Expense,Leisure & Lifestyle,Lottery & Gambling,DR
2022-11-27,Target ,97,0,910,Expense,Personal,Clothing & Accessories,DR
2022-12-01,Monthly Income,0,6542,7452,Income,Income,Wages,CR
2022-12-02,Sylvan Learning ,251,0,7201,Expense,Personal,Education,DR
2022-12-03,Coles Express ,492,0,6709,Expense,Transport,Fuel,DR
2022-12-04,Music Academy ,578,0,6131,Expense,Leisure & Lifestyle,Hobbies,DR
2022-12-06,Autobarn ,435,0,5696,Expense,Transport,"Car Insurance, Rego & Maintenance",DR
2022-12-06,Bunnings Warehouse ,455,0,5241,Expense,Household,Maintenance & Improvements,DR
2022-12-07, Jim's Mowing ,472,0,4769,Expense,Household,Maintenance & Improvements,DR
2022-12-08,Officeworks ,160,0,4609,Expense,Personal,Life Admin,DR
2022-12-10,ATO Tax Refund ,48,0,4561,Income,Income,Other Income,DR
2022-12-10,Service NSW ,327,0,4234,Expense,Transport,"Car Insurance, Rego & Maintenance",DR
2022-12-10,The Victory Hotel ,168,0,4066,Expense,Leisure & Lifestyle,Pubs & Bars,DR
2022-12-11,Optometrist ,167,0,3899,Expense,Personal,Health & Medical,DR
2022-12-12,Snap Fitness ,119,0,3780,Expense,Personal,Fitness & Wellbeing,DR
2022-12-14,Grill'd ,345,0,3435,Expense,Leisure & Lifestyle,Takeaway,DR
2022-12-14,Lorna Jane ,73,0,3362,Expense,Personal,Clothing & Accessories,DR
2022-12-15, Brisbane City Council ,231,0,3131,Expense,Household,Rates & Insurance,DR
2022-12-17,Optometrist ,124,0,3007,Expense,Personal,Health & Medical,DR
2022-12-18,The Espy ,212,0,2795,Expense,Leisure & Lifestyle,Pubs & Bars,DR
2022-12-19,Kmart Tyre & Auto Service ,35,0,2760,Expense,Transport,"Car Insurance, Rego & Maintenance",DR
2022-12-19,Salary Deposit from Woolworths Group ,203,0,2557,Income,Income,Wages,DR
2022-12-20,Ice Cream Parlour ,243,0,2314,Expense,Leisure & Lifestyle,Takeaway,DR
2022-12-20,Queensland Urban Utilities ,20,0,2294,Expense,Household,Utilities,DR
2022-12-21,Audible ,189,0,2105,Expense,Leisure & Lifestyle,"Tv, Music & Streaming",DR
2022-12-21,Eat Street Northshore ,193,0,1912,Expense,Leisure & Lifestyle,Pubs & Bars,DR
2022-12-21,Crown Perth ,67,0,1845,Expense,Leisure & Lifestyle,Pubs & Bars,DR
2022-12-21,EB Games ,55,0,1790,Expense,Leisure & Lifestyle,"Apps, Games & Software",DR
2022-12-23,Audible ,178,0,1612,Expense,Leisure & Lifestyle,"Tv, Music & Streaming",DR
2022-12-25,Village Cinemas ,74,0,1538,Expense,Leisure & Lifestyle,Entertainment,DR
2022-12-27,Aqua Fun Park ,36,0,1502,Expense,Leisure & Lifestyle,Holidays & Travel,DR
2023-01-01,Monthly Income,0,6542,8044,Income,Income,Wages,CR
2023-01-02,Payday Advance ,476,0,7568,Income,Income,Other Income,DR
2023-01-02,Café Nero ,503,0,7065,Expense,Leisure & Lifestyle,Restaurants & Cafes,DR
2023-01-02,Ultra Tune ,556,0,6509,Expense,Transport,"Car Insurance, Rego & Maintenance",DR
2023-01-03,T2 Tea ,155,0,6354,Expense,Personal,Fitness & Wellbeing,DR
2023-01-03, NRMA Insurance ,391,0,5963,Expense,Household,Rates & Insurance,DR
2023-01-03,Uber ,471,0,5492,Expense,Transport,Taxies & Share Cars,DR
2023-01-03,The Baxter Inn ,318,0,5174,Expense,Leisure & Lifestyle,Pubs & Bars,DR
2023-01-03,Sylvan Learning ,411,0,4763,Expense,Personal,Education,DR
2023-01-04,OfficeMax ,79,0,4684,Expense,Personal,Life Admin,DR
2023-01-05, Jim's Mowing ,83,0,4601,Expense,Household,Maintenance & Improvements,DR
2023-01-05, NSW Land Registry Services ,154,0,4447,Expense,Personal,Life Admin,DR
2023-01-06,Palace Cinemas ,304,0,4143,Expense,Leisure & Lifestyle,Entertainment,DR
2023-01-07,Zarraffa's Coffee ,100,0,4043,Expense,Leisure & Lifestyle,Restaurants & Cafes,DR
2023-01-07,Service NSW ,280,0,3763,Expense,Transport,"Car Insurance, Rego & Maintenance",DR
2023-01-07,BWS ,310,0,3453,Expense,Leisure & Lifestyle,Alcohol,DR
2023-01-08,Grill’d ,68,0,3385,Expense,Leisure & Lifestyle,Takeaway,DR
2023-01-08,VicRoads ,320,0,3065,Expense,Transport,"Car Insurance, Rego & Maintenance",DR
2023-01-08,Beachfront Markets ,155,0,2910,Expense,Personal,Clothing & Accessories,DR
2023-01-09,Eat Street Northshore ,64,0,2846,Expense,Leisure & Lifestyle,Pubs & Bars,DR
2023-01-09,Catholic Education Office ,98,0,2748,Expense,Personal,Education,DR
2023-01-09,Apple Store ,207,0,2541,Expense,Leisure & Lifestyle,Electronics,DR
2023-01-09,YMCA ,58,0,2483,Expense,Personal,Fitness & Wellbeing,DR
2023-01-10,Physiotherapy Clinic ,97,0,2386,Expense,Personal,Health & Medical,DR
2023-01-11,Green Slip Insurance ,94,0,2292,Expense,Transport,"Car Insurance, Rego & Maintenance",DR
2023-01-11,City Beach ,77,0,2215,Expense,Personal,Clothing & Accessories,DR
2023-01-12,Lorna Jane ,64,0,2151,Expense,Personal,Clothing & Accessories,DR
2023-01-12,Toys 'R' Us ,183,0,1968,Expense,Personal,CHildren & Family,DR
2023-01-13,The Body Shop ,188,0,1780,Expense,Personal,Hair & Beauty,DR
2023-01-14,Payday Advance ,168,0,1612,Income,Income,Other Income,DR
2023-01-14,Sylvan Learning ,107,0,1505,Expense,Personal,Education,DR
2023-01-14,Ballet Schools ,43,0,1462,Expense,Personal,Fitness & Wellbeing,DR
2023-01-16,Ballet Schools ,13,0,1449,Expense,Personal,Fitness & Wellbeing,DR
2023-01-16, Commonwealth Bank ,32,0,1417,Expense,Household,Rent & Mortgage,DR
2023-01-16, Ray White Real Estate ,18,0,1399,Expense,Personal,Life Admin,DR
2023-01-17,Country Road ,19,0,1380,Expense,Personal,Clothing & Accessories,DR
2023-01-17,Event Cinemas ,90,0,1290,Expense,Leisure & Lifestyle,Entertainment,DR
2023-01-18,BP ,98,0,1192,Expense,Transport,Fuel,DR
2023-01-19,Rooftop Bar ,69,0,1123,Expense,Leisure & Lifestyle,Pubs & Bars,DR
2023-01-20,SEQTA ,78,0,1045,Expense,Personal,Education,DR
2023-01-20,King Swim ,25,0,1020,Expense,Personal,Fitness & Wellbeing,DR
2023-01-22,The Australian ,54,0,966,Expense,Personal,Education,DR
2023-01-22,The Espy ,46,0,920,Expense,Leisure & Lifestyle,Pubs & Bars,DR
2023-01-23,Child Support Agency Deposit ,60,0,860,Income,Income,Other Income,DR
2023-01-23,Kmart Tyre & Auto Service ,18,0,842,Expense,Transport,"Car Insurance, Rego & Maintenance",DR
2023-01-23, National Bank ,57,0,785,Expense,Personal,Fees & Charges,DR
2023-01-23,Bridgestone Select ,9,0,776,Expense,Transport,"Car Insurance, Rego & Maintenance",DR
2023-01-24,Ice Cream Parlour ,41,0,735,Expense,Leisure & Lifestyle,Takeaway,DR
2023-01-25,The Athlete's Foot ,61,0,674,Expense,Personal,Clothing & Accessories,DR
2023-01-25,Ballet Schools ,40,0,634,Expense,Personal,Fitness & Wellbeing,DR
2023-01-26,Autobarn ,50,0,584,Expense,Transport,"Car Insurance, Rego & Maintenance",DR
2023-01-27,Pizza Hut ,20,0,564,Expense,Leisure & Lifestyle,Takeaway,DR
2023-01-27,SEQTA ,40,0,524,Expense,Personal,Education,DR
2023-01-27,Rebel Sport ,11,0,513,Expense,Personal,Fitness & Wellbeing,DR
2023-01-27, Rentokil ,52,0,461,Expense,Household,Maintenance & Improvements,DR
2023-01-28,Zone Bowling ,35,0,426,Expense,Leisure & Lifestyle,Entertainment,DR
2023-02-01,Monthly Income,0,6542,6968,Income,Income,Wages,CR
2023-02-04,AGL Energy ,650,0,6318,Expense,Household,Utilities,DR
2023-02-04,Melbourne Central Lion Hotel ,379,0,5939,Expense,Leisure & Lifestyle,Pubs & Bars,DR
2023-02-05,Liquorland ,294,0,5645,Expense,Leisure & Lifestyle,Alcohol,DR
2023-02-07,Officeworks ,333,0,5312,Expense,Personal,Life Admin,DR
2023-02-09,Eat Street Northshore ,318,0,4994,Expense,Leisure & Lifestyle,Pubs & Bars,DR
2023-02-09,Queensland Urban Utilities ,401,0,4593,Expense,Household,Utilities,DR
2023-02-14,David Jones ,280,0,4313,Expense,Personal,Clothing & Accessories,DR
2023-02-14,Sea Kayak Tours ,353,0,3960,Expense,Leisure & Lifestyle,Holidays & Travel,DR
2023-02-16,Target ,366,0,3594,Expense,Personal,Clothing & Accessories,DR
2023-02-17,Budget Direct Car Insurance ,291,0,3303,Expense,Transport,"Car Insurance, Rego & Maintenance",DR
2023-02-22, EnergyAustralia ,200,0,3103,Expense,Household,Utilities,DR
2023-02-22,Netflix ,308,0,2795,Expense,Leisure & Lifestyle,"Tv, Music & Streaming",DR
2023-02-22,BP ,201,0,2594,Expense,Transport,Fuel,DR
2023-02-22,Petbarn ,34,0,2560,Expense,Household,Pets,DR
2023-02-22,Massage Therapy Center ,162,0,2398,Expense,Personal,Health & Medical,DR
2023-02-22,Binge ,5,0,2393,Expense,Leisure & Lifestyle,"Tv, Music & Streaming",DR
2023-02-22, National Bank ,179,0,2214,Expense,Personal,Fees & Charges,DR
2023-02-25,School Locker ,151,0,2063,Expense,Personal,Children & Family,DR
2023-02-25,Sylvan Learning ,112,0,1951,Expense,Personal,Education,DR
2023-02-25,Budget Direct Car Insurance ,34,0,1917,Expense,Transport,"Car Insurance, Rego & Maintenance",DR
2023-02-25,Zarraffa's Coffee ,107,0,1810,Expense,Leisure & Lifestyle,Restaurants & Cafes,DR
2023-02-27,Café Nero ,97,0,1713,Expense,Leisure & Lifestyle,Restaurants & Cafes,DR
2023-02-28,Sydney Water ,11,0,1702,Expense,Household,Utilities,DR
2023-02-28,YMCA ,44,0,1658,Expense,Personal,Fitness & Wellbeing,DR
2023-03-01,Monthly Income,0,6542,8200,Income,Income,Wages,CR
2023-03-02,Mathnasium ,508,0,7692,Expense,Personal,Education,DR
2023-03-02,CommSec Share Trading Gains ,186,0,7506,Income,Income,Investments,DR
2023-03-02,Uber ,678,0,6828,Expense,Transport,Taxies & Share Cars,DR
2023-03-02,Stan ,127,0,6701,Expense,Leisure & Lifestyle,"Tv, Music & Streaming",DR
2023-03-02,Taronga Zoo ,313,0,6388,Expense,Leisure & Lifestyle,Entertainment,DR
2023-03-03,Music Academy ,557,0,5831,Expense,Leisure & Lifestyle,Hobbies,DR
2023-03-04,Scouts Australia ,285,0,5546,Expense,Leisure & Lifestyle,Hobbies,DR
2023-03-05,School Locker ,250,0,5296,Expense,Personal,Children & Family,DR
2023-03-05,Autobarn ,196,0,5100,Expense,Transport,"Car Insurance, Rego & Maintenance",DR
2023-03-05,Caltex ,80,0,5020,Expense,Transport,Fuel,DR
2023-03-06,Supercheap Auto ,473,0,4547,Expense,Transport,"Car Insurance, Rego & Maintenance",DR
2023-03-07,Rental Deposit from RealEstate.com.au ,266,0,4281,Income,Income,Other Income,DR
2023-03-08,Kmart Tyre & Auto Service ,200,0,4081,Expense,Transport,"Car Insurance, Rego & Maintenance",DR
2023-03-08,Crown Perth ,390,0,3691,Expense,Leisure & Lifestyle,Pubs & Bars,DR
2023-03-08,Ice Cream Parlour ,297,0,3394,Expense,Leisure & Lifestyle,Takeaway,DR
2023-03-10,Guzman y Gomez ,163,0,3231,Expense,Leisure & Lifestyle,Takeaway,DR
2023-03-10,Vodafone Prepaid ,193,0,3038,Expense,Personal,Mobile Phone,DR
2023-03-11,Myer ,32,0,3006,Expense,Personal,Clothing & Accessories,DR
2023-03-11, Brisbane City Council ,261,0,2745,Expense,Household,Rates & Insurance,DR
2023-03-11,Costco ,141,0,2604,Expense,Household,Groceries,DR
2023-03-11,YMCA ,101,0,2503,Expense,Personal,Fitness & Wellbeing,DR
2023-03-13,Muffin Break ,39,0,2464,Expense,Leisure & Lifestyle,Restaurants & Cafes,DR
2023-03-14,Aqua Fun Park ,40,0,2424,Expense,Leisure & Lifestyle,Holidays & Travel,DR
2023-03-15,Karate for Kids ,8,0,2416,Expense,Personal,Fitness & Wellbeing,DR
2023-03-16,Guzman y Gomez ,15,0,2401,Expense,Leisure & Lifestyle,Takeaway,DR
2023-03-16,Massage Therapy Center ,61,0,2340,Expense,Personal,Health & Medical,DR
2023-03-16,Adobe Creative Cloud ,162,0,2178,Expense,Leisure & Lifestyle,Hobbies,DR
2023-03-17,Kayo Sports ,86,0,2092,Expense,Leisure & Lifestyle,"Tv, Music & Streaming",DR
2023-03-17,Goodstart Early Learning ,161,0,1931,Expense,Personal,Children & Family,DR
2023-03-17,Platypus Shoes ,177,0,1754,Expense,Personal,Clothing & Accessories,DR
2023-03-17,Endota Spa ,155,0,1599,Expense,Personal,Fitness & Wellbeing,DR
2023-03-18,Fitness First ,52,0,1547,Expense,Personal,Fitness & Wellbeing,DR
2023-03-19,Gold's Gym ,65,0,1482,Expense,Personal,Fitness & Wellbeing,DR
2023-03-19,King Swim ,36,0,1446,Expense,Personal,Fitness & Wellbeing,DR
2023-03-20,eBay Sales Proceeds ,91,0,1355,Income,Income,Other Income,DR
2023-03-21,Quay Restaurant ,76,0,1279,Expense,Leisure & Lifestyle,Pubs & Bars,DR
2023-03-21,Medicare Claim ,22,0,1257,Expense,Personal,Health & Medical,DR
2023-03-22,Service NSW ,64,0,1193,Expense,Transport,"Car Insurance, Rego & Maintenance",DR
2023-03-22, Slater and Gordon Lawyers ,85,0,1108,Expense,Personal,Life Admin,DR
2023-03-23,eBay Sales Proceeds ,86,0,1022,Income,Income,Other Income,DR
2023-03-23,Apple Music ,62,0,960,Expense,Leisure & Lifestyle,"Tv, Music & Streaming",DR
2023-03-24,The Ivy ,28,0,932,Expense,Leisure & Lifestyle,Pubs & Bars,DR
2023-03-25,Sea Life Aquarium ,88,0,844,Expense,Leisure & Lifestyle,Entertainment,DR
2023-03-27,King Swim ,48,0,796,Expense,Personal,Fitness & Wellbeing,DR
2023-03-27,Quay Restaurant ,47,0,749,Expense,Leisure & Lifestyle,Pubs & Bars,DR
2023-03-28,Lorna Jane ,58,0,691,Expense,Personal,Clothing & Accessories,DR
2023-03-28,The Sydney Morning Herald ,62,0,629,Expense,Personal,Education,DR
2023-04-01,Monthly Income,0,6542,7171,Income,Income,Wages,CR
2023-04-02,Platypus Shoes ,638,0,6533,Expense,Personal,Clothing & Accessories,DR
2023-04-03,Priceline Pharmacy ,408,0,6125,Expense,Personal,Health & Medical,DR
2023-04-04,Ultra Tune ,480,0,5645,Expense,Transport,"Car Insurance, Rego & Maintenance",DR
2023-04-05,Car Wash Cafe ,8,0,5637,Expense,Transport,"Car Insurance, Rego & Maintenance",DR
2023-04-05,Coles ,36,0,5601,Expense,Household,Groceries,DR
2023-04-05,Anytime Fitness ,156,0,5445,Expense,Personal,Fitness & Wellbeing,DR
2023-04-05,MyCar Tyre & Auto ,354,0,5091,Expense,Transport,"Car Insurance, Rego & Maintenance",DR
2023-04-05,Village Cinemas ,326,0,4765,Expense,Leisure & Lifestyle,Entertainment,DR
2023-04-06,Sylvan Learning ,431,0,4334,Expense,Personal,Education,DR
2023-04-06,Menulog ,129,0,4205,Expense,Leisure & Lifestyle,Takeaway,DR
2023-04-08,Centrelink JobSeeker Payment ,163,0,4042,Income,Income,Other Income,DR
2023-04-09,NRMA Roadside Assistance ,21,0,4021,Expense,Transport,"Car Insurance, Rego & Maintenance",DR
2023-04-10,AGL Energy ,270,0,3751,Expense,Household,Utilities,DR
2023-04-10,Booktopia ,193,0,3558,Expense,Leisure & Lifestyle,Hobbies,DR
2023-04-11,Origin Energy ,32,0,3526,Expense,Household,Utilities,DR
2023-04-11,The Baxter Inn ,244,0,3282,Expense,Leisure & Lifestyle,Pubs & Bars,DR
2023-04-11,Dental Clinic ,231,0,3051,Expense,Personal,Health & Medical,DR
2023-04-12,Hungry Jack’s ,144,0,2907,Expense,Leisure & Lifestyle,Takeaway,DR
2023-04-12,Green Slip Insurance ,177,0,2730,Expense,Transport,"Car Insurance, Rego & Maintenance",DR
2023-04-14,Decathlon ,192,0,2538,Expense,Personal,Fitness & Wellbeing,DR
2023-04-14,Music Academy ,177,0,2361,Expense,Leisure & Lifestyle,Hobbies,DR
2023-04-14,Witchery ,83,0,2278,Expense,Personal,Clothing & Accessories,DR
2023-04-14,Acupuncture Clinic ,207,0,2071,Expense,Personal,Health & Medical,DR
2023-04-14,The Sydney Morning Herald ,140,0,1931,Expense,Personal,Education,DR
2023-04-15,King Swim ,7,0,1924,Expense,Personal,Fitness & Wellbeing,DR
2023-04-16,Tennis Australia ,132,0,1792,Expense,Personal,Fitness & Wellbeing,DR
2023-04-18,Scouts Australia ,94,0,1698,Expense,Leisure & Lifestyle,Hobbies,DR
2023-04-18,Le Creuset ,59,0,1639,Expense,Household,"Furniture, Electronics & Homewares",DR
2023-04-19,Who Gives A Crap ,31,0,1608,Expense,Household,Groceries,DR
2023-04-19,Endota Spa ,138,0,1470,Expense,Personal,Fitness & Wellbeing,DR
2023-04-20,Billabong ,93,0,1377,Expense,Personal,Clothing & Accessories,DR
2023-04-20,Surf Dive 'n Ski ,52,0,1325,Expense,Personal,Clothing & Accessories,DR
2023-04-21,eBay Sales Proceeds ,35,0,1290,Income,Income,Other Income,DR
2023-04-21,Stan ,123,0,1167,Expense,Leisure & Lifestyle,"Tv, Music & Streaming",DR
2023-04-22,The Good Guys ,9,0,1158,Expense,Household,"Furniture, Electronics & Homewares",DR
2023-04-24,Sylvan Learning ,51,0,1107,Expense,Personal,Education,DR
2023-04-25,Anytime Fitness ,60,0,1047,Expense,Personal,Fitness & Wellbeing,DR
2023-04-25,Flight Centre ,62,0,985,Expense,Leisure & Lifestyle,Holidays & Travel,DR
2023-04-25,Shell V Power,56,0,929,Expense,Transport,Fuel,DR
2023-04-25,AMF Bowling ,69,0,860,Expense,Leisure & Lifestyle,Entertainment,DR
2023-04-27,PayPal Transfer from Sale ,47,0,813,Income,Income,Other Income,DR
2023-04-27,Acupuncture Clinic ,12,0,801,Expense,Personal,Health & Medical,DR
2023-04-27,Rip Curl ,13,0,788,Expense,Personal,Clothing & Accessories,DR
2023-04-28,Sydney Water ,53,0,735,Expense,Household,Utilities,DR
2023-04-28,The Good Guys ,32,0,703,Expense,Household,"Furniture, Electronics & Homewares",DR
2023-04-28,Coles ,29,0,674,Expense,Household,Groceries,DR
2023-05-01,Monthly Income,0,6542,7216,Income,Income,Wages,CR
2023-05-02,Platypus Shoes ,691,0,6525,Expense,Personal,Clothing & Accessories,DR
2023-05-03,Vodafone Prepaid ,149,0,6376,Expense,Personal,Mobile Phone,DR
2023-05-03,Culture Kings ,187,0,6189,Expense,Personal,Clothing & Accessories,DR
2023-05-03,Queensland Urban Utilities ,603,0,5586,Expense,Household,Utilities,DR
2023-05-03,Ballet Schools ,454,0,5132,Expense,Personal,Fitness & Wellbeing,DR
2023-05-03,Amazon Prime ,195,0,4937,Expense,Leisure & Lifestyle,"Tv, Music & Streaming",DR
2023-05-03, Ray White Real Estate ,191,0,4746,Expense,Personal,Life Admin,DR
2023-05-04,Apple Store ,330,0,4416,Expense,Leisure & Lifestyle,Electronics,DR
2023-05-04,Eat Street Northshore ,416,0,4000,Expense,Leisure & Lifestyle,Pubs & Bars,DR
2023-05-06,Caltex Woolworths ,67,0,3933,Expense,Transport,Fuel,DR
2023-05-06,AGL Energy ,389,0,3544,Expense,Household,Utilities,DR
2023-05-07,TerryWhite Chemmart ,336,0,3208,Expense,Personal,Health & Medical,DR
2023-05-07,Caltex Woolworths ,75,0,3133,Expense,Transport,Fuel,DR
2023-05-09,MyCar Tyre & Auto ,62,0,3071,Expense,Transport,"Car Insurance, Rego & Maintenance",DR
2023-05-09,Grill'd ,22,0,3049,Expense,Leisure & Lifestyle,Takeaway,DR
2023-05-10,National Hearing Care ,75,0,2974,Expense,Personal,Health & Medical,DR
2023-05-10,Surfstitch ,188,0,2786,Expense,Personal,Clothing & Accessories,DR
2023-05-11,Soccer Clubs ,223,0,2563,Expense,Personal,Fitness & Wellbeing,DR
2023-05-11,BrewDog ,114,0,2449,Expense,Leisure & Lifestyle,Alcohol,DR
2023-05-11,Anytime Fitness ,96,0,2353,Expense,Personal,Fitness & Wellbeing,DR
2023-05-12,Lorna Jane ,23,0,2330,Expense,Personal,Clothing & Accessories,DR
2023-05-13,NRMA Roadside Assistance ,123,0,2207,Expense,Transport,"Car Insurance, Rego & Maintenance",DR
2023-05-14, Rentokil ,49,0,2158,Expense,Household,Maintenance & Improvements,DR
2023-05-15,Eau De Vie ,58,0,2100,Expense,Leisure & Lifestyle,Pubs & Bars,DR
2023-05-16,Tennis Australia ,188,0,1912,Expense,Personal,Fitness & Wellbeing,DR
2023-05-17,MyCar Tyre & Auto ,111,0,1801,Expense,Transport,"Car Insurance, Rego & Maintenance",DR
2023-05-17,Café Nero ,62,0,1739,Expense,Leisure & Lifestyle,Restaurants & Cafes,DR
2023-05-18,Beach Café ,59,0,1680,Expense,Leisure & Lifestyle,Restaurants & Cafes,DR
2023-05-19,Soccer Clubs ,98,0,1582,Expense,Personal,Fitness & Wellbeing,DR
2023-05-19,Spotlight ,150,0,1432,Expense,Leisure & Lifestyle,Hobbies,DR
2023-05-19, Commonwealth Bank ,90,0,1342,Expense,Household,Rent & Mortgage,DR
2023-05-19,Camp Australia ,110,0,1232,Expense,Leisure & Lifestyle,Hobbies,DR
2023-05-20,Camp Australia ,69,0,1163,Expense,Leisure & Lifestyle,Hobbies,DR
2023-05-20,The Iconic ,49,0,1114,Expense,Personal,Clothing & Accessories,DR
2023-05-21, Jim’s Building Inspections ,33,0,1081,Expense,Household,Maintenance & Improvements,DR
2023-05-21, Jim’s Building Inspections ,76,0,1005,Expense,Household,Maintenance & Improvements,DR
2023-05-22, Slater and Gordon Lawyers ,83,0,922,Expense,Personal,Life Admin,DR
2023-05-23,MyCar Tyre & Auto ,70,0,852,Expense,Transport,"Car Insurance, Rego & Maintenance",DR
2023-05-23,TerryWhite Chemmart ,19,0,833,Expense,Personal,Health & Medical,DR
2023-05-24,Priceline Pharmacy ,80,0,753,Expense,Personal,Health & Medical,DR
2023-05-25,Target ,26,0,727,Expense,Personal,Clothing & Accessories,DR
2023-05-26,Dan Murphy’s ,13,0,714,Expense,Leisure & Lifestyle,Alcohol,DR
2023-05-26,G8 Education ,21,0,693,Expense,Personal,Children & Family,DR
2023-05-27,Payday Advance ,19,0,674,Income,Income,Other Income,DR
2023-05-27,Officeworks ,27,0,647,Expense,Personal,Life Admin,DR
2023-05-28,Beachside Yoga Classes ,34,0,613,Expense,Personal,Fitness & Wellbeing,DR
2023-05-28,Binge ,21,0,592,Expense,Leisure & Lifestyle,"Tv, Music & Streaming",DR
2023-05-28,The Australian ,20,0,572,Expense,Personal,Education,DR
2023-06-01,Monthly Income,0,6542,7114,Income,Income,Wages,CR
2023-06-02,Ballet Schools ,367,0,6747,Expense,Personal,Fitness & Wellbeing,DR
2023-06-03,Fitness First ,631,0,6116,Expense,Personal,Fitness & Wellbeing,DR
2023-06-03,Costco ,49,0,6067,Expense,Household,Groceries,DR
2023-06-05,VicRoads ,572,0,5495,Expense,Transport,"Car Insurance, Rego & Maintenance",DR
2023-06-05,Palace Cinemas ,403,0,5092,Expense,Leisure & Lifestyle,Entertainment,DR
2023-06-06,Green Slip Insurance ,183,0,4909,Expense,Transport,"Car Insurance, Rego & Maintenance",DR
2023-06-07,Chemist Warehouse ,339,0,4570,Expense,Personal,Health & Medical,DR
2023-06-07,AustralianSuper Pension ,233,0,4337,Income,Income,Other Income,DR
2023-06-08,Officeworks ,5,0,4332,Expense,Personal,Life Admin,DR
2023-06-08,David Jones ,348,0,3984,Expense,Personal,Clothing & Accessories,DR
2023-06-13,Grill’d ,387,0,3597,Expense,Leisure & Lifestyle,Takeaway,DR
2023-06-15,Kayo Sports ,220,0,3377,Expense,Leisure & Lifestyle,"Tv, Music & Streaming",DR
2023-06-15,Service NSW ,39,0,3338,Expense,Transport,"Car Insurance, Rego & Maintenance",DR
2023-06-17,Timezone ,96,0,3242,Expense,Leisure & Lifestyle,Entertainment,DR
2023-06-22,Campion Education ,150,0,3092,Expense,Personal,Children & Family,DR
2023-06-22,Coles Express ,75,0,3017,Expense,Transport,Fuel,DR
2023-06-23,Queensland Urban Utilities ,156,0,2861,Expense,Household,Utilities,DR
2023-06-25,Palace Cinemas ,49,0,2812,Expense,Leisure & Lifestyle,Entertainment,DR
2023-06-25,Country Road ,207,0,2605,Expense,Personal,Clothing & Accessories,DR
2023-06-27,Coles Express ,135,0,2470,Expense,Transport,Fuel,DR
2023-07-01,Monthly Income,0,6542,9012,Income,Income,Wages,CR
2023-07-03,Origin Energy ,591,0,8421,Expense,Household,Utilities,DR
2023-07-03,Kmart ,743,0,7678,Expense,Personal,Children & Family,DR
2023-07-03,Foxtel ,699,0,6979,Expense,Leisure & Lifestyle,"Tv, Music & Streaming",DR
2023-07-04,Local Hospital ,11,0,6968,Expense,Personal,Health & Medical,DR
2023-07-05,Rental Deposit from RealEstate.com.au ,231,0,6737,Income,Income,Other Income,DR
2023-07-05,Guzman y Gomez ,292,0,6445,Expense,Leisure & Lifestyle,Takeaway,DR
2023-07-06,King Swim ,622,0,5823,Expense,Personal,Fitness & Wellbeing,DR
2023-07-06,Child Support Agency Deposit ,543,0,5280,Income,Income,Other Income,DR
2023-07-07,Surf Dive 'n Ski ,372,0,4908,Expense,Personal,Clothing & Accessories,DR
2023-07-08,Mathnasium ,312,0,4596,Expense,Personal,Education,DR
2023-07-08,Mathnasium ,92,0,4504,Expense,Personal,Education,DR
2023-07-08,AGL Energy ,102,0,4402,Expense,Household,Utilities,DR
2023-07-09,Tabcorp ,439,0,3963,Expense,Leisure & Lifestyle,Lottery & Gambling,DR
2023-07-10,The Rocks Bar and Pub ,44,0,3919,Expense,Leisure & Lifestyle,Pubs & Bars,DR
2023-07-10,Endota Spa ,62,0,3857,Expense,Personal,Fitness & Wellbeing,DR
2023-07-11,AustralianSuper Pension ,69,0,3788,Income,Income,Other Income,DR
2023-07-11,The Espy ,273,0,3515,Expense,Leisure & Lifestyle,Pubs & Bars,DR
2023-07-12,Eat Street Northshore ,284,0,3231,Expense,Leisure & Lifestyle,Pubs & Bars,DR
2023-07-12,Sea Kayak Tours ,228,0,3003,Expense,Leisure & Lifestyle,Holidays & Travel,DR
2023-07-12,Ultra Tune ,138,0,2865,Expense,Transport,"Car Insurance, Rego & Maintenance",DR
2023-07-14,Timezone ,100,0,2765,Expense,Leisure & Lifestyle,Entertainment,DR
2023-07-14, Jim's Mowing ,163,0,2602,Expense,Household,Maintenance & Improvements,DR
2023-07-14,Gold's Gym ,222,0,2380,Expense,Personal,Fitness & Wellbeing,DR
2023-07-14,Platypus Shoes ,199,0,2181,Expense,Personal,Clothing & Accessories,DR
2023-07-16,JB HiFi,19,0,2162,Expense,Leisure & Lifestyle,Electronics,DR
2023-07-17,Local Hospital ,157,0,2005,Expense,Personal,Health & Medical,DR
2023-07-18,BP ,136,0,1869,Expense,Transport,Fuel,DR
2023-07-18,Westpac Dividend Deposit ,150,0,1719,Income,Income,Investments,DR
2023-07-18,Foxtel ,151,0,1568,Expense,Leisure & Lifestyle,"Tv, Music & Streaming",DR
2023-07-18,Officeworks ,113,0,1455,Expense,Personal,Life Admin,DR
2023-07-18,Adobe Creative Cloud ,50,0,1405,Expense,Leisure & Lifestyle,Hobbies,DR
2023-07-19,Village Cinemas ,125,0,1280,Expense,Leisure & Lifestyle,Entertainment,DR
2023-07-20,Swim Australia ,41,0,1239,Expense,Personal,Fitness & Wellbeing,DR
2023-07-20,Westpac Dividend Deposit ,81,0,1158,Income,Income,Investments,DR
2023-07-22,Audible ,48,0,1110,Expense,Leisure & Lifestyle,"Tv, Music & Streaming",DR
2023-07-23,Menulog ,12,0,1098,Expense,Leisure & Lifestyle,Takeaway,DR
2023-07-23,Green Slip Insurance ,91,0,1007,Expense,Transport,"Car Insurance, Rego & Maintenance",DR
2023-07-23,MyCar Tyre & Auto ,54,0,953,Expense,Transport,"Car Insurance, Rego & Maintenance",DR
2023-07-23,Grill'd ,14,0,939,Expense,Leisure & Lifestyle,Takeaway,DR
2023-07-25,Specsavers ,86,0,853,Expense,Personal,Health & Medical,DR
2023-07-25,Specsavers ,55,0,798,Expense,Personal,Health & Medical,DR
2023-07-26,Ballet Schools ,29,0,769,Expense,Personal,Fitness & Wellbeing,DR
2023-07-26,Eat Street Northshore ,71,0,698,Expense,Leisure & Lifestyle,Pubs & Bars,DR
2023-07-27,Budget Direct Car Insurance ,32,0,666,Expense,Transport,"Car Insurance, Rego & Maintenance",DR
2023-07-27,The Iconic ,65,0,601,Expense,Personal,Clothing & Accessories,DR
2023-07-27,Endota Spa ,13,0,588,Expense,Personal,Fitness & Wellbeing,DR
2023-07-28,Decathlon ,16,0,572,Expense,Personal,Fitness & Wellbeing,DR
2023-07-28,Boost Juice Bars ,54,0,518,Expense,Leisure & Lifestyle,Takeaway,DR
2023-07-28,Hungry Jack’s ,9,0,509,Expense,Leisure & Lifestyle,Takeaway,DR
2023-07-28,Palace Cinemas ,43,0,466,Expense,Leisure & Lifestyle,Entertainment,DR
2023-08-01,Monthly Income,0,6542,7008,Income,Income,Wages,CR
2023-08-02,The Athlete's Foot ,301,0,6707,Expense,Personal,Clothing & Accessories,DR
2023-08-03,Crown Perth ,258,0,6449,Expense,Leisure & Lifestyle,Pubs & Bars,DR
2023-08-03,Zone Bowling ,559,0,5890,Expense,Leisure & Lifestyle,Entertainment,DR
2023-08-04,Harris Farm Markets ,326,0,5564,Expense,Household,Groceries,DR
2023-08-04,The Australian ,499,0,5065,Expense,Personal,Education,DR
2023-08-05,Montessori Schools ,73,0,4992,Expense,Personal,Education,DR
2023-08-06,Interest Payment from Commonwealth Bank ,78,0,4914,Income,Income,Investments,DR
2023-08-06,AGL Energy ,393,0,4521,Expense,Household,Utilities,DR
2023-08-07,BWS ,370,0,4151,Expense,Leisure & Lifestyle,Alcohol,DR
2023-08-07,Upwork Freelancer Payment ,173,0,3978,Income,Income,Other Income,DR
2023-08-07,YMCA ,9,0,3969,Expense,Personal,Fitness & Wellbeing,DR
2023-08-08,AustralianSuper Pension ,355,0,3614,Income,Income,Other Income,DR
2023-08-09,Priceline Pharmacy ,352,0,3262,Expense,Personal,Health & Medical,DR
2023-08-10,Shell V Power,65,0,3197,Expense,Transport,Fuel,DR
2023-08-10,Aqua Fun Park ,109,0,3088,Expense,Leisure & Lifestyle,Holidays & Travel,DR
2023-08-11,Domino’s Pizza ,138,0,2950,Expense,Leisure & Lifestyle,Takeaway,DR
2023-08-11,Decathlon ,25,0,2925,Expense,Personal,Fitness & Wellbeing,DR
2023-08-12,Australian Veterinary Association ,177,0,2748,Expense,Household,Pets,DR
2023-08-12,Jetts Fitness ,231,0,2517,Expense,Personal,Fitness & Wellbeing,DR
2023-08-13,Swim Australia ,13,0,2504,Expense,Personal,Fitness & Wellbeing,DR
2023-08-14,F45 Training ,146,0,2358,Expense,Personal,Fitness & Wellbeing,DR
2023-08-14,Dan Murphy’s ,112,0,2246,Expense,Leisure & Lifestyle,Alcohol,DR
2023-08-14,Beachside Yoga Classes ,218,0,2028,Expense,Personal,Fitness & Wellbeing,DR
2023-08-15, Jim’s Building Inspections ,47,0,1981,Expense,Household,Maintenance & Improvements,DR
2023-08-15,Chemist Warehouse ,17,0,1964,Expense,Personal,Health & Medical,DR
2023-08-16,Greencross Vets ,96,0,1868,Expense,Household,Pets,DR
2023-08-17,Fernwood Fitness ,95,0,1773,Expense,Personal,Fitness & Wellbeing,DR
2023-08-17,SEQTA ,159,0,1614,Expense,Personal,Education,DR
2023-08-18,Supercheap Auto ,111,0,1503,Expense,Transport,"Car Insurance, Rego & Maintenance",DR
2023-08-18,BP ,73,0,1430,Expense,Transport,Fuel,DR
2023-08-19,Child Support Agency Deposit ,13,0,1417,Income,Income,Other Income,DR
2023-08-19,Health Food Store ,26,0,1391,Expense,Personal,Fitness & Wellbeing,DR
2023-08-19, BSA Ltd ,103,0,1288,Expense,Household,Maintenance & Improvements,DR
2023-08-21,Supercheap Auto ,44,0,1244,Expense,Transport,"Car Insurance, Rego & Maintenance",DR
2023-08-22, Brisbane City Council ,82,0,1162,Expense,Household,Rates & Insurance,DR
2023-08-22,ATO Tax Refund ,17,0,1145,Income,Income,Other Income,DR
2023-08-22,Supercheap Auto ,40,0,1105,Expense,Transport,"Car Insurance, Rego & Maintenance",DR
2023-08-23,Dan Murphy’s ,58,0,1047,Expense,Leisure & Lifestyle,Alcohol,DR
2023-08-23,Car Wash Cafe ,38,0,1009,Expense,Transport,"Car Insurance, Rego & Maintenance",DR
2023-08-23,Medicare Claim ,34,0,975,Expense,Personal,Health & Medical,DR
2023-08-24,EB Games ,45,0,930,Expense,Leisure & Lifestyle,"Apps, Games & Software",DR
2023-08-25,Lorna Jane ,94,0,836,Expense,Personal,Clothing & Accessories,DR
2023-08-26,Grill’d ,30,0,806,Expense,Leisure & Lifestyle,Takeaway,DR
2023-08-26,Beachside Yoga Classes ,27,0,779,Expense,Personal,Fitness & Wellbeing,DR
2023-08-27,Autobarn ,67,0,712,Expense,Transport,"Car Insurance, Rego & Maintenance",DR
2023-08-27,OfficeMax ,64,0,648,Expense,Personal,Life Admin,DR
2023-08-27,Cookie ,64,0,584,Expense,Leisure & Lifestyle,Pubs & Bars,DR
2023-08-27,Foxtel ,14,0,570,Expense,Leisure & Lifestyle,"Tv, Music & Streaming",DR
2023-08-28,Caltex Woolworths ,27,0,543,Expense,Transport,Fuel,DR
2023-08-28,Jetts Fitness ,11,0,532,Expense,Personal,Fitness & Wellbeing,DR
2023-08-28,Childcare Payments ,31,0,501,Expense,Personal,Children & Family,DR
2023-09-01,Monthly Income,0,6542,7043,Income,Income,Wages,CR
2023-09-02,Harvey Norman ,489,0,6554,Expense,Household,"Furniture, Electronics & Homewares",DR
2023-09-04, NRMA Insurance ,104,0,6450,Expense,Household,Rates & Insurance,DR
2023-09-04,EnergyAustralia ,11,0,6439,Expense,Household,Utilities,DR
2023-09-04,Eat Street Northshore ,517,0,5922,Expense,Leisure & Lifestyle,Pubs & Bars,DR
2023-09-05,IKEA ,162,0,5760,Expense,Household,Maintenance & Improvements,DR
2023-09-05,Childcare Payments ,296,0,5464,Expense,Personal,Children & Family,DR
2023-09-05,City Beach ,312,0,5152,Expense,Personal,Clothing & Accessories,DR
2023-09-08,Sunnybank Hotel ,18,0,5134,Expense,Leisure & Lifestyle,Pubs & Bars,DR
2023-09-08,JB HiFi,325,0,4809,Expense,Leisure & Lifestyle,Electronics,DR
2023-09-08,The Brisbane Hotel ,9,0,4800,Expense,Leisure & Lifestyle,Pubs & Bars,DR
2023-09-10,Adobe Creative Cloud ,309,0,4491,Expense,Leisure & Lifestyle,Hobbies,DR
2023-09-10,Rebel Sport ,420,0,4071,Expense,Personal,Fitness & Wellbeing,DR
2023-09-11,South East Water ,359,0,3712,Expense,Household,Utilities,DR
2023-09-12,Disney+ ,191,0,3521,Expense,Leisure & Lifestyle,"Tv, Music & Streaming",DR
2023-09-12,Pathology Lab ,274,0,3247,Expense,Personal,Health & Medical,DR
2023-09-13,Physiotherapy Clinic ,125,0,3122,Expense,Personal,Health & Medical,DR
2023-09-13,Netflix ,285,0,2837,Expense,Leisure & Lifestyle,"Tv, Music & Streaming",DR
2023-09-14,Disney+ ,96,0,2741,Expense,Leisure & Lifestyle,"Tv, Music & Streaming",DR
2023-09-15,KU Children's Services ,105,0,2636,Expense,Personal,Children & Family,DR
2023-09-15,Interest Payment from Commonwealth Bank ,52,0,2584,Income,Income,Investments,DR
2023-09-16,Guzman y Gomez ,203,0,2381,Expense,Leisure & Lifestyle,Takeaway,DR
2023-09-16,Pizza Hut ,141,0,2240,Expense,Leisure & Lifestyle,Takeaway,DR
2023-09-16,Rooftop Bar ,139,0,2101,Expense,Leisure & Lifestyle,Pubs & Bars,DR
2023-09-16,Beachside Caravan Park ,166,0,1935,Expense,Leisure & Lifestyle,Holidays & Travel,DR
2023-09-17,Toys 'R' Us ,83,0,1852,Expense,Personal,CHildren & Family,DR
2023-09-18,Sunnybank Hotel ,70,0,1782,Expense,Leisure & Lifestyle,Pubs & Bars,DR
2023-09-19,Bulk Billing Doctor ,51,0,1731,Expense,Personal,Health & Medical,DR
2023-09-19,BWS ,67,0,1664,Expense,Leisure & Lifestyle,Alcohol,DR
2023-09-21,QBE Insurance Claim Payout ,20,0,1644,Income,Income,Other Income,DR
2023-09-21,Dymocks ,111,0,1533,Expense,Leisure & Lifestyle,Hobbies,DR
2023-09-22,Pathology Lab ,37,0,1496,Expense,Personal,Health & Medical,DR
2023-09-22,Café Nero ,77,0,1419,Expense,Leisure & Lifestyle,Restaurants & Cafes,DR
2023-09-22,Barbeques Galore ,106,0,1313,Expense,Household,"Furniture, Electronics & Homewares",DR
2023-09-23,Shell V Power,75,0,1238,Expense,Transport,Fuel,DR
2023-09-24,ATO Tax Refund ,16,0,1222,Income,Income,Other Income,DR
2023-09-25,The Body Shop ,103,0,1119,Expense,Personal,Hair & Beauty,DR
2023-09-26,Eat Street Northshore ,50,0,1069,Expense,Leisure & Lifestyle,Pubs & Bars,DR
2023-09-27,Petbarn ,45,0,1024,Expense,Household,Pets,DR
2023-09-27,Payday Advance ,58,0,966,Income,Income,Other Income,DR
2023-09-27,TerryWhite Chemmart ,26,0,940,Expense,Personal,Health & Medical,DR
2023-09-28,G8 Education ,88,0,852,Expense,Personal,Children & Family,DR
2023-10-01,Monthly Income,0,6542,7394,Income,Income,Wages,CR
2023-10-02,Country Road ,245,0,7149,Expense,Personal,Clothing & Accessories,DR
2023-10-02,Budget Direct Car Insurance ,73,0,7076,Expense,Transport,"Car Insurance, Rego & Maintenance",DR
2023-10-03,Café Nero ,674,0,6402,Expense,Leisure & Lifestyle,Restaurants & Cafes,DR
2023-10-04,Event Cinemas ,245,0,6157,Expense,Leisure & Lifestyle,Entertainment,DR
2023-10-05,Dymocks ,332,0,5825,Expense,Leisure & Lifestyle,Hobbies,DR
2023-10-05,Binge ,156,0,5669,Expense,Leisure & Lifestyle,"Tv, Music & Streaming",DR
2023-10-08,City Beach ,452,0,5217,Expense,Personal,Clothing & Accessories,DR
2023-10-08,Autobarn ,465,0,4752,Expense,Transport,"Car Insurance, Rego & Maintenance",DR
2023-10-09,BrewDog ,186,0,4566,Expense,Leisure & Lifestyle,Alcohol,DR
2023-10-10,Interest Payment from Commonwealth Bank ,159,0,4407,Income,Income,Investments,DR
2023-10-12,Acupuncture Clinic ,192,0,4215,Expense,Personal,Health & Medical,DR
2023-10-14,Medicare Claim ,312,0,3903,Expense,Personal,Health & Medical,DR
2023-10-15,The Sydney Morning Herald ,324,0,3579,Expense,Personal,Education,DR
2023-10-16,South East Water ,144,0,3435,Expense,Household,Utilities,DR
2023-10-18, EnergyAustralia ,208,0,3227,Expense,Household,Utilities,DR
2023-10-18,Harris Farm Markets ,16,0,3211,Expense,Household,Groceries,DR
2023-10-19,eBay Sales Proceeds ,174,0,3037,Income,Income,Other Income,DR
2023-10-21,Woolworths ,267,0,2770,Expense,Household,Groceries,DR
2023-10-21,Guardian Childcare & Education ,247,0,2523,Expense,Personal,Children & Family,DR
2023-10-21,Timezone ,47,0,2476,Expense,Leisure & Lifestyle,Entertainment,DR
2023-10-22,Rooftop Bar ,97,0,2379,Expense,Leisure & Lifestyle,Pubs & Bars,DR
2023-10-22,Microsoft 365 ,33,0,2346,Expense,Personal,Education,DR
2023-10-22, Brisbane City Council ,188,0,2158,Expense,Household,Rates & Insurance,DR
2023-10-23, Jim’s Building Inspections ,50,0,2108,Expense,Household,Maintenance & Improvements,DR
2023-10-23,The Iconic ,42,0,2066,Expense,Personal,Clothing & Accessories,DR
2023-10-25,Grill’d ,57,0,2009,Expense,Leisure & Lifestyle,Takeaway,DR
2023-10-26,Rental Deposit from RealEstate.com.au ,43,0,1966,Income,Income,Other Income,DR
2023-10-27,Freedom Furniture ,57,0,1909,Expense,Household,Maintenance & Improvements,DR
2023-10-28,Melbourne Central Lion Hotel ,77,0,1832,Expense,Leisure & Lifestyle,Pubs & Bars,DR
2023-10-28,Zarraffa's Coffee ,41,0,1791,Expense,Leisure & Lifestyle,Restaurants & Cafes,DR
2023-10-28, The Good Guys ,86,0,1705,Expense,Household,"Furniture, Electronics & Homewares",DR
2023-11-01,Monthly Income,0,6542,8247,Income,Income,Wages,CR
2023-11-02,Camp Australia ,463,0,7784,Expense,Leisure & Lifestyle,Hobbies,DR
2023-11-03,Platypus Shoes ,217,0,7567,Expense,Personal,Clothing & Accessories,DR
2023-11-04,Westpac Dividend Deposit ,155,0,7412,Income,Income,Investments,DR
2023-11-04,KU Children's Services ,80,0,7332,Expense,Personal,Children & Family,DR
2023-11-05,T2 Tea ,528,0,6804,Expense,Personal,Fitness & Wellbeing,DR
2023-11-05,Decathlon ,575,0,6229,Expense,Personal,Fitness & Wellbeing,DR
2023-11-07,Costco ,586,0,5643,Expense,Household,Groceries,DR
2023-11-08, Rentokil ,421,0,5222,Expense,Household,Maintenance & Improvements,DR
2023-11-08,Optus ,337,0,4885,Expense,Personal,Mobile Phone,DR
2023-11-08,Guardian Childcare & Education ,344,0,4541,Expense,Personal,Children & Family,DR
2023-11-10,Rooftop Bar ,158,0,4383,Expense,Leisure & Lifestyle,Pubs & Bars,DR
2023-11-14,Target ,368,0,4015,Expense,Personal,Clothing & Accessories,DR
2023-11-14,Swim Australia ,292,0,3723,Expense,Personal,Fitness & Wellbeing,DR
2023-11-16,Beachside Yoga Classes ,345,0,3378,Expense,Personal,Fitness & Wellbeing,DR
2023-11-18,PayPal Transfer from Sale ,249,0,3129,Income,Income,Other Income,DR
2023-11-18,Apple Store ,266,0,2863,Expense,Leisure & Lifestyle,Electronics,DR
2023-11-18,Mathnasium ,180,0,2683,Expense,Personal,Education,DR
2023-11-20,Melbourne Central Lion Hotel ,66,0,2617,Expense,Leisure & Lifestyle,Pubs & Bars,DR
2023-11-20,Hobart Brewing Company ,143,0,2474,Expense,Leisure & Lifestyle,Pubs & Bars,DR
2023-11-21,Domino’s Pizza ,160,0,2314,Expense,Leisure & Lifestyle,Takeaway,DR
2023-11-25,TerryWhite Chemmart ,126,0,2188,Expense,Personal,Health & Medical,DR
2023-11-26,City Beach ,194,0,1994,Expense,Personal,Clothing & Accessories,DR
2023-11-26,Autobarn ,97,0,1897,Expense,Transport,"Car Insurance, Rego & Maintenance",DR
2023-11-27,Surf Dive 'n Ski ,25,0,1872,Expense,Personal,Clothing & Accessories,DR
2023-12-01,Monthly Income,0,6542,8414,Income,Income,Wages,CR
2023-12-02,Foxtel ,433,0,7981,Expense,Leisure & Lifestyle,"Tv, Music & Streaming",DR
2023-12-02,Sea Kayak Tours ,15,0,7966,Expense,Leisure & Lifestyle,Holidays & Travel,DR
2023-12-03,Sydney Water ,574,0,7392,Expense,Household,Utilities,DR
2023-12-04,Stand Up Paddleboard Rental ,368,0,7024,Expense,Personal,Fitness & Wellbeing,DR
2023-12-05,Foxtel ,647,0,6377,Expense,Leisure & Lifestyle,"Tv, Music & Streaming",DR
2023-12-05,Specsavers ,127,0,6250,Expense,Personal,Health & Medical,DR
2023-12-06,CommSec Share Trading Gains ,387,0,5863,Income,Income,Investments,DR
2023-12-06,Telstra ,180,0,5683,Expense,Personal,Mobile Phone,DR
2023-12-06,Endota Spa ,77,0,5606,Expense,Personal,Fitness & Wellbeing,DR
2023-12-06,Culture Kings ,541,0,5065,Expense,Personal,Clothing & Accessories,DR
2023-12-06,Music Academy ,367,0,4698,Expense,Leisure & Lifestyle,Hobbies,DR
2023-12-06, Metricon ,320,0,4378,Expense,Household,Maintenance & Improvements,DR
2023-12-06,Centrelink JobSeeker Payment ,262,0,4116,Income,Income,Other Income,DR
2023-12-07,National Hearing Care ,328,0,3788,Expense,Personal,Health & Medical,DR
2023-12-07,The Athlete's Foot ,256,0,3532,Expense,Personal,Clothing & Accessories,DR
2023-12-08,Bridgestone Select ,261,0,3271,Expense,Transport,"Car Insurance, Rego & Maintenance",DR
2023-12-09,Music Academy ,226,0,3045,Expense,Leisure & Lifestyle,Hobbies,DR
2023-12-10,Green Slip Insurance ,235,0,2810,Expense,Transport,"Car Insurance, Rego & Maintenance",DR
2023-12-10,Medicare Claim ,47,0,2763,Expense,Personal,Health & Medical,DR
2023-12-11,The Brisbane Hotel ,189,0,2574,Expense,Leisure & Lifestyle,Pubs & Bars,DR
2023-12-12,Budget Direct Car Insurance ,253,0,2321,Expense,Transport,"Car Insurance, Rego & Maintenance",DR
2023-12-13,Beachside Caravan Park ,176,0,2145,Expense,Leisure & Lifestyle,Holidays & Travel,DR
2023-12-14,Chiropractor ,44,0,2101,Expense,Personal,Health & Medical,DR
2023-12-15,YMCA ,63,0,2038,Expense,Personal,Fitness & Wellbeing,DR
2023-12-16,VicRoads ,98,0,1940,Expense,Transport,"Car Insurance, Rego & Maintenance",DR
2023-12-16,CommSec Share Trading Gains ,100,0,1840,Income,Income,Investments,DR
2023-12-16, Fantastic Furniture ,37,0,1803,Expense,Household,"Furniture, Electronics & Homewares",DR
2023-12-16,Mathnasium ,84,0,1719,Expense,Personal,Education,DR
2023-12-16,Caltex Woolworths ,70,0,1649,Expense,Transport,Fuel,DR
2023-12-17,Caltex ,24,0,1625,Expense,Transport,Fuel,DR
2023-12-18,Scouts Australia ,94,0,1531,Expense,Leisure & Lifestyle,Hobbies,DR
2023-12-18,Chiropractor ,115,0,1416,Expense,Personal,Health & Medical,DR
2023-12-18,Bulk Billing Doctor ,10,0,1406,Expense,Personal,Health & Medical,DR
2023-12-19,Swim Australia ,125,0,1281,Expense,Personal,Fitness & Wellbeing,DR
2023-12-20,KU Children's Services ,109,0,1172,Expense,Personal,Children & Family,DR
2023-12-21,Zarraffa's Coffee ,57,0,1115,Expense,Leisure & Lifestyle,Restaurants & Cafes,DR
2023-12-21,Freedom Furniture ,86,0,1029,Expense,Household,Maintenance & Improvements,DR
2023-12-21,Freedom Furniture ,69,0,960,Expense,Household,Maintenance & Improvements,DR
2023-12-22,Disney+ ,73,0,887,Expense,Leisure & Lifestyle,"Tv, Music & Streaming",DR
2023-12-22,Massage Therapy Center ,47,0,840,Expense,Personal,Health & Medical,DR
2023-12-23,Toys 'R' Us ,42,0,798,Expense,Personal,CHildren & Family,DR
2023-12-24,Specsavers ,5,0,793,Expense,Personal,Health & Medical,DR
2023-12-24,Priceline Pharmacy ,71,0,722,Expense,Personal,Health & Medical,DR
2023-12-26,Beachside Caravan Park ,16,0,706,Expense,Leisure & Lifestyle,Holidays & Travel,DR
2023-12-27,Telstra ,34,0,672,Expense,Personal,Mobile Phone,DR
2023-12-27,Spotify ,13,0,659,Expense,Leisure & Lifestyle,"Tv, Music & Streaming",DR
2023-12-28,King Swim ,12,0,647,Expense,Personal,Fitness & Wellbeing,DR
2024-01-01,Monthly Income,0,6542,7189,Income,Income,Wages,CR
2024-01-02, Metricon ,551,0,6638,Expense,Household,Maintenance & Improvements,DR
2024-01-03,Kayo Sports ,293,0,6345,Expense,Leisure & Lifestyle,"Tv, Music & Streaming",DR
2024-01-04,Spotlight ,329,0,6016,Expense,Leisure & Lifestyle,Hobbies,DR
2024-01-05,Costco ,269,0,5747,Expense,Household,Groceries,DR
2024-01-06,Eau De Vie ,131,0,5616,Expense,Leisure & Lifestyle,Pubs & Bars,DR
2024-01-06,Bridgestone Select ,69,0,5547,Expense,Transport,"Car Insurance, Rego & Maintenance",DR
2024-01-07,Salary Deposit from Woolworths Group ,555,0,4992,Income,Income,Wages,DR
2024-01-07,Crown Perth ,194,0,4798,Expense,Leisure & Lifestyle,Pubs & Bars,DR
2024-01-07,The Rocks Bar and Pub ,52,0,4746,Expense,Leisure & Lifestyle,Pubs & Bars,DR
2024-01-08,Beachside Caravan Park ,198,0,4548,Expense,Leisure & Lifestyle,Holidays & Travel,DR
2024-01-08,Officeworks ,234,0,4314,Expense,Personal,Life Admin,DR
2024-01-09,Snap Fitness ,122,0,4192,Expense,Personal,Fitness & Wellbeing,DR
2024-01-09,Service NSW ,114,0,4078,Expense,Transport,"Car Insurance, Rego & Maintenance",DR
2024-01-10,EB Games ,367,0,3711,Expense,Leisure & Lifestyle,"Apps, Games & Software",DR
2024-01-11, Commonwealth Bank ,43,0,3668,Expense,Household,Rent & Mortgage,DR
2024-01-12,Domino’s Pizza ,221,0,3447,Expense,Leisure & Lifestyle,Takeaway,DR
2024-01-12,Tabcorp ,232,0,3215,Expense,Leisure & Lifestyle,Lottery & Gambling,DR
2024-01-13,Anytime Fitness ,33,0,3182,Expense,Personal,Fitness & Wellbeing,DR
2024-01-14,Grill'd ,63,0,3119,Expense,Leisure & Lifestyle,Takeaway,DR
2024-01-14,Sydney Water ,51,0,3068,Expense,Household,Utilities,DR
2024-01-15,Caltex Woolworths ,7,0,3061,Expense,Transport,Fuel,DR
2024-01-16,Stan ,68,0,2993,Expense,Leisure & Lifestyle,"Tv, Music & Streaming",DR
2024-01-17,Zarraffa's Coffee ,290,0,2703,Expense,Leisure & Lifestyle,Restaurants & Cafes,DR
2024-01-17,Beachfront Markets ,138,0,2565,Expense,Personal,Clothing & Accessories,DR
2024-01-17,Pizza Hut ,147,0,2418,Expense,Leisure & Lifestyle,Takeaway,DR
2024-01-17, Slater and Gordon Lawyers ,75,0,2343,Expense,Personal,Life Admin,DR
2024-01-17,Childcare Payments ,179,0,2164,Expense,Personal,Children & Family,DR
2024-01-17,EnergyAustralia ,27,0,2137,Expense,Household,Utilities,DR
2024-01-17,Taronga Zoo ,169,0,1968,Expense,Leisure & Lifestyle,Entertainment,DR
2024-01-18,Ballet Schools ,159,0,1809,Expense,Personal,Fitness & Wellbeing,DR
2024-01-18, National Bank ,120,0,1689,Expense,Personal,Fees & Charges,DR
2024-01-18,PayPal Transfer from Sale ,60,0,1629,Income,Income,Other Income,DR
2024-01-18,Ice Cream Parlour ,6,0,1623,Expense,Leisure & Lifestyle,Takeaway,DR
2024-01-19,Costco ,76,0,1547,Expense,Household,Groceries,DR
2024-01-19,The Victory Hotel ,107,0,1440,Expense,Leisure & Lifestyle,Pubs & Bars,DR
2024-01-19,TerryWhite Chemmart ,96,0,1344,Expense,Personal,Health & Medical,DR
2024-01-20,Le Creuset ,128,0,1216,Expense,Household,"Furniture, Electronics & Homewares",DR
2024-01-20,Westpac Dividend Deposit ,22,0,1194,Income,Income,Investments,DR
2024-01-20,Camp Australia ,90,0,1104,Expense,Leisure & Lifestyle,Hobbies,DR
2024-01-21,Ladbrokes ,6,0,1098,Expense,Leisure & Lifestyle,Lottery & Gambling,DR
2024-01-21,Sylvan Learning ,30,0,1068,Expense,Personal,Education,DR
2024-01-22,Specsavers ,35,0,1033,Expense,Personal,Health & Medical,DR
2024-01-22,Bulk Billing Doctor ,35,0,998,Expense,Personal,Health & Medical,DR
2024-01-23,The Coffee Club ,28,0,970,Expense,Leisure & Lifestyle,Restaurants & Cafes,DR
2024-01-23,City Beach ,76,0,894,Expense,Personal,Clothing & Accessories,DR
2024-01-24,Sunburn Swimwear ,18,0,876,Expense,Personal,Clothing & Accessories,DR
2024-01-24,Airbnb Host Income ,57,0,819,Income,Income,Other Income,DR
2024-01-24,Liquorland ,37,0,782,Expense,Leisure & Lifestyle,Alcohol,DR
2024-01-25,City Beach ,9,0,773,Expense,Personal,Clothing & Accessories,DR
2024-01-25,Harris Farm Markets ,18,0,755,Expense,Household,Groceries,DR
2024-01-26,Medicare Claim ,21,0,734,Expense,Personal,Health & Medical,DR
2024-01-27,Beachfront Markets ,23,0,711,Expense,Personal,Clothing & Accessories,DR
2024-01-27,The Sydney Morning Herald ,6,0,705,Expense,Personal,Education,DR
2024-01-27,Stand Up Paddleboard Rental ,7,0,698,Expense,Personal,Fitness & Wellbeing,DR
2024-01-28, Brisbane City Council ,52,0,646,Expense,Household,Rates & Insurance,DR
2024-01-28,The Athlete's Foot ,25,0,621,Expense,Personal,Clothing & Accessories,DR
2024-02-01,Monthly Income,0,6542,7163,Income,Income,Wages,CR
2024-02-02,Autobarn ,386,0,6777,Expense,Transport,"Car Insurance, Rego & Maintenance",DR
2024-02-02,Origin Energy ,430,0,6347,Expense,Household,Utilities,DR
2024-02-03,QBE Insurance Claim Payout ,5,0,6342,Income,Income,Other Income,DR
2024-02-03,Optometrist ,371,0,5971,Expense,Personal,Health & Medical,DR
2024-02-03,Zarraffa's Coffee ,162,0,5809,Expense,Leisure & Lifestyle,Restaurants & Cafes,DR
2024-02-03,Shell V Power,36,0,5773,Expense,Transport,Fuel,DR
2024-02-04,Uber ,263,0,5510,Expense,Transport,Taxies & Share Cars,DR
2024-02-04,Audible ,541,0,4969,Expense,Leisure & Lifestyle,"Tv, Music & Streaming",DR
2024-02-04,Beachside Yoga Classes ,329,0,4640,Expense,Personal,Fitness & Wellbeing,DR
2024-02-04,Grill’d ,198,0,4442,Expense,Leisure & Lifestyle,Takeaway,DR
2024-02-04,Chinatown Night Market ,133,0,4309,Expense,Leisure & Lifestyle,Pubs & Bars,DR
2024-02-05,Guzman y Gomez ,122,0,4187,Expense,Leisure & Lifestyle,Takeaway,DR
2024-02-06,Green Slip Insurance ,113,0,4074,Expense,Transport,"Car Insurance, Rego & Maintenance",DR
2024-02-06,Salary Deposit from Woolworths Group ,85,0,3989,Income,Income,Wages,DR
2024-02-06,Myer ,104,0,3885,Expense,Personal,Clothing & Accessories,DR
2024-02-06,Chemist Warehouse ,355,0,3530,Expense,Personal,Health & Medical,DR
2024-02-06,Kayo Sports ,69,0,3461,Expense,Leisure & Lifestyle,"Tv, Music & Streaming",DR
2024-02-07,School Locker ,144,0,3317,Expense,Personal,Children & Family,DR
2024-02-08,Supercheap Auto ,233,0,3084,Expense,Transport,"Car Insurance, Rego & Maintenance",DR
2024-02-09, National Bank ,77,0,3007,Expense,Personal,Fees & Charges,DR
2024-02-09,Endota Spa ,227,0,2780,Expense,Personal,Fitness & Wellbeing,DR
2024-02-10,Ice Cream Parlour ,89,0,2691,Expense,Leisure & Lifestyle,Takeaway,DR
2024-02-10,Ultra Tune ,143,0,2548,Expense,Transport,"Car Insurance, Rego & Maintenance",DR
2024-02-11,BWS ,84,0,2464,Expense,Leisure & Lifestyle,Alcohol,DR
2024-02-12, Ray White Real Estate ,214,0,2250,Expense,Personal,Life Admin,DR
2024-02-12,Music Academy ,14,0,2236,Expense,Leisure & Lifestyle,Hobbies,DR
2024-02-14,Chemist Warehouse ,218,0,2018,Expense,Personal,Health & Medical,DR
2024-02-16,Muffin Break ,156,0,1862,Expense,Leisure & Lifestyle,Restaurants & Cafes,DR
2024-02-16,Menulog ,137,0,1725,Expense,Leisure & Lifestyle,Takeaway,DR
2024-02-16,National Hearing Care ,33,0,1692,Expense,Personal,Health & Medical,DR
2024-02-17,The Australian ,15,0,1677,Expense,Personal,Education,DR
2024-02-17,Tennis Australia ,145,0,1532,Expense,Personal,Fitness & Wellbeing,DR
2024-02-17,Chinatown Night Market ,40,0,1492,Expense,Leisure & Lifestyle,Pubs & Bars,DR
2024-02-17,Petbarn ,142,0,1350,Expense,Household,Pets,DR
2024-02-17,Soccer Clubs ,14,0,1336,Expense,Personal,Fitness & Wellbeing,DR
2024-02-17,Apple Music ,132,0,1204,Expense,Leisure & Lifestyle,"Tv, Music & Streaming",DR
2024-02-17,Event Cinemas ,119,0,1085,Expense,Leisure & Lifestyle,Entertainment,DR
2024-02-18,Centrelink JobSeeker Payment ,93,0,992,Income,Income,Other Income,DR
2024-02-18,Jetts Fitness ,46,0,946,Expense,Personal,Fitness & Wellbeing,DR
2024-02-19, Rentokil ,78,0,868,Expense,Household,Maintenance & Improvements,DR
2024-02-19,Village Cinemas ,5,0,863,Expense,Leisure & Lifestyle,Entertainment,DR
2024-02-20,Billabong ,14,0,849,Expense,Personal,Clothing & Accessories,DR
2024-02-20,Centrelink JobSeeker Payment ,35,0,814,Income,Income,Other Income,DR
2024-02-20,AGL Energy ,5,0,809,Expense,Household,Utilities,DR
2024-02-21,Liquorland ,31,0,778,Expense,Leisure & Lifestyle,Alcohol,DR
2024-02-22,Karate for Kids ,72,0,706,Expense,Personal,Fitness & Wellbeing,DR
2024-02-22,Quay Restaurant ,42,0,664,Expense,Leisure & Lifestyle,Pubs & Bars,DR
2024-02-23, Jim's Mowing ,43,0,621,Expense,Household,Maintenance & Improvements,DR
2024-02-23,eBay Sales Proceeds ,11,0,610,Income,Income,Other Income,DR
2024-02-23,School Locker ,21,0,589,Expense,Personal,Children & Family,DR
2024-02-24,Surf Dive 'n Ski ,39,0,550,Expense,Personal,Clothing & Accessories,DR
2024-02-24, Rentokil ,47,0,503,Expense,Household,Maintenance & Improvements,DR
2024-02-25,Melbourne Central Lion Hotel ,50,0,453,Expense,Leisure & Lifestyle,Pubs & Bars,DR
2024-02-25,Binge ,35,0,418,Expense,Leisure & Lifestyle,"Tv, Music & Streaming",DR
2024-02-26,Freedom Furniture ,15,0,403,Expense,Household,Maintenance & Improvements,DR
2024-02-27,BrewDog ,23,0,380,Expense,Leisure & Lifestyle,Alcohol,DR
2024-02-28,Dan Murphy’s ,12,0,368,Expense,Leisure & Lifestyle,Alcohol,DR
2024-03-01,Monthly Income,0,6542,6910,Income,Income,Wages,CR
2024-03-02,Audible ,451,0,6459,Expense,Leisure & Lifestyle,"Tv, Music & Streaming",DR
2024-03-02,Melbourne Central Lion Hotel ,285,0,6174,Expense,Leisure & Lifestyle,Pubs & Bars,DR
2024-03-04,Interest Payment from Commonwealth Bank ,148,0,6026,Income,Income,Investments,DR
2024-03-05,Childcare Payments ,208,0,5818,Expense,Personal,Children & Family,DR
2024-03-06,Autobarn ,516,0,5302,Expense,Transport,"Car Insurance, Rego & Maintenance",DR
2024-03-06,Campion Education ,530,0,4772,Expense,Personal,Children & Family,DR
2024-03-06,Optometrist ,181,0,4591,Expense,Personal,Health & Medical,DR
2024-03-07,Coles ,415,0,4176,Expense,Household,Groceries,DR
2024-03-07,The Ivy ,408,0,3768,Expense,Leisure & Lifestyle,Pubs & Bars,DR
2024-03-07,Audible ,101,0,3667,Expense,Leisure & Lifestyle,"Tv, Music & Streaming",DR
2024-03-09,Zarraffa's Coffee ,228,0,3439,Expense,Leisure & Lifestyle,Restaurants & Cafes,DR
2024-03-09,Massage Therapy Center ,122,0,3317,Expense,Personal,Health & Medical,DR
2024-03-09,Rebel Sport ,121,0,3196,Expense,Personal,Fitness & Wellbeing,DR
2024-03-10,VetLove ,136,0,3060,Expense,Household,Pets,DR
2024-03-11, Jim's Mowing ,38,0,3022,Expense,Household,Maintenance & Improvements,DR
2024-03-12,Beachside Yoga Classes ,66,0,2956,Expense,Personal,Fitness & Wellbeing,DR
2024-03-14,Bulk Billing Doctor ,263,0,2693,Expense,Personal,Health & Medical,DR
2024-03-16,Rebel Sport ,230,0,2463,Expense,Personal,Fitness & Wellbeing,DR
2024-03-16,Car Wash Cafe ,180,0,2283,Expense,Transport,"Car Insurance, Rego & Maintenance",DR
2024-03-19,South East Water ,24,0,2259,Expense,Household,Utilities,DR
2024-03-19,Freedom Furniture ,212,0,2047,Expense,Household,Maintenance & Improvements,DR
2024-03-20,Culture Kings ,157,0,1890,Expense,Personal,Clothing & Accessories,DR
2024-03-20,Zone Bowling ,19,0,1871,Expense,Leisure & Lifestyle,Entertainment,DR
2024-03-22,TerryWhite Chemmart ,85,0,1786,Expense,Personal,Health & Medical,DR
2024-03-23,Zone Bowling ,44,0,1742,Expense,Leisure & Lifestyle,Entertainment,DR
2024-03-24,Liquorland ,113,0,1629,Expense,Leisure & Lifestyle,Alcohol,DR
2024-03-25,Audible ,76,0,1553,Expense,Leisure & Lifestyle,"Tv, Music & Streaming",DR
2024-03-26,G8 Education ,49,0,1504,Expense,Personal,Children & Family,DR
2024-03-27,Eau De Vie ,99,0,1405,Expense,Leisure & Lifestyle,Pubs & Bars,DR
2024-04-01,Monthly Income,0,6542,7947,Income,Income,Wages,CR
2024-04-02,Boost Juice Bars ,360,0,7587,Expense,Leisure & Lifestyle,Takeaway,DR
2024-04-03,Westpac Dividend Deposit ,745,0,6842,Income,Income,Investments,DR
2024-04-06,Supercheap Auto ,633,0,6209,Expense,Transport,"Car Insurance, Rego & Maintenance",DR
2024-04-07,AGL Energy ,44,0,6165,Expense,Household,Utilities,DR
2024-04-12,Beachside Caravan Park ,198,0,5967,Expense,Leisure & Lifestyle,Holidays & Travel,DR
2024-04-12,Repco ,538,0,5429,Expense,Transport,"Car Insurance, Rego & Maintenance",DR
2024-04-12,Hungry Jack’s ,149,0,5280,Expense,Leisure & Lifestyle,Takeaway,DR
2024-04-12,Fitness First ,22,0,5258,Expense,Personal,Fitness & Wellbeing,DR
2024-04-13,King Swim ,509,0,4749,Expense,Personal,Fitness & Wellbeing,DR
2024-04-13,Audible ,432,0,4317,Expense,Leisure & Lifestyle,"Tv, Music & Streaming",DR
2024-04-14,Payday Advance ,172,0,4145,Income,Income,Other Income,DR
2024-04-15,Cookie ,412,0,3733,Expense,Leisure & Lifestyle,Pubs & Bars,DR
2024-04-17,Kmart ,307,0,3426,Expense,Personal,Children & Family,DR
2024-04-19,Hobart Brewing Company ,283,0,3143,Expense,Leisure & Lifestyle,Pubs & Bars,DR
2024-04-19,Campion Education ,206,0,2937,Expense,Personal,Children & Family,DR
2024-04-21,Bridgestone Select ,121,0,2816,Expense,Transport,"Car Insurance, Rego & Maintenance",DR
2024-04-22,The Australian ,128,0,2688,Expense,Personal,Education,DR
2024-04-22,Surf Dive 'n Ski ,108,0,2580,Expense,Personal,Clothing & Accessories,DR
2024-04-23,Caltex ,238,0,2342,Expense,Transport,Fuel,DR
2024-04-24,Kmart ,137,0,2205,Expense,Personal,Children & Family,DR
2024-04-25, Ray White Real Estate ,36,0,2169,Expense,Personal,Life Admin,DR
2024-04-27,Rip Curl ,28,0,2141,Expense,Personal,Clothing & Accessories,DR
2024-04-28,Endota Spa ,194,0,1947,Expense,Personal,Fitness & Wellbeing,DR
2024-04-28,eBay Sales Proceeds ,91,0,1856,Income,Income,Other Income,DR
2024-04-28,Sea Kayak Tours ,72,0,1784,Expense,Leisure & Lifestyle,Holidays & Travel,DR
2024-05-01,Monthly Income,0,6542,8326,Income,Income,Wages,CR
2024-05-02,G8 Education ,301,0,8025,Expense,Personal,Children & Family,DR
2024-05-07,Menulog ,261,0,7764,Expense,Leisure & Lifestyle,Takeaway,DR
2024-05-08,Foxtel ,247,0,7517,Expense,Leisure & Lifestyle,"Tv, Music & Streaming",DR
2024-05-09,Event Cinemas ,719,0,6798,Expense,Leisure & Lifestyle,Entertainment,DR
2024-05-10, Brisbane City Council ,559,0,6239,Expense,Household,Rates & Insurance,DR
2024-05-11, Rentokil ,110,0,6129,Expense,Household,Maintenance & Improvements,DR
2024-05-15,Culture Kings ,389,0,5740,Expense,Personal,Clothing & Accessories,DR
2024-05-15,Culture Kings ,265,0,5475,Expense,Personal,Clothing & Accessories,DR
2024-05-17,Local Fish and Chips ,93,0,5382,Expense,Leisure & Lifestyle,Takeaway,DR
2024-05-18,IKEA ,374,0,5008,Expense,Household,Maintenance & Improvements,DR
2024-05-18,The Ivy ,168,0,4840,Expense,Leisure & Lifestyle,Pubs & Bars,DR
2024-05-19,King Swim ,278,0,4562,Expense,Personal,Fitness & Wellbeing,DR
2024-05-21, Ray White Real Estate ,40,0,4522,Expense,Personal,Life Admin,DR
2024-05-21,NRMA Roadside Assistance ,451,0,4071,Expense,Transport,"Car Insurance, Rego & Maintenance",DR
2024-05-23,Billabong ,194,0,3877,Expense,Personal,Clothing & Accessories,DR
2024-05-24,Palace Cinemas ,220,0,3657,Expense,Leisure & Lifestyle,Entertainment,DR
2024-05-24,Fernwood Fitness ,134,0,3523,Expense,Personal,Fitness & Wellbeing,DR
2024-05-24,Local Fish and Chips ,244,0,3279,Expense,Leisure & Lifestyle,Takeaway,DR
2024-05-25,ALDI ,214,0,3065,Expense,Household,Groceries,DR
2024-05-26,The Espy ,92,0,2973,Expense,Leisure & Lifestyle,Pubs & Bars,DR
2024-05-26,Endota Spa ,15,0,2958,Expense,Personal,Fitness & Wellbeing,DR
2024-06-01,Monthly Income,0,6542,9500,Income,Income,Wages,CR
2024-06-02,The Espy ,268,0,9232,Expense,Leisure & Lifestyle,Pubs & Bars,DR
2024-06-03,CommSec Share Trading Gains ,118,0,9114,Income,Income,Investments,DR
2024-06-03,Eat Street Northshore ,554,0,8560,Expense,Leisure & Lifestyle,Pubs & Bars,DR
2024-06-04,The Brisbane Hotel ,731,0,7829,Expense,Leisure & Lifestyle,Pubs & Bars,DR
2024-06-04,The Athlete's Foot ,691,0,7138,Expense,Personal,Clothing & Accessories,DR
2024-06-05, NSW Land Registry Services ,28,0,7110,Expense,Personal,Life Admin,DR
2024-06-05,Camp Australia ,240,0,6870,Expense,Leisure & Lifestyle,Hobbies,DR
2024-06-06,Bridgestone Select ,540,0,6330,Expense,Transport,"Car Insurance, Rego & Maintenance",DR
2024-06-06,McDonald’s ,215,0,6115,Expense,Leisure & Lifestyle,Takeaway,DR
2024-06-06,Massage Therapy Center ,223,0,5892,Expense,Personal,Health & Medical,DR
2024-06-07,Eat Street Northshore ,64,0,5828,Expense,Leisure & Lifestyle,Pubs & Bars,DR
2024-06-07,Beachfront Markets ,433,0,5395,Expense,Personal,Clothing & Accessories,DR
2024-06-08,Telstra ,233,0,5162,Expense,Personal,Mobile Phone,DR
2024-06-10,Palace Cinemas ,97,0,5065,Expense,Leisure & Lifestyle,Entertainment,DR
2024-06-10,Zone Bowling ,137,0,4928,Expense,Leisure & Lifestyle,Entertainment,DR
2024-06-12,Campion Education ,362,0,4566,Expense,Personal,Children & Family,DR
2024-06-12,Specsavers ,297,0,4269,Expense,Personal,Health & Medical,DR
2024-06-13,Scouts Australia ,87,0,4182,Expense,Leisure & Lifestyle,Hobbies,DR
2024-06-13,AGL Energy ,309,0,3873,Expense,Household,Utilities,DR
2024-06-13,South East Water ,215,0,3658,Expense,Household,Utilities,DR
2024-06-14,BWS ,13,0,3645,Expense,Leisure & Lifestyle,Alcohol,DR
2024-06-15,Fitness First ,270,0,3375,Expense,Personal,Fitness & Wellbeing,DR
2024-06-16,Local Hospital ,176,0,3199,Expense,Personal,Health & Medical,DR
2024-06-17,Coles ,270,0,2929,Expense,Household,Groceries,DR
2024-06-17,Flight Centre ,182,0,2747,Expense,Leisure & Lifestyle,Holidays & Travel,DR
2024-06-17,Sunnybank Hotel ,191,0,2556,Expense,Leisure & Lifestyle,Pubs & Bars,DR
2024-06-17,Mathnasium ,27,0,2529,Expense,Personal,Education,DR
2024-06-18,TerryWhite Chemmart ,156,0,2373,Expense,Personal,Health & Medical,DR
2024-06-18, NRMA Insurance ,164,0,2209,Expense,Household,Rates & Insurance,DR
2024-06-19,The Iconic ,117,0,2092,Expense,Personal,Clothing & Accessories,DR
2024-06-19,Chemist Warehouse ,183,0,1909,Expense,Personal,Health & Medical,DR
2024-06-20, Slater and Gordon Lawyers ,110,0,1799,Expense,Personal,Life Admin,DR
2024-06-20,Foxtel ,136,0,1663,Expense,Leisure & Lifestyle,"Tv, Music & Streaming",DR
2024-06-21,Bunnings Warehouse ,23,0,1640,Expense,Household,Maintenance & Improvements,DR
2024-06-23,Apple Music ,140,0,1500,Expense,Leisure & Lifestyle,"Tv, Music & Streaming",DR
2024-06-23,Who Gives A Crap ,146,0,1354,Expense,Household,Groceries,DR
2024-06-24,Foxtel ,102,0,1252,Expense,Leisure & Lifestyle,"Tv, Music & Streaming",DR
2024-06-24,Vodafone Prepaid ,44,0,1208,Expense,Personal,Mobile Phone,DR
2024-06-24,Guardian Childcare & Education ,20,0,1188,Expense,Personal,Children & Family,DR
2024-06-25,Pathology Lab ,115,0,1073,Expense,Personal,Health & Medical,DR
2024-06-25,The Brisbane Hotel ,103,0,970,Expense,Leisure & Lifestyle,Pubs & Bars,DR
2024-06-25,Netflix ,36,0,934,Expense,Leisure & Lifestyle,"Tv, Music & Streaming",DR
2024-06-28,F45 Training ,59,0,875,Expense,Personal,Fitness & Wellbeing,DR
2024-07-01,Monthly Income,0,6542,7417,Income,Income,Wages,CR
2024-07-02,The Baxter Inn ,240,0,7177,Expense,Leisure & Lifestyle,Pubs & Bars,DR
2024-07-02,The Iconic ,479,0,6698,Expense,Personal,Clothing & Accessories,DR
2024-07-02,Soccer Clubs ,643,0,6055,Expense,Personal,Fitness & Wellbeing,DR
2024-07-03, EnergyAustralia ,543,0,5512,Expense,Household,Utilities,DR
2024-07-03,Car Wash Cafe ,281,0,5231,Expense,Transport,"Car Insurance, Rego & Maintenance",DR
2024-07-03,Health Food Store ,254,0,4977,Expense,Personal,Fitness & Wellbeing,DR
2024-07-03,Le Creuset ,359,0,4618,Expense,Household,"Furniture, Electronics & Homewares",DR
2024-07-04,Origin Energy ,416,0,4202,Expense,Household,Utilities,DR
2024-07-04,Coles Express ,353,0,3849,Expense,Transport,Fuel,DR
2024-07-04,Audible ,384,0,3465,Expense,Leisure & Lifestyle,"Tv, Music & Streaming",DR
2024-07-04,VicRoads ,196,0,3269,Expense,Transport,"Car Insurance, Rego & Maintenance",DR
2024-07-05,ATO Tax Refund ,276,0,2993,Income,Income,Other Income,DR
2024-07-07,Tabcorp ,284,0,2709,Expense,Leisure & Lifestyle,Lottery & Gambling,DR
2024-07-08,Myer ,256,0,2453,Expense,Personal,Clothing & Accessories,DR
2024-07-10,School Locker ,219,0,2234,Expense,Personal,Children & Family,DR
2024-07-11,Guardian Childcare & Education ,75,0,2159,Expense,Personal,Children & Family,DR
2024-07-11,Greencross Vets ,19,0,2140,Expense,Household,Pets,DR
2024-07-11,Kmart Tyre & Auto Service ,45,0,2095,Expense,Transport,"Car Insurance, Rego & Maintenance",DR
2024-07-12,CommSec Share Trading Gains ,201,0,1894,Income,Income,Investments,DR
2024-07-12,Microsoft 365 ,37,0,1857,Expense,Personal,Education,DR
2024-07-12, Jim’s Building Inspections ,139,0,1718,Expense,Household,Maintenance & Improvements,DR
2024-07-13,Billabong ,6,0,1712,Expense,Personal,Clothing & Accessories,DR
2024-07-13,Airbnb Host Income ,18,0,1694,Income,Income,Other Income,DR
2024-07-13,Local Hospital ,137,0,1557,Expense,Personal,Health & Medical,DR
2024-07-14,Coles Express ,101,0,1456,Expense,Transport,Fuel,DR
2024-07-14,Beacon Lighting ,39,0,1417,Expense,Household,Maintenance & Improvements,DR
2024-07-14,Rental Deposit from RealEstate.com.au ,52,0,1365,Income,Income,Other Income,DR
2024-07-14,Surfstitch ,13,0,1352,Expense,Personal,Clothing & Accessories,DR
2024-07-16,Sydney Water ,81,0,1271,Expense,Household,Utilities,DR
2024-07-16,Optus ,49,0,1222,Expense,Personal,Mobile Phone,DR
2024-07-17,Gardening Australia ,35,0,1187,Expense,Household,Maintenance & Improvements,DR
2024-07-17,BP ,15,0,1172,Expense,Transport,Fuel,DR
2024-07-18,Acupuncture Clinic ,92,0,1080,Expense,Personal,Health & Medical,DR
2024-07-18,Hungry Jack’s ,61,0,1019,Expense,Leisure & Lifestyle,Takeaway,DR
2024-07-18,Grill’d ,65,0,954,Expense,Leisure & Lifestyle,Takeaway,DR
2024-07-20,Le Creuset ,9,0,945,Expense,Household,"Furniture, Electronics & Homewares",DR
2024-07-23,Centrelink JobSeeker Payment ,38,0,907,Income,Income,Other Income,DR
2024-07-23,Chemist Warehouse ,90,0,817,Expense,Personal,Health & Medical,DR
2024-07-23,BrewDog ,79,0,738,Expense,Leisure & Lifestyle,Alcohol,DR
2024-07-24,Barbeques Galore ,59,0,679,Expense,Household,"Furniture, Electronics & Homewares",DR
2024-07-25,Sea Kayak Tours ,65,0,614,Expense,Leisure & Lifestyle,Holidays & Travel,DR
2024-07-27,NRMA Roadside Assistance ,13,0,601,Expense,Transport,"Car Insurance, Rego & Maintenance",DR
2024-07-28,The Ivy ,50,0,551,Expense,Leisure & Lifestyle,Pubs & Bars,DR
2024-08-01,Monthly Income,0,6542,7093,Income,Income,Wages,CR
2024-08-02,EnergyAustralia ,72,0,7021,Expense,Household,Utilities,DR
2024-08-03,JAX Tyres ,658,0,6363,Expense,Transport,"Car Insurance, Rego & Maintenance",DR
2024-08-05,VicRoads ,634,0,5729,Expense,Transport,"Car Insurance, Rego & Maintenance",DR
2024-08-09,Sylvan Learning ,254,0,5475,Expense,Personal,Education,DR
2024-08-10,Jetts Fitness ,547,0,4928,Expense,Personal,Fitness & Wellbeing,DR
2024-08-11,Music Academy ,486,0,4442,Expense,Leisure & Lifestyle,Hobbies,DR
2024-08-12,Caltex Woolworths ,409,0,4033,Expense,Transport,Fuel,DR
2024-08-12,Karate for Kids ,297,0,3736,Expense,Personal,Fitness & Wellbeing,DR
2024-08-12,Witchery ,365,0,3371,Expense,Personal,Clothing & Accessories,DR
2024-08-14,Apple Music ,184,0,3187,Expense,Leisure & Lifestyle,"Tv, Music & Streaming",DR
2024-08-14,Westpac Dividend Deposit ,100,0,3087,Income,Income,Investments,DR
2024-08-20, BSA Ltd ,89,0,2998,Expense,Household,Maintenance & Improvements,DR
2024-08-20,Café Nero ,95,0,2903,Expense,Leisure & Lifestyle,Restaurants & Cafes,DR
2024-08-20,Sydney Water ,229,0,2674,Expense,Household,Utilities,DR
2024-08-21,Interest Payment from Commonwealth Bank ,233,0,2441,Income,Income,Investments,DR
2024-08-21,David Jones ,167,0,2274,Expense,Personal,Clothing & Accessories,DR
2024-08-21,Chinatown Night Market ,165,0,2109,Expense,Leisure & Lifestyle,Pubs & Bars,DR
2024-08-22,Surf Dive 'n Ski ,85,0,2024,Expense,Personal,Clothing & Accessories,DR
2024-08-22,Childcare Payments ,128,0,1896,Expense,Personal,Children & Family,DR
2024-08-23,Netflix ,85,0,1811,Expense,Leisure & Lifestyle,"Tv, Music & Streaming",DR
2024-08-25,Chinatown Night Market ,107,0,1704,Expense,Leisure & Lifestyle,Pubs & Bars,DR
2024-08-26,The Iconic ,37,0,1667,Expense,Personal,Clothing & Accessories,DR
2024-08-28,Toys 'R' Us ,87,0,1580,Expense,Personal,CHildren & Family,DR
2024-09-01,Monthly Income,0,6542,8122,Income,Income,Wages,CR
2024-09-02,Catholic Education Office ,126,0,7996,Expense,Personal,Education,DR
2024-09-02,VicRoads ,733,0,7263,Expense,Transport,"Car Insurance, Rego & Maintenance",DR
2024-09-03,Chinatown Night Market ,284,0,6979,Expense,Leisure & Lifestyle,Pubs & Bars,DR
2024-09-04, Slater and Gordon Lawyers ,420,0,6559,Expense,Personal,Life Admin,DR
2024-09-05,Greencross Vets ,243,0,6316,Expense,Household,Pets,DR
2024-09-06,Adobe Creative Cloud ,130,0,6186,Expense,Leisure & Lifestyle,Hobbies,DR
2024-09-07,Target ,249,0,5937,Expense,Personal,Clothing & Accessories,DR
2024-09-07,QBE Insurance Claim Payout ,340,0,5597,Income,Income,Other Income,DR
2024-09-08, Metricon ,445,0,5152,Expense,Household,Maintenance & Improvements,DR
2024-09-09,Upwork Freelancer Payment ,95,0,5057,Income,Income,Other Income,DR
2024-09-10,Adobe Creative Cloud ,187,0,4870,Expense,Leisure & Lifestyle,Hobbies,DR
2024-09-11,SEQTA ,258,0,4612,Expense,Personal,Education,DR
2024-09-12,Eat Street Northshore ,258,0,4354,Expense,Leisure & Lifestyle,Pubs & Bars,DR
2024-09-12,Specsavers ,87,0,4267,Expense,Personal,Health & Medical,DR
2024-09-12,Optometrist ,281,0,3986,Expense,Personal,Health & Medical,DR
2024-09-13,King Swim ,232,0,3754,Expense,Personal,Fitness & Wellbeing,DR
2024-09-13,EB Games ,270,0,3484,Expense,Leisure & Lifestyle,"Apps, Games & Software",DR
2024-09-13,Local Fish and Chips ,117,0,3367,Expense,Leisure & Lifestyle,Takeaway,DR
2024-09-14,Disney+ ,183,0,3184,Expense,Leisure & Lifestyle,"Tv, Music & Streaming",DR
2024-09-14,The Body Shop ,260,0,2924,Expense,Personal,Hair & Beauty,DR
2024-09-17,Rental Deposit from RealEstate.com.au ,232,0,2692,Income,Income,Other Income,DR
2024-09-17,Guardian Childcare & Education ,82,0,2610,Expense,Personal,Children & Family,DR
2024-09-17,Taronga Zoo ,253,0,2357,Expense,Leisure & Lifestyle,Entertainment,DR
2024-09-17,Karate for Kids ,74,0,2283,Expense,Personal,Fitness & Wellbeing,DR
2024-09-17,The Rocks Bar and Pub ,70,0,2213,Expense,Leisure & Lifestyle,Pubs & Bars,DR
2024-09-18,IKEA ,79,0,2134,Expense,Household,Maintenance & Improvements,DR
2024-09-20, Metricon ,62,0,2072,Expense,Household,Maintenance & Improvements,DR
2024-09-21,Caltex ,5,0,2067,Expense,Transport,Fuel,DR
2024-09-22,Beach Café ,71,0,1996,Expense,Leisure & Lifestyle,Restaurants & Cafes,DR
2024-09-22,Coles Express ,195,0,1801,Expense,Transport,Fuel,DR
2024-09-22,Physiotherapy Clinic ,93,0,1708,Expense,Personal,Health & Medical,DR
2024-09-22,ATO Tax Refund ,72,0,1636,Income,Income,Other Income,DR
2024-09-22,Sea Kayak Tours ,17,0,1619,Expense,Leisure & Lifestyle,Holidays & Travel,DR
2024-09-22,Rebel Sport ,117,0,1502,Expense,Personal,Fitness & Wellbeing,DR
2024-09-23,Harvey Norman ,20,0,1482,Expense,Household,"Furniture, Electronics & Homewares",DR
2024-09-23,Specsavers ,5,0,1477,Expense,Personal,Health & Medical,DR
2024-09-24,AustralianSuper Pension ,116,0,1361,Income,Income,Other Income,DR
2024-09-24,Adairs ,72,0,1289,Expense,Household,"Furniture, Electronics & Homewares",DR
2024-09-25,Ice Cream Parlour ,44,0,1245,Expense,Leisure & Lifestyle,Takeaway,DR
2024-09-26,Optus ,125,0,1120,Expense,Personal,Mobile Phone,DR
2024-09-26, Metricon ,74,0,1046,Expense,Household,Maintenance & Improvements,DR
2024-09-27,Boost Juice Bars ,11,0,1035,Expense,Leisure & Lifestyle,Takeaway,DR
2024-09-28,Village Cinemas ,7,0,1028,Expense,Leisure & Lifestyle,Entertainment,DR
2024-09-28,David Jones ,51,0,977,Expense,Personal,Clothing & Accessories,DR
2024-10-01,Monthly Income,0,6542,7519,Income,Income,Wages,CR
2024-10-02,Mathnasium ,443,0,7076,Expense,Personal,Education,DR
2024-10-02,Westpac Dividend Deposit ,490,0,6586,Income,Income,Investments,DR
2024-10-02,Gold's Gym ,518,0,6068,Expense,Personal,Fitness & Wellbeing,DR
2024-10-02,T2 Tea ,590,0,5478,Expense,Personal,Fitness & Wellbeing,DR
2024-10-03,NRMA Roadside Assistance ,61,0,5417,Expense,Transport,"Car Insurance, Rego & Maintenance",DR
2024-10-03,SEQTA ,239,0,5178,Expense,Personal,Education,DR
2024-10-05,David Jones ,123,0,5055,Expense,Personal,Clothing & Accessories,DR
2024-10-07,Centrelink JobSeeker Payment ,465,0,4590,Income,Income,Other Income,DR
2024-10-07,The Iconic ,242,0,4348,Expense,Personal,Clothing & Accessories,DR
2024-10-08,Endota Spa ,424,0,3924,Expense,Personal,Fitness & Wellbeing,DR
2024-10-10,Centrelink JobSeeker Payment ,350,0,3574,Income,Income,Other Income,DR
2024-10-12,Payday Advance ,257,0,3317,Income,Income,Other Income,DR
2024-10-12,BrewDog ,97,0,3220,Expense,Leisure & Lifestyle,Alcohol,DR
2024-10-16,ALDI ,317,0,2903,Expense,Household,Groceries,DR
2024-10-18,Goodstart Early Learning ,113,0,2790,Expense,Personal,Children & Family,DR
2024-10-18,Airbnb Host Income ,146,0,2644,Income,Income,Other Income,DR
2024-10-19,Greencross Vets ,137,0,2507,Expense,Household,Pets,DR
2024-10-22,Service NSW ,146,0,2361,Expense,Transport,"Car Insurance, Rego & Maintenance",DR
2024-10-22,Spotlight ,79,0,2282,Expense,Leisure & Lifestyle,Hobbies,DR
2024-10-22,Grill'd ,127,0,2155,Expense,Leisure & Lifestyle,Takeaway,DR
2024-10-23,Beachside Caravan Park ,24,0,2131,Expense,Leisure & Lifestyle,Holidays & Travel,DR
2024-10-24,EB Games ,87,0,2044,Expense,Leisure & Lifestyle,"Apps, Games & Software",DR
2024-10-25,Domino’s Pizza ,16,0,2028,Expense,Leisure & Lifestyle,Takeaway,DR
2024-10-25,South East Water ,54,0,1974,Expense,Household,Utilities,DR
2024-10-25,QBE Insurance Claim Payout ,61,0,1913,Income,Income,Other Income,DR
2024-10-26,Green Slip Insurance ,185,0,1728,Expense,Transport,"Car Insurance, Rego & Maintenance",DR
2024-10-27,Timezone ,98,0,1630,Expense,Leisure & Lifestyle,Entertainment,DR
2024-10-27,Amazon Prime ,19,0,1611,Expense,Leisure & Lifestyle,"Tv, Music & Streaming",DR
2024-10-27,Foxtel ,15,0,1596,Expense,Leisure & Lifestyle,"Tv, Music & Streaming",DR
2024-11-01,Monthly Income,0,6542,8138,Income,Income,Wages,CR
2024-11-02,Officeworks ,809,0,7329,Expense,Personal,Life Admin,DR
2024-11-02,Foxtel ,256,0,7073,Expense,Leisure & Lifestyle,"Tv, Music & Streaming",DR
2024-11-03,Supercheap Auto ,245,0,6828,Expense,Transport,"Car Insurance, Rego & Maintenance",DR
2024-11-03,Adairs ,548,0,6280,Expense,Household,"Furniture, Electronics & Homewares",DR
2024-11-03,BWS ,115,0,6165,Expense,Leisure & Lifestyle,Alcohol,DR
2024-11-03,Fitness First ,611,0,5554,Expense,Personal,Fitness & Wellbeing,DR
2024-11-04,Medicare Claim ,65,0,5489,Expense,Personal,Health & Medical,DR
2024-11-05,Optus ,459,0,5030,Expense,Personal,Mobile Phone,DR
2024-11-05,School Locker ,459,0,4571,Expense,Personal,Children & Family,DR
2024-11-05,Zarraffa's Coffee ,22,0,4549,Expense,Leisure & Lifestyle,Restaurants & Cafes,DR
2024-11-05,The Rocks Bar and Pub ,252,0,4297,Expense,Leisure & Lifestyle,Pubs & Bars,DR
2024-11-05,Montessori Schools ,320,0,3977,Expense,Personal,Education,DR
2024-11-06, Rentokil ,335,0,3642,Expense,Household,Maintenance & Improvements,DR
2024-11-06,Stand Up Paddleboard Rental ,25,0,3617,Expense,Personal,Fitness & Wellbeing,DR
2024-11-06,Adobe Creative Cloud ,234,0,3383,Expense,Leisure & Lifestyle,Hobbies,DR
2024-11-06,Kumon ,218,0,3165,Expense,Personal,Education,DR
2024-11-06,Jetts Fitness ,193,0,2972,Expense,Personal,Fitness & Wellbeing,DR
2024-11-08,Café Nero ,228,0,2744,Expense,Leisure & Lifestyle,Restaurants & Cafes,DR
2024-11-08,Stand Up Paddleboard Rental ,234,0,2510,Expense,Personal,Fitness & Wellbeing,DR
2024-11-09, National Bank ,230,0,2280,Expense,Personal,Fees & Charges,DR
2024-11-11,National Hearing Care ,146,0,2134,Expense,Personal,Health & Medical,DR
2024-11-14,Palace Cinemas ,64,0,2070,Expense,Leisure & Lifestyle,Entertainment,DR
2024-11-15,Platypus Shoes ,12,0,2058,Expense,Personal,Clothing & Accessories,DR
2024-11-15,Liquorland ,117,0,1941,Expense,Leisure & Lifestyle,Alcohol,DR
2024-11-15,Guzman y Gomez ,51,0,1890,Expense,Leisure & Lifestyle,Takeaway,DR
2024-11-15,Lorna Jane ,38,0,1852,Expense,Personal,Clothing & Accessories,DR
2024-11-16, Slater and Gordon Lawyers ,33,0,1819,Expense,Personal,Life Admin,DR
2024-11-16,Rooftop Bar ,99,0,1720,Expense,Leisure & Lifestyle,Pubs & Bars,DR
2024-11-16,Queensland Urban Utilities ,171,0,1549,Expense,Household,Utilities,DR
2024-11-18,Café Nero ,73,0,1476,Expense,Leisure & Lifestyle,Restaurants & Cafes,DR
2024-11-19,Harris Farm Markets ,145,0,1331,Expense,Household,Groceries,DR
2024-11-19,Ladbrokes ,102,0,1229,Expense,Leisure & Lifestyle,Lottery & Gambling,DR
2024-11-20,Massage Therapy Center ,117,0,1112,Expense,Personal,Health & Medical,DR
2024-11-21,Chinatown Night Market ,11,0,1101,Expense,Leisure & Lifestyle,Pubs & Bars,DR
2024-11-21,F45 Training ,21,0,1080,Expense,Personal,Fitness & Wellbeing,DR
2024-11-22,Apple Music ,82,0,998,Expense,Leisure & Lifestyle,"Tv, Music & Streaming",DR
2024-11-22,Guardian Childcare & Education ,48,0,950,Expense,Personal,Children & Family,DR
2024-11-23,Grill’d ,24,0,926,Expense,Leisure & Lifestyle,Takeaway,DR
2024-11-23,Flight Centre ,36,0,890,Expense,Leisure & Lifestyle,Holidays & Travel,DR
2024-11-25,Greencross Vets ,29,0,861,Expense,Household,Pets,DR
2024-11-25,Melbourne Central Lion Hotel ,44,0,817,Expense,Leisure & Lifestyle,Pubs & Bars,DR
2024-11-28,Montessori Schools ,22,0,795,Expense,Personal,Education,DR
2024-11-28,Rebel Sport ,7,0,788,Expense,Personal,Fitness & Wellbeing,DR
2024-12-01,Monthly Income,0,6542,7330,Income,Income,Wages,CR
2024-12-02,Karate for Kids ,361,0,6969,Expense,Personal,Fitness & Wellbeing,DR
2024-12-03,Witchery ,267,0,6702,Expense,Personal,Clothing & Accessories,DR
2024-12-06,The Espy ,81,0,6621,Expense,Leisure & Lifestyle,Pubs & Bars,DR
2024-12-06,Goodstart Early Learning ,334,0,6287,Expense,Personal,Children & Family,DR
2024-12-09,Health Food Store ,586,0,5701,Expense,Personal,Fitness & Wellbeing,DR
2024-12-10,Ballet Schools ,201,0,5500,Expense,Personal,Fitness & Wellbeing,DR
2024-12-11,Flight Centre ,479,0,5021,Expense,Leisure & Lifestyle,Holidays & Travel,DR
2024-12-11,Beachside Yoga Classes ,159,0,4862,Expense,Personal,Fitness & Wellbeing,DR
2024-12-11,Decathlon ,193,0,4669,Expense,Personal,Fitness & Wellbeing,DR
2024-12-11,CommSec Share Trading Gains ,256,0,4413,Income,Income,Investments,DR
2024-12-13,Stan ,88,0,4325,Expense,Leisure & Lifestyle,"Tv, Music & Streaming",DR
2024-12-13,Who Gives A Crap ,331,0,3994,Expense,Household,Groceries,DR
2024-12-13,Fernwood Fitness ,189,0,3805,Expense,Personal,Fitness & Wellbeing,DR
2024-12-14,Beachside Yoga Classes ,112,0,3693,Expense,Personal,Fitness & Wellbeing,DR
2024-12-15,Jetts Fitness ,270,0,3423,Expense,Personal,Fitness & Wellbeing,DR
2024-12-15,The Victory Hotel ,20,0,3403,Expense,Leisure & Lifestyle,Pubs & Bars,DR
2024-12-16,Kumon ,216,0,3187,Expense,Personal,Education,DR
2024-12-18,Binge ,110,0,3077,Expense,Leisure & Lifestyle,"Tv, Music & Streaming",DR
2024-12-19,Chemist Warehouse ,124,0,2953,Expense,Personal,Health & Medical,DR
2024-12-20,Stand Up Paddleboard Rental ,76,0,2877,Expense,Personal,Fitness & Wellbeing,DR
2024-12-22,Adobe Creative Cloud ,73,0,2804,Expense,Leisure & Lifestyle,Hobbies,DR
2024-12-25,Catholic Education Office ,158,0,2646,Expense,Personal,Education,DR
2024-12-25, Rentokil ,160,0,2486,Expense,Household,Maintenance & Improvements,DR
2025-01-01,Monthly Income,0,6542,9028,Income,Income,Wages,CR
2025-01-02,eBay Sales Proceeds ,712,0,8316,Income,Income,Other Income,DR
2025-01-02, Slater and Gordon Lawyers ,160,0,8156,Expense,Personal,Life Admin,DR
2025-01-02,Ultra Tune ,352,0,7804,Expense,Transport,"Car Insurance, Rego & Maintenance",DR
2025-01-03,Myer ,158,0,7646,Expense,Personal,Clothing & Accessories,DR
2025-01-04,Sea Life Aquarium ,383,0,7263,Expense,Leisure & Lifestyle,Entertainment,DR
2025-01-04,Centrelink JobSeeker Payment ,158,0,7105,Income,Income,Other Income,DR
2025-01-05,Binge ,27,0,7078,Expense,Leisure & Lifestyle,"Tv, Music & Streaming",DR
2025-01-05,Car Wash Cafe ,360,0,6718,Expense,Transport,"Car Insurance, Rego & Maintenance",DR
2025-01-06,The Victory Hotel ,61,0,6657,Expense,Leisure & Lifestyle,Pubs & Bars,DR
2025-01-07,Surfstitch ,542,0,6115,Expense,Personal,Clothing & Accessories,DR
2025-01-08,Beach Café ,382,0,5733,Expense,Leisure & Lifestyle,Restaurants & Cafes,DR
2025-01-08,EB Games ,134,0,5599,Expense,Leisure & Lifestyle,"Apps, Games & Software",DR
2025-01-08,The Rocks Bar and Pub ,178,0,5421,Expense,Leisure & Lifestyle,Pubs & Bars,DR
2025-01-09,Guardian Childcare & Education ,451,0,4970,Expense,Personal,Children & Family,DR
2025-01-10, Brisbane City Council ,407,0,4563,Expense,Household,Rates & Insurance,DR
2025-01-10,Woolworths ,121,0,4442,Expense,Household,Groceries,DR
2025-01-11,Apple Store ,23,0,4419,Expense,Leisure & Lifestyle,Electronics,DR
2025-01-11,Child Support Agency Deposit ,143,0,4276,Income,Income,Other Income,DR
2025-01-11, Slater and Gordon Lawyers ,253,0,4023,Expense,Personal,Life Admin,DR
2025-01-12,Endota Spa ,208,0,3815,Expense,Personal,Fitness & Wellbeing,DR
2025-01-14,VicRoads ,181,0,3634,Expense,Transport,"Car Insurance, Rego & Maintenance",DR
2025-01-14,Kmart Tyre & Auto Service ,363,0,3271,Expense,Transport,"Car Insurance, Rego & Maintenance",DR
2025-01-15,Boost Juice Bars ,128,0,3143,Expense,Leisure & Lifestyle,Takeaway,DR
2025-01-15,ATO Tax Refund ,41,0,3102,Income,Income,Other Income,DR
2025-01-16,Event Cinemas ,130,0,2972,Expense,Leisure & Lifestyle,Entertainment,DR
2025-01-17,Dental Clinic ,219,0,2753,Expense,Personal,Health & Medical,DR
2025-01-17,T2 Tea ,192,0,2561,Expense,Personal,Fitness & Wellbeing,DR
2025-01-17,AustralianSuper Pension ,197,0,2364,Income,Income,Other Income,DR
2025-01-18,Officeworks ,190,0,2174,Expense,Personal,Life Admin,DR
2025-01-18,Amazon Prime ,183,0,1991,Expense,Leisure & Lifestyle,"Tv, Music & Streaming",DR
2025-01-18,Domino’s Pizza ,190,0,1801,Expense,Leisure & Lifestyle,Takeaway,DR
2025-01-18,The Espy ,98,0,1703,Expense,Leisure & Lifestyle,Pubs & Bars,DR
2025-01-19,Optus ,41,0,1662,Expense,Personal,Mobile Phone,DR
2025-01-20,Stand Up Paddleboard Rental ,160,0,1502,Expense,Personal,Fitness & Wellbeing,DR
2025-01-21, EnergyAustralia ,91,0,1411,Expense,Household,Utilities,DR
2025-01-21,The Coffee Club ,59,0,1352,Expense,Leisure & Lifestyle,Restaurants & Cafes,DR
2025-01-22,Jetts Fitness ,118,0,1234,Expense,Personal,Fitness & Wellbeing,DR
2025-01-22,OfficeMax ,67,0,1167,Expense,Personal,Life Admin,DR
2025-01-22,Guardian Childcare & Education ,26,0,1141,Expense,Personal,Children & Family,DR
2025-01-23,MyCar Tyre & Auto ,100,0,1041,Expense,Transport,"Car Insurance, Rego & Maintenance",DR
2025-01-24,Big W ,29,0,1012,Expense,Personal,Children & Family,DR
2025-01-25,City Beach ,79,0,933,Expense,Personal,Clothing & Accessories,DR
2025-01-27,VicRoads ,28,0,905,Expense,Transport,"Car Insurance, Rego & Maintenance",DR
2025-01-27,Bunnings Warehouse ,36,0,869,Expense,Household,Maintenance & Improvements,DR
2025-01-28,Guzman y Gomez ,16,0,853,Expense,Leisure & Lifestyle,Takeaway,DR
2025-01-28,AustralianSuper Pension ,59,0,794,Income,Income,Other Income,DR
2025-01-28,Physiotherapy Clinic ,62,0,732,Expense,Personal,Health & Medical,DR
2025-01-28,Stand Up Paddleboard Rental ,47,0,685,Expense,Personal,Fitness & Wellbeing,DR
2025-02-01,Monthly Income,0,6542,7227,Income,Income,Wages,CR
2025-02-02,Foxtel ,91,0,7136,Expense,Leisure & Lifestyle,"Tv, Music & Streaming",DR
2025-02-03,Event Cinemas ,330,0,6806,Expense,Leisure & Lifestyle,Entertainment,DR
2025-02-03,VetLove ,352,0,6454,Expense,Household,Pets,DR
2025-02-03,South East Water ,568,0,5886,Expense,Household,Utilities,DR
2025-02-03,Myer ,121,0,5765,Expense,Personal,Clothing & Accessories,DR
2025-02-04,Beachside Caravan Park ,158,0,5607,Expense,Leisure & Lifestyle,Holidays & Travel,DR
2025-02-04,AMF Bowling ,284,0,5323,Expense,Leisure & Lifestyle,Entertainment,DR
2025-02-04,OfficeMax ,27,0,5296,Expense,Personal,Life Admin,DR
2025-02-04, Slater and Gordon Lawyers ,37,0,5259,Expense,Personal,Life Admin,DR
2025-02-05,Quay Restaurant ,386,0,4873,Expense,Leisure & Lifestyle,Pubs & Bars,DR
2025-02-05,National Hearing Care ,451,0,4422,Expense,Personal,Health & Medical,DR
2025-02-05,Budget Direct Car Insurance ,220,0,4202,Expense,Transport,"Car Insurance, Rego & Maintenance",DR
2025-02-06,Soccer Clubs ,264,0,3938,Expense,Personal,Fitness & Wellbeing,DR
2025-02-07,Café Nero ,26,0,3912,Expense,Leisure & Lifestyle,Restaurants & Cafes,DR
2025-02-07,Sylvan Learning ,310,0,3602,Expense,Personal,Education,DR
2025-02-09,Caltex ,311,0,3291,Expense,Transport,Fuel,DR
2025-02-10,Big W ,192,0,3099,Expense,Personal,Children & Family,DR
2025-02-11,JAX Tyres ,139,0,2960,Expense,Transport,"Car Insurance, Rego & Maintenance",DR
2025-02-11,Telstra ,43,0,2917,Expense,Personal,Mobile Phone,DR
2025-02-12,Optus ,182,0,2735,Expense,Personal,Mobile Phone,DR
2025-02-12, The Good Guys ,228,0,2507,Expense,Household,"Furniture, Electronics & Homewares",DR
2025-02-13,Witchery ,52,0,2455,Expense,Personal,Clothing & Accessories,DR
2025-02-13, NRMA Insurance ,44,0,2411,Expense,Household,Rates & Insurance,DR
2025-02-14,Rental Deposit from RealEstate.com.au ,15,0,2396,Income,Income,Other Income,DR
2025-02-15,Ultra Tune ,109,0,2287,Expense,Transport,"Car Insurance, Rego & Maintenance",DR
2025-02-15,BP ,167,0,2120,Expense,Transport,Fuel,DR
2025-02-16,Adairs ,183,0,1937,Expense,Household,"Furniture, Electronics & Homewares",DR
2025-02-18,ALDI ,7,0,1930,Expense,Household,Groceries,DR
2025-02-19,Australian Veterinary Association ,87,0,1843,Expense,Household,Pets,DR
2025-02-19,Amazon Prime ,26,0,1817,Expense,Leisure & Lifestyle,"Tv, Music & Streaming",DR
2025-02-19,The Australian ,27,0,1790,Expense,Personal,Education,DR
2025-02-19,Beacon Lighting ,21,0,1769,Expense,Household,Maintenance & Improvements,DR
2025-02-20,Guzman y Gomez ,50,0,1719,Expense,Leisure & Lifestyle,Takeaway,DR
2025-02-20,Café Nero ,162,0,1557,Expense,Leisure & Lifestyle,Restaurants & Cafes,DR
2025-02-20,Centrelink JobSeeker Payment ,23,0,1534,Income,Income,Other Income,DR
2025-02-21, Brisbane City Council ,96,0,1438,Expense,Household,Rates & Insurance,DR
2025-02-21,Beachfront Markets ,128,0,1310,Expense,Personal,Clothing & Accessories,DR
2025-02-21,Surf Dive 'n Ski ,52,0,1258,Expense,Personal,Clothing & Accessories,DR
2025-02-22,Kmart Tyre & Auto Service ,114,0,1144,Expense,Transport,"Car Insurance, Rego & Maintenance",DR
2025-02-23, Jim’s Building Inspections ,31,0,1113,Expense,Household,Maintenance & Improvements,DR
2025-02-23,Timezone ,39,0,1074,Expense,Leisure & Lifestyle,Entertainment,DR
2025-02-23,Queensland Urban Utilities ,42,0,1032,Expense,Household,Utilities,DR
2025-02-24,VetLove ,84,0,948,Expense,Household,Pets,DR
2025-02-24,Beachfront Markets ,91,0,857,Expense,Personal,Clothing & Accessories,DR
2025-02-25,Flight Centre ,84,0,773,Expense,Leisure & Lifestyle,Holidays & Travel,DR
2025-02-27,Beacon Lighting ,35,0,738,Expense,Household,Maintenance & Improvements,DR
2025-02-28,Zone Bowling ,58,0,680,Expense,Leisure & Lifestyle,Entertainment,DR
2025-02-28,The Brisbane Hotel ,12,0,668,Expense,Leisure & Lifestyle,Pubs & Bars,DR
2025-03-01,Monthly Income,0,6542,7210,Income,Income,Wages,CR
2025-03-02,Apple Music ,488,0,6722,Expense,Leisure & Lifestyle,"Tv, Music & Streaming",DR
2025-03-03,Hungry Jack’s ,285,0,6437,Expense,Leisure & Lifestyle,Takeaway,DR
2025-03-03,Domino’s Pizza ,123,0,6314,Expense,Leisure & Lifestyle,Takeaway,DR
2025-03-03,Decathlon ,188,0,6126,Expense,Personal,Fitness & Wellbeing,DR
2025-03-03, NSW Land Registry Services ,301,0,5825,Expense,Personal,Life Admin,DR
2025-03-04, Jim’s Building Inspections ,449,0,5376,Expense,Household,Maintenance & Improvements,DR
2025-03-04,Goodstart Early Learning ,135,0,5241,Expense,Personal,Children & Family,DR
2025-03-06,Cookie ,334,0,4907,Expense,Leisure & Lifestyle,Pubs & Bars,DR
2025-03-07,Rooftop Bar ,20,0,4887,Expense,Leisure & Lifestyle,Pubs & Bars,DR
2025-03-07,Chiropractor ,164,0,4723,Expense,Personal,Health & Medical,DR
2025-03-07, Jim’s Building Inspections ,14,0,4709,Expense,Household,Maintenance & Improvements,DR
2025-03-08,Binge ,192,0,4517,Expense,Leisure & Lifestyle,"Tv, Music & Streaming",DR
2025-03-08,Café Nero ,300,0,4217,Expense,Leisure & Lifestyle,Restaurants & Cafes,DR
2025-03-08,Surfstitch ,277,0,3940,Expense,Personal,Clothing & Accessories,DR
2025-03-09,The Iconic ,20,0,3920,Expense,Personal,Clothing & Accessories,DR
2025-03-10,Village Cinemas ,64,0,3856,Expense,Leisure & Lifestyle,Entertainment,DR
2025-03-11,Who Gives A Crap ,103,0,3753,Expense,Household,Groceries,DR
2025-03-12,Scouts Australia ,95,0,3658,Expense,Leisure & Lifestyle,Hobbies,DR
2025-03-13,AustralianSuper Pension ,272,0,3386,Income,Income,Other Income,DR
2025-03-13,Kmart Tyre & Auto Service ,282,0,3104,Expense,Transport,"Car Insurance, Rego & Maintenance",DR
2025-03-13,Repco ,215,0,2889,Expense,Transport,"Car Insurance, Rego & Maintenance",DR
2025-03-13,BP ,154,0,2735,Expense,Transport,Fuel,DR
2025-03-14,Shell V Power,116,0,2619,Expense,Transport,Fuel,DR
2025-03-14,YMCA ,58,0,2561,Expense,Personal,Fitness & Wellbeing,DR
2025-03-15,Greencross Vets ,66,0,2495,Expense,Household,Pets,DR
2025-03-16,Sunburn Swimwear ,40,0,2455,Expense,Personal,Clothing & Accessories,DR
2025-03-16,The Sydney Morning Herald ,17,0,2438,Expense,Personal,Education,DR
2025-03-17,Flight Centre ,208,0,2230,Expense,Leisure & Lifestyle,Holidays & Travel,DR
2025-03-18,Fitness First ,30,0,2200,Expense,Personal,Fitness & Wellbeing,DR
2025-03-18,Apple Music ,118,0,2082,Expense,Leisure & Lifestyle,"Tv, Music & Streaming",DR
2025-03-20,Coles ,196,0,1886,Expense,Household,Groceries,DR
2025-03-20,Freedom Furniture ,108,0,1778,Expense,Household,Maintenance & Improvements,DR
2025-03-20,Sydney Water ,156,0,1622,Expense,Household,Utilities,DR
2025-03-20,VicRoads ,47,0,1575,Expense,Transport,"Car Insurance, Rego & Maintenance",DR
2025-03-21,Culture Kings ,149,0,1426,Expense,Personal,Clothing & Accessories,DR
2025-03-22,Stand Up Paddleboard Rental ,116,0,1310,Expense,Personal,Fitness & Wellbeing,DR
2025-03-23,Eau De Vie ,95,0,1215,Expense,Leisure & Lifestyle,Pubs & Bars,DR
2025-03-26,Aqua Fun Park ,59,0,1156,Expense,Leisure & Lifestyle,Holidays & Travel,DR
2025-03-27,Cookie ,105,0,1051,Expense,Leisure & Lifestyle,Pubs & Bars,DR
2025-03-28,eBay Sales Proceeds ,52,0,999,Income,Income,Other Income,DR
2025-04-01,Monthly Income,0,6542,7541,Income,Income,Wages,CR
2025-04-02,Rebel Sport ,397,0,7144,Expense,Personal,Fitness & Wellbeing,DR
2025-04-02,Health Food Store ,214,0,6930,Expense,Personal,Fitness & Wellbeing,DR
2025-04-03,Hobart Brewing Company ,622,0,6308,Expense,Leisure & Lifestyle,Pubs & Bars,DR
2025-04-04,Interest Payment from Commonwealth Bank ,271,0,6037,Income,Income,Investments,DR
2025-04-06,National Hearing Care ,490,0,5547,Expense,Personal,Health & Medical,DR
2025-04-06,Officeworks ,454,0,5093,Expense,Personal,Life Admin,DR
2025-04-06,Myer ,90,0,5003,Expense,Personal,Clothing & Accessories,DR
2025-04-06,South East Water ,24,0,4979,Expense,Household,Utilities,DR
2025-04-07,Catholic Education Office ,446,0,4533,Expense,Personal,Education,DR
2025-04-07,AustralianSuper Pension ,95,0,4438,Income,Income,Other Income,DR
2025-04-09,Woolworths ,50,0,4388,Expense,Household,Groceries,DR
2025-04-10,Soccer Clubs ,202,0,4186,Expense,Personal,Fitness & Wellbeing,DR
2025-04-11,JAX Tyres ,308,0,3878,Expense,Transport,"Car Insurance, Rego & Maintenance",DR
2025-04-12,TerryWhite Chemmart ,171,0,3707,Expense,Personal,Health & Medical,DR
2025-04-12,School Locker ,255,0,3452,Expense,Personal,Children & Family,DR
2025-04-14,Montessori Schools ,49,0,3403,Expense,Personal,Education,DR
2025-04-16,Health Food Store ,234,0,3169,Expense,Personal,Fitness & Wellbeing,DR
2025-04-16,Guzman y Gomez ,143,0,3026,Expense,Leisure & Lifestyle,Takeaway,DR
2025-04-17,King Swim ,253,0,2773,Expense,Personal,Fitness & Wellbeing,DR
2025-04-18,Aqua Fun Park ,146,0,2627,Expense,Leisure & Lifestyle,Holidays & Travel,DR
2025-04-18,Sylvan Learning ,7,0,2620,Expense,Personal,Education,DR
2025-04-20,The Sydney Morning Herald ,236,0,2384,Expense,Personal,Education,DR
2025-04-21,JB HiFi,97,0,2287,Expense,Leisure & Lifestyle,Electronics,DR
2025-04-21,G8 Education ,116,0,2171,Expense,Personal,Children & Family,DR
2025-04-21,Goodstart Early Learning ,213,0,1958,Expense,Personal,Children & Family,DR
2025-04-21,Big W ,179,0,1779,Expense,Personal,Children & Family,DR
2025-04-24,T2 Tea ,28,0,1751,Expense,Personal,Fitness & Wellbeing,DR
2025-04-24,Disney+ ,105,0,1646,Expense,Leisure & Lifestyle,"Tv, Music & Streaming",DR
2025-04-24,Decathlon ,72,0,1574,Expense,Personal,Fitness & Wellbeing,DR
2025-04-25,Anytime Fitness ,133,0,1441,Expense,Personal,Fitness & Wellbeing,DR
2025-04-25, Metricon ,17,0,1424,Expense,Household,Maintenance & Improvements,DR
2025-04-25,Local Hospital ,57,0,1367,Expense,Personal,Health & Medical,DR
2025-04-26,Netflix ,96,0,1271,Expense,Leisure & Lifestyle,"Tv, Music & Streaming",DR
2025-04-26,Eat Street Northshore ,28,0,1243,Expense,Leisure & Lifestyle,Pubs & Bars,DR
2025-04-26,McDonald’s ,96,0,1147,Expense,Leisure & Lifestyle,Takeaway,DR
2025-04-27,AMF Bowling ,14,0,1133,Expense,Leisure & Lifestyle,Entertainment,DR
2025-04-27,Freedom Furniture ,85,0,1048,Expense,Household,Maintenance & Improvements,DR
2025-05-01,Monthly Income,0,6542,7590,Income,Income,Wages,CR
2025-05-03,Karate for Kids ,379,0,7211,Expense,Personal,Fitness & Wellbeing,DR
2025-05-05,AMF Bowling ,244,0,6967,Expense,Leisure & Lifestyle,Entertainment,DR
2025-05-06,Palace Cinemas ,455,0,6512,Expense,Leisure & Lifestyle,Entertainment,DR
2025-05-07,Officeworks ,569,0,5943,Expense,Personal,Life Admin,DR
2025-05-07,Binge ,206,0,5737,Expense,Leisure & Lifestyle,"Tv, Music & Streaming",DR
2025-05-09,Zone Bowling ,164,0,5573,Expense,Leisure & Lifestyle,Entertainment,DR
2025-05-10,Montessori Schools ,223,0,5350,Expense,Personal,Education,DR
2025-05-10,Supercheap Auto ,70,0,5280,Expense,Transport,"Car Insurance, Rego & Maintenance",DR
2025-05-12,Domino’s Pizza ,47,0,5233,Expense,Leisure & Lifestyle,Takeaway,DR
2025-05-13, Commonwealth Bank ,452,0,4781,Expense,Household,Rent & Mortgage,DR
2025-05-14,Sydney Water ,89,0,4692,Expense,Household,Utilities,DR
2025-05-17,Bulk Billing Doctor ,422,0,4270,Expense,Personal,Health & Medical,DR
2025-05-17,Centrelink JobSeeker Payment ,331,0,3939,Income,Income,Other Income,DR
2025-05-17,Local Hospital ,199,0,3740,Expense,Personal,Health & Medical,DR
2025-05-19,AMF Bowling ,56,0,3684,Expense,Leisure & Lifestyle,Entertainment,DR
2025-05-20,Guzman y Gomez ,269,0,3415,Expense,Leisure & Lifestyle,Takeaway,DR
2025-05-22,JAX Tyres ,200,0,3215,Expense,Transport,"Car Insurance, Rego & Maintenance",DR
2025-05-24,Optus ,33,0,3182,Expense,Personal,Mobile Phone,DR
2025-05-24,The Victory Hotel ,209,0,2973,Expense,Leisure & Lifestyle,Pubs & Bars,DR
2025-05-25,ATO Tax Refund ,211,0,2762,Income,Income,Other Income,DR
2025-05-25,Caltex Woolworths ,162,0,2600,Expense,Transport,Fuel,DR
2025-05-25,Car Wash Cafe ,80,0,2520,Expense,Transport,"Car Insurance, Rego & Maintenance",DR
2025-05-27, Brisbane City Council ,50,0,2470,Expense,Household,Rates & Insurance,DR
2025-06-01,Monthly Income,0,6542,9012,Income,Income,Wages,CR
2025-06-03,Uber ,572,0,8440,Expense,Transport,Taxies & Share Cars,DR
2025-06-04,Gold's Gym ,245,0,8195,Expense,Personal,Fitness & Wellbeing,DR
2025-06-07,Priceline Pharmacy ,188,0,8007,Expense,Personal,Health & Medical,DR
2025-06-07,Beachside Yoga Classes ,599,0,7408,Expense,Personal,Fitness & Wellbeing,DR
2025-06-07,BrewDog ,358,0,7050,Expense,Leisure & Lifestyle,Alcohol,DR
2025-06-08,Tabcorp ,112,0,6938,Expense,Leisure & Lifestyle,Lottery & Gambling,DR
2025-06-09,Chinatown Night Market ,529,0,6409,Expense,Leisure & Lifestyle,Pubs & Bars,DR
2025-06-12,VetLove ,397,0,6012,Expense,Household,Pets,DR
2025-06-13,Rip Curl ,290,0,5722,Expense,Personal,Clothing & Accessories,DR
2025-06-14,Childcare Payments ,570,0,5152,Expense,Personal,Children & Family,DR
2025-06-15, Meriton Apartments ,12,0,5140,Expense,Household,Rates & Insurance,DR
2025-06-17,Dymocks ,288,0,4852,Expense,Leisure & Lifestyle,Hobbies,DR
2025-06-17,Sunburn Swimwear ,78,0,4774,Expense,Personal,Clothing & Accessories,DR
2025-06-18,Domino’s Pizza ,228,0,4546,Expense,Leisure & Lifestyle,Takeaway,DR
2025-06-19,Local Hospital ,450,0,4096,Expense,Personal,Health & Medical,DR
2025-06-19,Beacon Lighting ,408,0,3688,Expense,Household,Maintenance & Improvements,DR
2025-06-20,The Baxter Inn ,329,0,3359,Expense,Leisure & Lifestyle,Pubs & Bars,DR
2025-06-20,Culture Kings ,50,0,3309,Expense,Personal,Clothing & Accessories,DR
2025-06-20,Grill'd ,310,0,2999,Expense,Leisure & Lifestyle,Takeaway,DR
2025-06-20,Fitness First ,289,0,2710,Expense,Personal,Fitness & Wellbeing,DR
2025-06-21,The Athlete's Foot ,49,0,2661,Expense,Personal,Clothing & Accessories,DR
2025-06-22,Specsavers ,133,0,2528,Expense,Personal,Health & Medical,DR
2025-06-22,Audible ,219,0,2309,Expense,Leisure & Lifestyle,"Tv, Music & Streaming",DR
2025-06-25,Myer ,12,0,2297,Expense,Personal,Clothing & Accessories,DR
2025-06-25,Australian Veterinary Association ,33,0,2264,Expense,Household,Pets,DR
2025-06-28, Metricon ,116,0,2148,Expense,Household,Maintenance & Improvements,DR
2025-06-28,Binge ,52,0,2096,Expense,Leisure & Lifestyle,"Tv, Music & Streaming",DR
2025-07-01,Monthly Income,0,6542,8638,Income,Income,Wages,CR
2025-07-02,Tennis Australia ,9,0,8629,Expense,Personal,Fitness & Wellbeing,DR
2025-07-02,Crown Perth ,741,0,7888,Expense,Leisure & Lifestyle,Pubs & Bars,DR
2025-07-03,Gardening Australia ,47,0,7841,Expense,Household,Maintenance & Improvements,DR
2025-07-04,Music Academy ,669,0,7172,Expense,Leisure & Lifestyle,Hobbies,DR
2025-07-04,Adobe Creative Cloud ,201,0,6971,Expense,Leisure & Lifestyle,Hobbies,DR
2025-07-05,Beachside Caravan Park ,691,0,6280,Expense,Leisure & Lifestyle,Holidays & Travel,DR
2025-07-06,Surf Dive 'n Ski ,589,0,5691,Expense,Personal,Clothing & Accessories,DR
2025-07-06,Specsavers ,392,0,5299,Expense,Personal,Health & Medical,DR
2025-07-08,Adobe Creative Cloud ,89,0,5210,Expense,Leisure & Lifestyle,Hobbies,DR
2025-07-09,Car Wash Cafe ,321,0,4889,Expense,Transport,"Car Insurance, Rego & Maintenance",DR
2025-07-09,Gold's Gym ,229,0,4660,Expense,Personal,Fitness & Wellbeing,DR
2025-07-10,Who Gives A Crap ,297,0,4363,Expense,Household,Groceries,DR
2025-07-11,Cookie ,93,0,4270,Expense,Leisure & Lifestyle,Pubs & Bars,DR
2025-07-11,Harvey Norman ,67,0,4203,Expense,Household,"Furniture, Electronics & Homewares",DR
2025-07-11,Stand Up Paddleboard Rental ,315,0,3888,Expense,Personal,Fitness & Wellbeing,DR
2025-07-13,Aqua Fun Park ,56,0,3832,Expense,Leisure & Lifestyle,Holidays & Travel,DR
2025-07-13,Crown Perth ,279,0,3553,Expense,Leisure & Lifestyle,Pubs & Bars,DR
2025-07-14,Sydney Water ,251,0,3302,Expense,Household,Utilities,DR
2025-07-15,Zarraffa's Coffee ,39,0,3263,Expense,Leisure & Lifestyle,Restaurants & Cafes,DR
2025-07-15,Car Wash Cafe ,123,0,3140,Expense,Transport,"Car Insurance, Rego & Maintenance",DR
2025-07-15,Service NSW ,180,0,2960,Expense,Transport,"Car Insurance, Rego & Maintenance",DR
2025-07-15,Kumon ,127,0,2833,Expense,Personal,Education,DR
2025-07-18, Jim’s Building Inspections ,171,0,2662,Expense,Household,Maintenance & Improvements,DR
2025-07-18,Audible ,190,0,2472,Expense,Leisure & Lifestyle,"Tv, Music & Streaming",DR
2025-07-19,The Baxter Inn ,39,0,2433,Expense,Leisure & Lifestyle,Pubs & Bars,DR
2025-07-19,Adobe Creative Cloud ,236,0,2197,Expense,Leisure & Lifestyle,Hobbies,DR
2025-07-20,Cookie ,65,0,2132,Expense,Leisure & Lifestyle,Pubs & Bars,DR
2025-07-20,Physiotherapy Clinic ,89,0,2043,Expense,Personal,Health & Medical,DR
2025-07-20,Optus ,13,0,2030,Expense,Personal,Mobile Phone,DR
2025-07-21,JAX Tyres ,128,0,1902,Expense,Transport,"Car Insurance, Rego & Maintenance",DR
2025-07-21,Pathology Lab ,111,0,1791,Expense,Personal,Health & Medical,DR
2025-07-22,Local Fish and Chips ,105,0,1686,Expense,Leisure & Lifestyle,Takeaway,DR
2025-07-23,Chinatown Night Market ,103,0,1583,Expense,Leisure & Lifestyle,Pubs & Bars,DR
2025-07-23,VicRoads ,144,0,1439,Expense,Transport,"Car Insurance, Rego & Maintenance",DR
2025-07-23,Officeworks ,13,0,1426,Expense,Personal,Life Admin,DR
2025-07-23,Hobart Brewing Company ,107,0,1319,Expense,Leisure & Lifestyle,Pubs & Bars,DR
2025-07-24,The Victory Hotel ,104,0,1215,Expense,Leisure & Lifestyle,Pubs & Bars,DR
2025-07-24,Greencross Vets ,42,0,1173,Expense,Household,Pets,DR
2025-07-24,Coles Express ,87,0,1086,Expense,Transport,Fuel,DR
2025-07-24,Billabong ,100,0,986,Expense,Personal,Clothing & Accessories,DR
2025-07-25,Payday Advance ,26,0,960,Income,Income,Other Income,DR
2025-07-26,Bunnings Warehouse ,47,0,913,Expense,Household,Maintenance & Improvements,DR
2025-07-26,NRMA Roadside Assistance ,65,0,848,Expense,Transport,"Car Insurance, Rego & Maintenance",DR
2025-07-26,Optometrist ,37,0,811,Expense,Personal,Health & Medical,DR
2025-07-26,T2 Tea ,8,0,803,Expense,Personal,Fitness & Wellbeing,DR
2025-07-26,Stan ,67,0,736,Expense,Leisure & Lifestyle,"Tv, Music & Streaming",DR
2025-07-26,The Baxter Inn ,15,0,721,Expense,Leisure & Lifestyle,Pubs & Bars,DR
2025-07-27,Palace Cinemas ,64,0,657,Expense,Leisure & Lifestyle,Entertainment,DR
2025-07-27,Karate for Kids ,23,0,634,Expense,Personal,Fitness & Wellbeing,DR
2025-07-27,Service NSW ,7,0,627,Expense,Transport,"Car Insurance, Rego & Maintenance",DR
2025-07-27,Lorna Jane ,44,0,583,Expense,Personal,Clothing & Accessories,DR
2025-07-27,McDonald’s ,57,0,526,Expense,Leisure & Lifestyle,Takeaway,DR
2025-07-27, Ray White Real Estate ,39,0,487,Expense,Personal,Life Admin,DR
2025-07-27,Music Academy ,27,0,460,Expense,Leisure & Lifestyle,Hobbies,DR
2025-07-28,Kmart Tyre & Auto Service ,36,0,424,Expense,Transport,"Car Insurance, Rego & Maintenance",DR
2025-07-28,Adairs ,34,0,390,Expense,Household,"Furniture, Electronics & Homewares",DR
2025-07-28,Quay Restaurant ,20,0,370,Expense,Leisure & Lifestyle,Pubs & Bars,DR
2025-08-01,Monthly Income,0,6542,6912,Income,Income,Wages,CR
2025-08-03,Guardian Childcare & Education ,385,0,6527,Expense,Personal,Children & Family,DR
2025-08-04,Microsoft 365 ,244,0,6283,Expense,Personal,Education,DR
2025-08-04,KU Children's Services ,540,0,5743,Expense,Personal,Children & Family,DR
2025-08-06,Domino’s Pizza ,459,0,5284,Expense,Leisure & Lifestyle,Takeaway,DR
2025-08-06,Local Fish and Chips ,33,0,5251,Expense,Leisure & Lifestyle,Takeaway,DR
2025-08-07,Service NSW ,507,0,4744,Expense,Transport,"Car Insurance, Rego & Maintenance",DR
2025-08-08,Dan Murphy’s ,82,0,4662,Expense,Leisure & Lifestyle,Alcohol,DR
2025-08-08,Snap Fitness ,278,0,4384,Expense,Personal,Fitness & Wellbeing,DR
2025-08-09,Melbourne Central Lion Hotel ,225,0,4159,Expense,Leisure & Lifestyle,Pubs & Bars,DR
2025-08-09,Foxtel ,390,0,3769,Expense,Leisure & Lifestyle,"Tv, Music & Streaming",DR
2025-08-10,Surf Dive 'n Ski ,122,0,3647,Expense,Personal,Clothing & Accessories,DR
2025-08-10,Quay Restaurant ,171,0,3476,Expense,Leisure & Lifestyle,Pubs & Bars,DR
2025-08-11,Mathnasium ,188,0,3288,Expense,Personal,Education,DR
2025-08-12,KU Children's Services ,159,0,3129,Expense,Personal,Children & Family,DR
2025-08-13,MyCar Tyre & Auto ,200,0,2929,Expense,Transport,"Car Insurance, Rego & Maintenance",DR
2025-08-14,Caltex ,128,0,2801,Expense,Transport,Fuel,DR
2025-08-14,Little Athletics ,208,0,2593,Expense,Personal,Fitness & Wellbeing,DR
2025-08-14,eBay Sales Proceeds ,127,0,2466,Income,Income,Other Income,DR
2025-08-15,MyCar Tyre & Auto ,111,0,2355,Expense,Transport,"Car Insurance, Rego & Maintenance",DR
2025-08-17,Costco ,198,0,2157,Expense,Household,Groceries,DR
2025-08-17,Montessori Schools ,46,0,2111,Expense,Personal,Education,DR
2025-08-17,Lorna Jane ,59,0,2052,Expense,Personal,Clothing & Accessories,DR
2025-08-19,IKEA ,111,0,1941,Expense,Household,Maintenance & Improvements,DR
2025-08-21,Childcare Payments ,84,0,1857,Expense,Personal,Children & Family,DR
2025-08-21,Melbourne Central Lion Hotel ,60,0,1797,Expense,Leisure & Lifestyle,Pubs & Bars,DR
2025-08-21,Upwork Freelancer Payment ,32,0,1765,Income,Income,Other Income,DR
2025-08-22,G8 Education ,71,0,1694,Expense,Personal,Children & Family,DR
2025-08-22,Beachside Yoga Classes ,108,0,1586,Expense,Personal,Fitness & Wellbeing,DR
2025-08-25,Caltex Woolworths ,48,0,1538,Expense,Transport,Fuel,DR
2025-08-25,Goodstart Early Learning ,25,0,1513,Expense,Personal,Children & Family,DR
2025-08-26,BWS ,90,0,1423,Expense,Leisure & Lifestyle,Alcohol,DR
2025-08-26,Boost Juice Bars ,75,0,1348,Expense,Leisure & Lifestyle,Takeaway,DR
2025-08-27,Montessori Schools ,101,0,1247,Expense,Personal,Education,DR
2025-08-28,Child Support Agency Deposit ,70,0,1177,Income,Income,Other Income,DR
2025-09-01,Monthly Income,0,6542,7719,Income,Income,Wages,CR
2025-09-02,Who Gives A Crap ,235,0,7484,Expense,Household,Groceries,DR
2025-09-02,Snap Fitness ,409,0,7075,Expense,Personal,Fitness & Wellbeing,DR
2025-09-02,The Victory Hotel ,82,0,6993,Expense,Leisure & Lifestyle,Pubs & Bars,DR
2025-09-03,Optus ,164,0,6829,Expense,Personal,Mobile Phone,DR
2025-09-03,OfficeMax ,8,0,6821,Expense,Personal,Life Admin,DR
2025-09-04,Barbeques Galore ,183,0,6638,Expense,Household,"Furniture, Electronics & Homewares",DR
2025-09-05, NRMA Insurance ,166,0,6472,Expense,Household,Rates & Insurance,DR
2025-09-06,The Iconic ,432,0,6040,Expense,Personal,Clothing & Accessories,DR
2025-09-07,Ultra Tune ,58,0,5982,Expense,Transport,"Car Insurance, Rego & Maintenance",DR
2025-09-07,Rental Deposit from RealEstate.com.au ,70,0,5912,Income,Income,Other Income,DR
2025-09-08,Gardening Australia ,305,0,5607,Expense,Household,Maintenance & Improvements,DR
2025-09-08,Chiropractor ,424,0,5183,Expense,Personal,Health & Medical,DR
2025-09-09,The Good Guys ,166,0,5017,Expense,Household,"Furniture, Electronics & Homewares",DR
2025-09-11,Beachside Caravan Park ,101,0,4916,Expense,Leisure & Lifestyle,Holidays & Travel,DR
2025-09-11,Dymocks ,118,0,4798,Expense,Leisure & Lifestyle,Hobbies,DR
2025-09-11,Westpac Dividend Deposit ,224,0,4574,Income,Income,Investments,DR
2025-09-12,Vodafone Prepaid ,276,0,4298,Expense,Personal,Mobile Phone,DR
2025-09-12,Ultra Tune ,106,0,4192,Expense,Transport,"Car Insurance, Rego & Maintenance",DR
2025-09-13,Chiropractor ,116,0,4076,Expense,Personal,Health & Medical,DR
2025-09-13,Eat Street Northshore ,403,0,3673,Expense,Leisure & Lifestyle,Pubs & Bars,DR
2025-09-13,Menulog ,299,0,3374,Expense,Leisure & Lifestyle,Takeaway,DR
2025-09-14,Acupuncture Clinic ,63,0,3311,Expense,Personal,Health & Medical,DR
2025-09-14,The Body Shop ,179,0,3132,Expense,Personal,Hair & Beauty,DR
2025-09-14,South East Water ,307,0,2825,Expense,Household,Utilities,DR
2025-09-14,Zarraffa's Coffee ,177,0,2648,Expense,Leisure & Lifestyle,Restaurants & Cafes,DR
2025-09-15,MyCar Tyre & Auto ,238,0,2410,Expense,Transport,"Car Insurance, Rego & Maintenance",DR
2025-09-15,Pathology Lab ,227,0,2183,Expense,Personal,Health & Medical,DR
2025-09-15,Ballet Schools ,183,0,2000,Expense,Personal,Fitness & Wellbeing,DR
2025-09-16,Café Nero ,154,0,1846,Expense,Leisure & Lifestyle,Restaurants & Cafes,DR
2025-09-17,EnergyAustralia ,33,0,1813,Expense,Household,Utilities,DR
2025-09-17,King Swim ,169,0,1644,Expense,Personal,Fitness & Wellbeing,DR
2025-09-17,Village Cinemas ,38,0,1606,Expense,Leisure & Lifestyle,Entertainment,DR
2025-09-17,Ice Cream Parlour ,106,0,1500,Expense,Leisure & Lifestyle,Takeaway,DR
2025-09-18,Origin Energy ,132,0,1368,Expense,Household,Utilities,DR
2025-09-18,Stan ,130,0,1238,Expense,Leisure & Lifestyle,"Tv, Music & Streaming",DR
2025-09-18,Vodafone Prepaid ,7,0,1231,Expense,Personal,Mobile Phone,DR
2025-09-18,Upwork Freelancer Payment ,124,0,1107,Income,Income,Other Income,DR
2025-09-18,Childcare Payments ,9,0,1098,Expense,Personal,Children & Family,DR
2025-09-18, EnergyAustralia ,49,0,1049,Expense,Household,Utilities,DR
2025-09-18,Uber ,53,0,996,Expense,Transport,Taxies & Share Cars,DR
2025-09-18,Beachside Caravan Park ,50,0,946,Expense,Leisure & Lifestyle,Holidays & Travel,DR
2025-09-19,Tabcorp ,49,0,897,Expense,Leisure & Lifestyle,Lottery & Gambling,DR
2025-09-20,EB Games ,88,0,809,Expense,Leisure & Lifestyle,"Apps, Games & Software",DR
2025-09-20,Origin Energy ,8,0,801,Expense,Household,Utilities,DR
2025-09-20,Kumon ,18,0,783,Expense,Personal,Education,DR
2025-09-20,McDonald’s ,9,0,774,Expense,Leisure & Lifestyle,Takeaway,DR
2025-09-21,McDonald’s ,29,0,745,Expense,Leisure & Lifestyle,Takeaway,DR
2025-09-21,Spotlight ,51,0,694,Expense,Leisure & Lifestyle,Hobbies,DR
2025-09-21,Bunnings Warehouse ,60,0,634,Expense,Household,Maintenance & Improvements,DR
2025-09-23,Freedom Furniture ,13,0,621,Expense,Household,Maintenance & Improvements,DR
2025-09-24,Amazon Prime ,63,0,558,Expense,Leisure & Lifestyle,"Tv, Music & Streaming",DR
2025-09-25,Booktopia ,20,0,538,Expense,Leisure & Lifestyle,Hobbies,DR
2025-09-25,Chemist Warehouse ,52,0,486,Expense,Personal,Health & Medical,DR
2025-09-25,Catholic Education Office ,9,0,477,Expense,Personal,Education,DR
2025-09-27,Sunnybank Hotel ,10,0,467,Expense,Leisure & Lifestyle,Pubs & Bars,DR
2025-09-28,The Rocks Bar and Pub ,23,0,444,Expense,Leisure & Lifestyle,Pubs & Bars,DR
2025-10-01,Monthly Income,0,6542,6986,Income,Income,Wages,CR
2025-10-03,Gold's Gym ,115,0,6871,Expense,Personal,Fitness & Wellbeing,DR
2025-10-03,The Victory Hotel ,191,0,6680,Expense,Leisure & Lifestyle,Pubs & Bars,DR
2025-10-03,Catholic Education Office ,117,0,6563,Expense,Personal,Education,DR
2025-10-04,Beach Café ,394,0,6169,Expense,Leisure & Lifestyle,Restaurants & Cafes,DR
2025-10-04,eBay Sales Proceeds ,262,0,5907,Income,Income,Other Income,DR
2025-10-04,ABC Reading Eggs ,537,0,5370,Expense,Personal,Education,DR
2025-10-05,Ladbrokes ,200,0,5170,Expense,Leisure & Lifestyle,Lottery & Gambling,DR
2025-10-05,Optometrist ,258,0,4912,Expense,Personal,Health & Medical,DR
2025-10-06,Caltex Woolworths ,490,0,4422,Expense,Transport,Fuel,DR
2025-10-06,Rooftop Bar ,113,0,4309,Expense,Leisure & Lifestyle,Pubs & Bars,DR
2025-10-06,Freedom Furniture ,385,0,3924,Expense,Household,Maintenance & Improvements,DR
2025-10-08,Le Creuset ,347,0,3577,Expense,Household,"Furniture, Electronics & Homewares",DR
2025-10-09,Harvey Norman ,235,0,3342,Expense,Household,"Furniture, Electronics & Homewares",DR
2025-10-10,Acupuncture Clinic ,92,0,3250,Expense,Personal,Health & Medical,DR
2025-10-11,David Jones ,210,0,3040,Expense,Personal,Clothing & Accessories,DR
2025-10-12,Goodstart Early Learning ,268,0,2772,Expense,Personal,Children & Family,DR
2025-10-13,The Coffee Club ,256,0,2516,Expense,Leisure & Lifestyle,Restaurants & Cafes,DR
2025-10-14,Guzman y Gomez ,145,0,2371,Expense,Leisure & Lifestyle,Takeaway,DR
2025-10-14,BrewDog ,238,0,2133,Expense,Leisure & Lifestyle,Alcohol,DR
2025-10-14,Eau De Vie ,64,0,2069,Expense,Leisure & Lifestyle,Pubs & Bars,DR
2025-10-14,Zarraffa's Coffee ,120,0,1949,Expense,Leisure & Lifestyle,Restaurants & Cafes,DR
2025-10-15,Caltex ,27,0,1922,Expense,Transport,Fuel,DR
2025-10-15,National Hearing Care ,56,0,1866,Expense,Personal,Health & Medical,DR
2025-10-16,Medicare Claim ,159,0,1707,Expense,Personal,Health & Medical,DR
2025-10-17,Beacon Lighting ,96,0,1611,Expense,Household,Maintenance & Improvements,DR
2025-10-17,Service NSW ,7,0,1604,Expense,Transport,"Car Insurance, Rego & Maintenance",DR
2025-10-19,Guzman y Gomez ,22,0,1582,Expense,Leisure & Lifestyle,Takeaway,DR
2025-10-19,Disney+ ,109,0,1473,Expense,Leisure & Lifestyle,"Tv, Music & Streaming",DR
2025-10-19,Tennis Australia ,98,0,1375,Expense,Personal,Fitness & Wellbeing,DR
2025-10-20,Kumon ,72,0,1303,Expense,Personal,Education,DR
2025-10-22,Eau De Vie ,122,0,1181,Expense,Leisure & Lifestyle,Pubs & Bars,DR
2025-10-22,Muffin Break ,84,0,1097,Expense,Leisure & Lifestyle,Restaurants & Cafes,DR
2025-10-23,David Jones ,39,0,1058,Expense,Personal,Clothing & Accessories,DR
2025-10-24,Beach Café ,20,0,1038,Expense,Leisure & Lifestyle,Restaurants & Cafes,DR
2025-10-25,Aqua Fun Park ,62,0,976,Expense,Leisure & Lifestyle,Holidays & Travel,DR
2025-10-25,Platypus Shoes ,22,0,954,Expense,Personal,Clothing & Accessories,DR
2025-10-26,Optus ,16,0,938,Expense,Personal,Mobile Phone,DR
2025-10-26,Massage Therapy Center ,45,0,893,Expense,Personal,Health & Medical,DR
2025-10-27,Autobarn ,13,0,880,Expense,Transport,"Car Insurance, Rego & Maintenance",DR
2025-10-28,The Sydney Morning Herald ,12,0,868,Expense,Personal,Education,DR
2025-11-01,Monthly Income,0,6542,7410,Income,Income,Wages,CR
2025-11-02,Woolworths ,555,0,6855,Expense,Household,Groceries,DR
2025-11-02, Meriton Apartments ,667,0,6188,Expense,Household,Rates & Insurance,DR
2025-11-03,YMCA ,527,0,5661,Expense,Personal,Fitness & Wellbeing,DR
2025-11-04,Mathnasium ,531,0,5130,Expense,Personal,Education,DR
2025-11-04,McDonald’s ,141,0,4989,Expense,Leisure & Lifestyle,Takeaway,DR
2025-11-08,Mathnasium ,388,0,4601,Expense,Personal,Education,DR
2025-11-08,Stan ,116,0,4485,Expense,Leisure & Lifestyle,"Tv, Music & Streaming",DR
2025-11-08,Guzman y Gomez ,443,0,4042,Expense,Leisure & Lifestyle,Takeaway,DR
2025-11-11,Endota Spa ,202,0,3840,Expense,Personal,Fitness & Wellbeing,DR
2025-11-12,Chemist Warehouse ,207,0,3633,Expense,Personal,Health & Medical,DR
2025-11-12,Gardening Australia ,200,0,3433,Expense,Household,Maintenance & Improvements,DR
2025-11-15,City Beach ,191,0,3242,Expense,Personal,Clothing & Accessories,DR
2025-11-16,ALDI ,79,0,3163,Expense,Household,Groceries,DR
2025-11-18,T2 Tea ,196,0,2967,Expense,Personal,Fitness & Wellbeing,DR
2025-11-20,Gardening Australia ,169,0,2798,Expense,Household,Maintenance & Improvements,DR
2025-11-21,Zone Bowling ,79,0,2719,Expense,Leisure & Lifestyle,Entertainment,DR
2025-11-22,CommSec Share Trading Gains ,37,0,2682,Income,Income,Investments,DR
2025-11-22,Guardian Childcare & Education ,212,0,2470,Expense,Personal,Children & Family,DR
2025-11-23,Anytime Fitness ,181,0,2289,Expense,Personal,Fitness & Wellbeing,DR
2025-11-23,Local Fish and Chips ,28,0,2261,Expense,Leisure & Lifestyle,Takeaway,DR
2025-11-23,Foxtel ,221,0,2040,Expense,Leisure & Lifestyle,"Tv, Music & Streaming",DR
2025-11-27,Netflix ,118,0,1922,Expense,Leisure & Lifestyle,"Tv, Music & Streaming",DR
2025-11-27,Acupuncture Clinic ,20,0,1902,Expense,Personal,Health & Medical,DR
2025-11-28,Greencross Vets ,114,0,1788,Expense,Household,Pets,DR
2025-11-28,Sea Life Aquarium ,120,0,1668,Expense,Leisure & Lifestyle,Entertainment,DR
2025-11-28,Bridgestone Select ,57,0,1611,Expense,Transport,"Car Insurance, Rego & Maintenance",DR
2025-12-01,Monthly Income,0,6542,8153,Income,Income,Wages,CR
2025-12-02,Netflix ,237,0,7916,Expense,Leisure & Lifestyle,"Tv, Music & Streaming",DR
2025-12-02,Target ,652,0,7264,Expense,Personal,Clothing & Accessories,DR
2025-12-03,Coles ,658,0,6606,Expense,Household,Groceries,DR
2025-12-03,Who Gives A Crap ,290,0,6316,Expense,Household,Groceries,DR
2025-12-03,Tabcorp ,123,0,6193,Expense,Leisure & Lifestyle,Lottery & Gambling,DR
2025-12-03,Decathlon ,50,0,6143,Expense,Personal,Fitness & Wellbeing,DR
2025-12-04,Village Cinemas ,27,0,6116,Expense,Leisure & Lifestyle,Entertainment,DR
2025-12-04,Guardian Childcare & Education ,537,0,5579,Expense,Personal,Children & Family,DR
2025-12-05,Catholic Education Office ,461,0,5118,Expense,Personal,Education,DR
2025-12-06,Snap Fitness ,103,0,5015,Expense,Personal,Fitness & Wellbeing,DR
2025-12-07,Lorna Jane ,311,0,4704,Expense,Personal,Clothing & Accessories,DR
2025-12-07,Eat Street Northshore ,27,0,4677,Expense,Leisure & Lifestyle,Pubs & Bars,DR
2025-12-07,Freedom Furniture ,277,0,4400,Expense,Household,Maintenance & Improvements,DR
2025-12-07,Green Slip Insurance ,15,0,4385,Expense,Transport,"Car Insurance, Rego & Maintenance",DR
2025-12-07,G8 Education ,90,0,4295,Expense,Personal,Children & Family,DR
2025-12-08,The Espy ,196,0,4099,Expense,Leisure & Lifestyle,Pubs & Bars,DR
2025-12-09,Jetts Fitness ,61,0,4038,Expense,Personal,Fitness & Wellbeing,DR
2025-12-09,AGL Energy ,99,0,3939,Expense,Household,Utilities,DR
2025-12-11,Ice Cream Parlour ,220,0,3719,Expense,Leisure & Lifestyle,Takeaway,DR
2025-12-12,Camp Australia ,293,0,3426,Expense,Leisure & Lifestyle,Hobbies,DR
2025-12-12,ABC Reading Eggs ,251,0,3175,Expense,Personal,Education,DR
2025-12-12,The Body Shop ,119,0,3056,Expense,Personal,Hair & Beauty,DR
2025-12-13,Apple Music ,235,0,2821,Expense,Leisure & Lifestyle,"Tv, Music & Streaming",DR
2025-12-14,Mathnasium ,37,0,2784,Expense,Personal,Education,DR
2025-12-15,Adairs ,145,0,2639,Expense,Household,"Furniture, Electronics & Homewares",DR
2025-12-15,Medicare Claim ,64,0,2575,Expense,Personal,Health & Medical,DR
2025-12-16,Domino’s Pizza ,61,0,2514,Expense,Leisure & Lifestyle,Takeaway,DR
2025-12-17,Costco ,21,0,2493,Expense,Household,Groceries,DR
2025-12-17,The Iconic ,99,0,2394,Expense,Personal,Clothing & Accessories,DR
2025-12-17,Cookie ,162,0,2232,Expense,Leisure & Lifestyle,Pubs & Bars,DR
2025-12-18,Surf Dive 'n Ski ,43,0,2189,Expense,Personal,Clothing & Accessories,DR
2025-12-18,Child Support Agency Deposit ,28,0,2161,Income,Income,Other Income,DR
2025-12-18,Sunburn Swimwear ,46,0,2115,Expense,Personal,Clothing & Accessories,DR
2025-12-19,Airbnb Host Income ,126,0,1989,Income,Income,Other Income,DR
2025-12-19,JB HiFi,197,0,1792,Expense,Leisure & Lifestyle,Electronics,DR
2025-12-21,Child Support Agency Deposit ,167,0,1625,Income,Income,Other Income,DR
2025-12-21,Grill'd ,128,0,1497,Expense,Leisure & Lifestyle,Takeaway,DR
2025-12-21,Fernwood Fitness ,42,0,1455,Expense,Personal,Fitness & Wellbeing,DR
2025-12-22, Commonwealth Bank ,92,0,1363,Expense,Household,Rent & Mortgage,DR
2025-12-22,Adobe Creative Cloud ,10,0,1353,Expense,Leisure & Lifestyle,Hobbies,DR
2025-12-23,QBE Insurance Claim Payout ,88,0,1265,Income,Income,Other Income,DR
2025-12-24,MyCar Tyre & Auto ,27,0,1238,Expense,Transport,"Car Insurance, Rego & Maintenance",DR
2025-12-24,Coles Express ,63,0,1175,Expense,Transport,Fuel,DR
2025-12-24,QBE Insurance Claim Payout ,8,0,1167,Income,Income,Other Income,DR
2025-12-24,Mathnasium ,71,0,1096,Expense,Personal,Education,DR
2025-12-25,Fitness First ,53,0,1043,Expense,Personal,Fitness & Wellbeing,DR
2025-12-25, NRMA Insurance ,53,0,990,Expense,Household,Rates & Insurance,DR
2025-12-26,ATO Tax Refund ,47,0,943,Income,Income,Other Income,DR
2025-12-28,Surf Dive 'n Ski ,65,0,878,Expense,Personal,Clothing & Accessories,DR
2026-01-01,Monthly Income,0,6542,7420,Income,Income,Wages,CR
2026-01-02,Sea Life Aquarium ,371,0,7049,Expense,Leisure & Lifestyle,Entertainment,DR
2026-01-04,Jetts Fitness ,629,0,6420,Expense,Personal,Fitness & Wellbeing,DR
2026-01-05,Guzman y Gomez ,546,0,5874,Expense,Leisure & Lifestyle,Takeaway,DR
2026-01-05,The Athlete's Foot ,246,0,5628,Expense,Personal,Clothing & Accessories,DR
2026-01-05,VicRoads ,333,0,5295,Expense,Transport,"Car Insurance, Rego & Maintenance",DR
2026-01-05,T2 Tea ,177,0,5118,Expense,Personal,Fitness & Wellbeing,DR
2026-01-06, NRMA Insurance ,55,0,5063,Expense,Household,Rates & Insurance,DR
2026-01-06,BP ,213,0,4850,Expense,Transport,Fuel,DR
2026-01-07,Medicare Claim ,415,0,4435,Expense,Personal,Health & Medical,DR
2026-01-07,Zone Bowling ,390,0,4045,Expense,Leisure & Lifestyle,Entertainment,DR
2026-01-07,Scouts Australia ,332,0,3713,Expense,Leisure & Lifestyle,Hobbies,DR
2026-01-07,Quay Restaurant ,226,0,3487,Expense,Leisure & Lifestyle,Pubs & Bars,DR
2026-01-07,ATO Tax Refund ,163,0,3324,Income,Income,Other Income,DR
2026-01-07,Chemist Warehouse ,210,0,3114,Expense,Personal,Health & Medical,DR
2026-01-08,The Body Shop ,12,0,3102,Expense,Personal,Hair & Beauty,DR
2026-01-08,Mathnasium ,263,0,2839,Expense,Personal,Education,DR
2026-01-08,Event Cinemas ,95,0,2744,Expense,Leisure & Lifestyle,Entertainment,DR
2026-01-09,Witchery ,41,0,2703,Expense,Personal,Clothing & Accessories,DR
2026-01-09,Foxtel ,143,0,2560,Expense,Leisure & Lifestyle,"Tv, Music & Streaming",DR
2026-01-09,Who Gives A Crap ,219,0,2341,Expense,Household,Groceries,DR
2026-01-10,Eau De Vie ,58,0,2283,Expense,Leisure & Lifestyle,Pubs & Bars,DR
2026-01-11,Repco ,7,0,2276,Expense,Transport,"Car Insurance, Rego & Maintenance",DR
2026-01-11,Shell V Power,10,0,2266,Expense,Transport,Fuel,DR
2026-01-12,Campion Education ,183,0,2083,Expense,Personal,Children & Family,DR
2026-01-12,Harvey Norman ,75,0,2008,Expense,Household,"Furniture, Electronics & Homewares",DR
2026-01-12,Sea Kayak Tours ,43,0,1965,Expense,Leisure & Lifestyle,Holidays & Travel,DR
2026-01-12,Caltex ,79,0,1886,Expense,Transport,Fuel,DR
2026-01-14,Netflix ,186,0,1700,Expense,Leisure & Lifestyle,"Tv, Music & Streaming",DR
2026-01-15,David Jones ,128,0,1572,Expense,Personal,Clothing & Accessories,DR
2026-01-15, Rentokil ,131,0,1441,Expense,Household,Maintenance & Improvements,DR
2026-01-16,Harvey Norman ,6,0,1435,Expense,Household,"Furniture, Electronics & Homewares",DR
2026-01-16,Kayo Sports ,56,0,1379,Expense,Leisure & Lifestyle,"Tv, Music & Streaming",DR
2026-01-16,Telstra ,74,0,1305,Expense,Personal,Mobile Phone,DR
2026-01-16,Ladbrokes ,68,0,1237,Expense,Leisure & Lifestyle,Lottery & Gambling,DR
2026-01-16,Coles ,75,0,1162,Expense,Household,Groceries,DR
2026-01-18,Lorna Jane ,87,0,1075,Expense,Personal,Clothing & Accessories,DR
2026-01-18,IKEA ,86,0,989,Expense,Household,Maintenance & Improvements,DR
2026-01-20,Bridgestone Select ,13,0,976,Expense,Transport,"Car Insurance, Rego & Maintenance",DR
2026-01-20,Vodafone Prepaid ,41,0,935,Expense,Personal,Mobile Phone,DR
2026-01-21,King Swim ,54,0,881,Expense,Personal,Fitness & Wellbeing,DR
2026-01-22,Swim Australia ,86,0,795,Expense,Personal,Fitness & Wellbeing,DR
2026-01-24,MyCar Tyre & Auto ,16,0,779,Expense,Transport,"Car Insurance, Rego & Maintenance",DR
2026-01-24,Repco ,49,0,730,Expense,Transport,"Car Insurance, Rego & Maintenance",DR
2026-01-25,CommSec Share Trading Gains ,70,0,660,Income,Income,Investments,DR
2026-01-25,Café Nero ,15,0,645,Expense,Leisure & Lifestyle,Restaurants & Cafes,DR
2026-01-26,The Ivy ,29,0,616,Expense,Leisure & Lifestyle,Pubs & Bars,DR
2026-01-28,Apple Music ,6,0,610,Expense,Leisure & Lifestyle,"Tv, Music & Streaming",DR
2026-01-28,Optus ,41,0,569,Expense,Personal,Mobile Phone,DR
2026-02-01,Monthly Income,0,6542,7111,Income,Income,Wages,CR
2026-02-02,KU Children's Services ,275,0,6836,Expense,Personal,Children & Family,DR
2026-02-03,NRMA Roadside Assistance ,73,0,6763,Expense,Transport,"Car Insurance, Rego & Maintenance",DR
2026-02-03,Rebel Sport ,334,0,6429,Expense,Personal,Fitness & Wellbeing,DR
2026-02-03, Brisbane City Council ,203,0,6226,Expense,Household,Rates & Insurance,DR
2026-02-04,Stan ,161,0,6065,Expense,Leisure & Lifestyle,"Tv, Music & Streaming",DR
2026-02-04,Booktopia ,555,0,5510,Expense,Leisure & Lifestyle,Hobbies,DR
2026-02-05,Hobart Brewing Company ,243,0,5267,Expense,Leisure & Lifestyle,Pubs & Bars,DR
2026-02-05,Tennis Australia ,354,0,4913,Expense,Personal,Fitness & Wellbeing,DR
2026-02-06,Physiotherapy Clinic ,220,0,4693,Expense,Personal,Health & Medical,DR
2026-02-06,Chemist Warehouse ,349,0,4344,Expense,Personal,Health & Medical,DR
2026-02-06,SEQTA ,233,0,4111,Expense,Personal,Education,DR
2026-02-07,Caltex Woolworths ,364,0,3747,Expense,Transport,Fuel,DR
2026-02-07,Adairs ,238,0,3509,Expense,Household,"Furniture, Electronics & Homewares",DR
2026-02-07,Bulk Billing Doctor ,189,0,3320,Expense,Personal,Health & Medical,DR
2026-02-07,eBay Sales Proceeds ,188,0,3132,Income,Income,Other Income,DR
2026-02-08,The Coffee Club ,154,0,2978,Expense,Leisure & Lifestyle,Restaurants & Cafes,DR
2026-02-08,Timezone ,266,0,2712,Expense,Leisure & Lifestyle,Entertainment,DR
2026-02-08,Surfstitch ,257,0,2455,Expense,Personal,Clothing & Accessories,DR
2026-02-09,BrewDog ,235,0,2220,Expense,Leisure & Lifestyle,Alcohol,DR
2026-02-09,Decathlon ,180,0,2040,Expense,Personal,Fitness & Wellbeing,DR
2026-02-10,Target ,68,0,1972,Expense,Personal,Clothing & Accessories,DR
2026-02-11,Disney+ ,71,0,1901,Expense,Leisure & Lifestyle,"Tv, Music & Streaming",DR
2026-02-11,Dental Clinic ,131,0,1770,Expense,Personal,Health & Medical,DR
2026-02-12,Beach Café ,19,0,1751,Expense,Leisure & Lifestyle,Restaurants & Cafes,DR
2026-02-13,AMF Bowling ,105,0,1646,Expense,Leisure & Lifestyle,Entertainment,DR
2026-02-13,TerryWhite Chemmart ,79,0,1567,Expense,Personal,Health & Medical,DR
2026-02-13,Taronga Zoo ,79,0,1488,Expense,Leisure & Lifestyle,Entertainment,DR
2026-02-13,Target ,115,0,1373,Expense,Personal,Clothing & Accessories,DR
2026-02-13,Bridgestone Select ,87,0,1286,Expense,Transport,"Car Insurance, Rego & Maintenance",DR
2026-02-14,The Espy ,118,0,1168,Expense,Leisure & Lifestyle,Pubs & Bars,DR
2026-02-14,Uber ,12,0,1156,Expense,Transport,Taxies & Share Cars,DR
2026-02-15,Airbnb Host Income ,40,0,1116,Income,Income,Other Income,DR
2026-02-15,Hobart Brewing Company ,49,0,1067,Expense,Leisure & Lifestyle,Pubs & Bars,DR
2026-02-16,Local Hospital ,30,0,1037,Expense,Personal,Health & Medical,DR
2026-02-17,Billabong ,28,0,1009,Expense,Personal,Clothing & Accessories,DR
2026-02-17,Snap Fitness ,16,0,993,Expense,Personal,Fitness & Wellbeing,DR
2026-02-19,Gold's Gym ,41,0,952,Expense,Personal,Fitness & Wellbeing,DR
2026-02-19,Toys 'R' Us ,54,0,898,Expense,Personal,CHildren & Family,DR
2026-02-20,Westpac Dividend Deposit ,78,0,820,Income,Income,Investments,DR
2026-02-20, National Bank ,33,0,787,Expense,Personal,Fees & Charges,DR
2026-02-20,Interest Payment from Commonwealth Bank ,39,0,748,Income,Income,Investments,DR
2026-02-21, Jim’s Building Inspections ,62,0,686,Expense,Household,Maintenance & Improvements,DR
2026-02-21,Karate for Kids ,60,0,626,Expense,Personal,Fitness & Wellbeing,DR
2026-02-21, Slater and Gordon Lawyers ,48,0,578,Expense,Personal,Life Admin,DR
2026-02-22,QBE Insurance Claim Payout ,39,0,539,Income,Income,Other Income,DR
2026-02-22,Stan ,48,0,491,Expense,Leisure & Lifestyle,"Tv, Music & Streaming",DR
2026-02-24,Origin Energy ,15,0,476,Expense,Household,Utilities,DR
2026-02-24,Petbarn ,41,0,435,Expense,Household,Pets,DR
2026-02-24,Vodafone Prepaid ,36,0,399,Expense,Personal,Mobile Phone,DR
2026-02-25,Green Slip Insurance ,30,0,369,Expense,Transport,"Car Insurance, Rego & Maintenance",DR
2026-02-25,Guzman y Gomez ,25,0,344,Expense,Leisure & Lifestyle,Takeaway,DR
2026-02-25,Coles Express ,7,0,337,Expense,Transport,Fuel,DR
2026-02-25,Eau De Vie ,9,0,328,Expense,Leisure & Lifestyle,Pubs & Bars,DR
2026-02-25,National Hearing Care ,17,0,311,Expense,Personal,Health & Medical,DR
2026-02-25,Ultra Tune ,22,0,289,Expense,Transport,"Car Insurance, Rego & Maintenance",DR
2026-02-25,Decathlon ,23,0,266,Expense,Personal,Fitness & Wellbeing,DR
2026-02-26,Gold's Gym ,27,0,239,Expense,Personal,Fitness & Wellbeing,DR
2026-02-27,Dymocks ,20,0,219,Expense,Leisure & Lifestyle,Hobbies,DR
2026-03-01,Monthly Income,0,6542,6761,Income,Income,Wages,CR
2026-03-02,Chinatown Night Market ,507,0,6254,Expense,Leisure & Lifestyle,Pubs & Bars,DR
2026-03-03,McDonald’s ,513,0,5741,Expense,Leisure & Lifestyle,Takeaway,DR
2026-03-03,Petbarn ,260,0,5481,Expense,Household,Pets,DR
2026-03-04,Fitness First ,450,0,5031,Expense,Personal,Fitness & Wellbeing,DR
2026-03-04,Centrelink JobSeeker Payment ,71,0,4960,Income,Income,Other Income,DR
2026-03-04,Apple Music ,479,0,4481,Expense,Leisure & Lifestyle,"Tv, Music & Streaming",DR
2026-03-05,G8 Education ,175,0,4306,Expense,Personal,Children & Family,DR
2026-03-06, Fantastic Furniture ,173,0,4133,Expense,Household,"Furniture, Electronics & Homewares",DR
2026-03-07,Spotify ,134,0,3999,Expense,Leisure & Lifestyle,"Tv, Music & Streaming",DR
2026-03-07,Sunburn Swimwear ,390,0,3609,Expense,Personal,Clothing & Accessories,DR
2026-03-07,Gold's Gym ,219,0,3390,Expense,Personal,Fitness & Wellbeing,DR
2026-03-08,Green Slip Insurance ,75,0,3315,Expense,Transport,"Car Insurance, Rego & Maintenance",DR
2026-03-08,Greencross Vets ,277,0,3038,Expense,Household,Pets,DR
2026-03-09,Medicare Claim ,298,0,2740,Expense,Personal,Health & Medical,DR
2026-03-09,Campion Education ,80,0,2660,Expense,Personal,Children & Family,DR
2026-03-09,Quay Restaurant ,139,0,2521,Expense,Leisure & Lifestyle,Pubs & Bars,DR
2026-03-10, The Good Guys ,46,0,2475,Expense,Household,"Furniture, Electronics & Homewares",DR
2026-03-11, EnergyAustralia ,234,0,2241,Expense,Household,Utilities,DR
2026-03-11,Westpac Dividend Deposit ,189,0,2052,Income,Income,Investments,DR
2026-03-11,Campion Education ,128,0,1924,Expense,Personal,Children & Family,DR
2026-03-13,Bunnings Warehouse ,124,0,1800,Expense,Household,Maintenance & Improvements,DR
2026-03-13,Boost Juice Bars ,14,0,1786,Expense,Leisure & Lifestyle,Takeaway,DR
2026-03-14,The Australian ,165,0,1621,Expense,Personal,Education,DR
2026-03-14,Goodstart Early Learning ,108,0,1513,Expense,Personal,Children & Family,DR
2026-03-15,Childcare Payments ,104,0,1409,Expense,Personal,Children & Family,DR
2026-03-15,EnergyAustralia ,23,0,1386,Expense,Household,Utilities,DR
2026-03-15,Greencross Vets ,98,0,1288,Expense,Household,Pets,DR
2026-03-15,Campion Education ,12,0,1276,Expense,Personal,Children & Family,DR
2026-03-15,Campion Education ,85,0,1191,Expense,Personal,Children & Family,DR
2026-03-16,Country Road ,19,0,1172,Expense,Personal,Clothing & Accessories,DR
2026-03-16,Grill'd ,111,0,1061,Expense,Leisure & Lifestyle,Takeaway,DR
2026-03-16,Service NSW ,16,0,1045,Expense,Transport,"Car Insurance, Rego & Maintenance",DR
2026-03-17,Billabong ,79,0,966,Expense,Personal,Clothing & Accessories,DR
2026-03-18,MyCar Tyre & Auto ,38,0,928,Expense,Transport,"Car Insurance, Rego & Maintenance",DR
2026-03-18,Salary Deposit from Woolworths Group ,15,0,913,Income,Income,Wages,DR
2026-03-19, Meriton Apartments ,69,0,844,Expense,Household,Rates & Insurance,DR
2026-03-19,IKEA ,58,0,786,Expense,Household,Maintenance & Improvements,DR
2026-03-20,The Body Shop ,50,0,736,Expense,Personal,Hair & Beauty,DR
2026-03-20,Adobe Creative Cloud ,70,0,666,Expense,Leisure & Lifestyle,Hobbies,DR
2026-03-20,Sydney Water ,7,0,659,Expense,Household,Utilities,DR
2026-03-21,Decathlon ,46,0,613,Expense,Personal,Fitness & Wellbeing,DR
2026-03-21,Petbarn ,58,0,555,Expense,Household,Pets,DR
2026-03-21,Microsoft 365 ,21,0,534,Expense,Personal,Education,DR
2026-03-22,Flight Centre ,33,0,501,Expense,Leisure & Lifestyle,Holidays & Travel,DR
2026-03-22,Jetts Fitness ,39,0,462,Expense,Personal,Fitness & Wellbeing,DR
2026-03-22,Spotify ,18,0,444,Expense,Leisure & Lifestyle,"Tv, Music & Streaming",DR
2026-03-23,Harvey Norman ,38,0,406,Expense,Household,"Furniture, Electronics & Homewares",DR
2026-03-23,Big W ,6,0,400,Expense,Personal,Children & Family,DR
2026-03-23,Payday Advance ,24,0,376,Income,Income,Other Income,DR
2026-03-23,Harvey Norman ,5,0,371,Expense,Household,"Furniture, Electronics & Homewares",DR
2026-03-23,Spotlight ,27,0,344,Expense,Leisure & Lifestyle,Hobbies,DR
2026-03-24,Grill’d ,12,0,332,Expense,Leisure & Lifestyle,Takeaway,DR
2026-03-25,eBay Sales Proceeds ,23,0,309,Income,Income,Other Income,DR
2026-03-26,BP ,11,0,298,Expense,Transport,Fuel,DR
2026-03-26,Apple Store ,7,0,291,Expense,Leisure & Lifestyle,Electronics,DR
2026-03-27,Beacon Lighting ,14,0,277,Expense,Household,Maintenance & Improvements,DR
2026-03-27,Domino’s Pizza ,15,0,262,Expense,Leisure & Lifestyle,Takeaway,DR
2026-03-28,Coles ,24,0,238,Expense,Household,Groceries,DR
2026-03-28,Salary Deposit from Woolworths Group ,15,0,223,Income,Income,Wages,DR
2026-03-28,Gardening Australia ,5,0,218,Expense,Household,Maintenance & Improvements,DR
2026-04-01,Monthly Income,0,6542,6760,Income,Income,Wages,CR
2026-04-02,Adairs ,137,0,6623,Expense,Household,"Furniture, Electronics & Homewares",DR
2026-04-02,Catholic Education Office ,207,0,6416,Expense,Personal,Education,DR
2026-04-03,Harvey Norman ,220,0,6196,Expense,Household,"Furniture, Electronics & Homewares",DR
2026-04-03,Origin Energy ,502,0,5694,Expense,Household,Utilities,DR
2026-04-03,Toys 'R' Us ,530,0,5164,Expense,Personal,CHildren & Family,DR
2026-04-04,Eat Street Northshore ,184,0,4980,Expense,Leisure & Lifestyle,Pubs & Bars,DR
2026-04-06,Harvey Norman ,384,0,4596,Expense,Household,"Furniture, Electronics & Homewares",DR
2026-04-06,SEQTA ,366,0,4230,Expense,Personal,Education,DR
2026-04-06,Campion Education ,141,0,4089,Expense,Personal,Children & Family,DR
2026-04-08, BSA Ltd ,267,0,3822,Expense,Household,Maintenance & Improvements,DR
2026-04-09,Tennis Australia ,338,0,3484,Expense,Personal,Fitness & Wellbeing,DR
2026-04-09,Target ,269,0,3215,Expense,Personal,Clothing & Accessories,DR
2026-04-10,Binge ,42,0,3173,Expense,Leisure & Lifestyle,"Tv, Music & Streaming",DR
2026-04-10,Zarraffa's Coffee ,204,0,2969,Expense,Leisure & Lifestyle,Restaurants & Cafes,DR
2026-04-10,Medicare Claim ,27,0,2942,Expense,Personal,Health & Medical,DR
2026-04-10,Who Gives A Crap ,99,0,2843,Expense,Household,Groceries,DR
2026-04-11,Kmart Tyre & Auto Service ,86,0,2757,Expense,Transport,"Car Insurance, Rego & Maintenance",DR
2026-04-12,Hungry Jack’s ,199,0,2558,Expense,Leisure & Lifestyle,Takeaway,DR
2026-04-12,Endota Spa ,218,0,2340,Expense,Personal,Fitness & Wellbeing,DR
2026-04-13,Priceline Pharmacy ,16,0,2324,Expense,Personal,Health & Medical,DR
2026-04-16,VicRoads ,71,0,2253,Expense,Transport,"Car Insurance, Rego & Maintenance",DR
2026-04-17,BWS ,99,0,2154,Expense,Leisure & Lifestyle,Alcohol,DR
2026-04-18,Sunnybank Hotel ,207,0,1947,Expense,Leisure & Lifestyle,Pubs & Bars,DR
2026-04-18,VicRoads ,77,0,1870,Expense,Transport,"Car Insurance, Rego & Maintenance",DR
2026-04-19,Officeworks ,39,0,1831,Expense,Personal,Life Admin,DR
2026-04-20,Supercheap Auto ,53,0,1778,Expense,Transport,"Car Insurance, Rego & Maintenance",DR
2026-04-20,Liquorland ,111,0,1667,Expense,Leisure & Lifestyle,Alcohol,DR
2026-04-21,Budget Direct Car Insurance ,50,0,1617,Expense,Transport,"Car Insurance, Rego & Maintenance",DR
2026-04-21,YMCA ,92,0,1525,Expense,Personal,Fitness & Wellbeing,DR
2026-04-21,Little Athletics ,126,0,1399,Expense,Personal,Fitness & Wellbeing,DR
2026-04-23,Surf Dive 'n Ski ,18,0,1381,Expense,Personal,Clothing & Accessories,DR
2026-04-23,Car Wash Cafe ,91,0,1290,Expense,Transport,"Car Insurance, Rego & Maintenance",DR
2026-04-23,Jetts Fitness ,48,0,1242,Expense,Personal,Fitness & Wellbeing,DR
2026-04-23,Gold's Gym ,28,0,1214,Expense,Personal,Fitness & Wellbeing,DR
2026-04-24,Foxtel ,79,0,1135,Expense,Leisure & Lifestyle,"Tv, Music & Streaming",DR
2026-04-24,Spotify ,109,0,1026,Expense,Leisure & Lifestyle,"Tv, Music & Streaming",DR
2026-04-25,Village Cinemas ,52,0,974,Expense,Leisure & Lifestyle,Entertainment,DR
2026-04-25,Payday Advance ,60,0,914,Income,Income,Other Income,DR
2026-04-26,Lorna Jane ,29,0,885,Expense,Personal,Clothing & Accessories,DR
2026-04-27, National Bank ,34,0,851,Expense,Personal,Fees & Charges,DR
2026-04-27,Rebel Sport ,73,0,778,Expense,Personal,Fitness & Wellbeing,DR
2026-04-28,Endota Spa ,33,0,745,Expense,Personal,Fitness & Wellbeing,DR
2026-04-28,Surfstitch ,35,0,710,Expense,Personal,Clothing & Accessories,DR
2026-05-01,Monthly Income,0,6542,7252,Income,Income,Wages,CR
2026-05-02,The Coffee Club ,63,0,7189,Expense,Leisure & Lifestyle,Restaurants & Cafes,DR
2026-05-04,Upwork Freelancer Payment ,428,0,6761,Income,Income,Other Income,DR
2026-05-04,ABC Reading Eggs ,114,0,6647,Expense,Personal,Education,DR
2026-05-05,The Iconic ,617,0,6030,Expense,Personal,Clothing & Accessories,DR
2026-05-05,Telstra ,363,0,5667,Expense,Personal,Mobile Phone,DR
2026-05-05,Rebel Sport ,507,0,5160,Expense,Personal,Fitness & Wellbeing,DR
2026-05-07,Ice Cream Parlour ,21,0,5139,Expense,Leisure & Lifestyle,Takeaway,DR
2026-05-07,Le Creuset ,286,0,4853,Expense,Household,"Furniture, Electronics & Homewares",DR
2026-05-07,Salary Deposit from Woolworths Group ,304,0,4549,Income,Income,Wages,DR
2026-05-08,Village Cinemas ,365,0,4184,Expense,Leisure & Lifestyle,Entertainment,DR
2026-05-08,Surf Dive 'n Ski ,365,0,3819,Expense,Personal,Clothing & Accessories,DR
2026-05-09, EnergyAustralia ,315,0,3504,Expense,Household,Utilities,DR
2026-05-09,Netflix ,16,0,3488,Expense,Leisure & Lifestyle,"Tv, Music & Streaming",DR
2026-05-09,Disney+ ,334,0,3154,Expense,Leisure & Lifestyle,"Tv, Music & Streaming",DR
2026-05-10,The Espy ,258,0,2896,Expense,Leisure & Lifestyle,Pubs & Bars,DR
2026-05-10,Westpac Dividend Deposit ,16,0,2880,Income,Income,Investments,DR
2026-05-10,IKEA ,158,0,2722,Expense,Household,Maintenance & Improvements,DR
2026-05-11,The Australian ,174,0,2548,Expense,Personal,Education,DR
2026-05-11, Jim’s Building Inspections ,58,0,2490,Expense,Household,Maintenance & Improvements,DR
2026-05-11,Childcare Payments ,22,0,2468,Expense,Personal,Children & Family,DR
2026-05-12,Country Road ,34,0,2434,Expense,Personal,Clothing & Accessories,DR
2026-05-12,Officeworks ,153,0,2281,Expense,Personal,Life Admin,DR
2026-05-12, Rentokil ,112,0,2169,Expense,Household,Maintenance & Improvements,DR
2026-05-13,AMF Bowling ,82,0,2087,Expense,Leisure & Lifestyle,Entertainment,DR
2026-05-13,Bridgestone Select ,172,0,1915,Expense,Transport,"Car Insurance, Rego & Maintenance",DR
2026-05-14,Interest Payment from Commonwealth Bank ,95,0,1820,Income,Income,Investments,DR
2026-05-14,Pizza Hut ,170,0,1650,Expense,Leisure & Lifestyle,Takeaway,DR
2026-05-14,Hobart Brewing Company ,127,0,1523,Expense,Leisure & Lifestyle,Pubs & Bars,DR
2026-05-14,Priceline Pharmacy ,62,0,1461,Expense,Personal,Health & Medical,DR
2026-05-15,Specsavers ,59,0,1402,Expense,Personal,Health & Medical,DR
2026-05-16,Physiotherapy Clinic ,51,0,1351,Expense,Personal,Health & Medical,DR
2026-05-16,Rental Deposit from RealEstate.com.au ,45,0,1306,Income,Income,Other Income,DR
2026-05-17,Guzman y Gomez ,58,0,1248,Expense,Leisure & Lifestyle,Takeaway,DR
2026-05-17,Tennis Australia ,96,0,1152,Expense,Personal,Fitness & Wellbeing,DR
2026-05-18,The Ivy ,45,0,1107,Expense,Leisure & Lifestyle,Pubs & Bars,DR
2026-05-19,Bulk Billing Doctor ,96,0,1011,Expense,Personal,Health & Medical,DR
2026-05-19,eBay Sales Proceeds ,14,0,997,Income,Income,Other Income,DR
2026-05-19,The Ivy ,49,0,948,Expense,Leisure & Lifestyle,Pubs & Bars,DR
2026-05-20,EB Games ,6,0,942,Expense,Leisure & Lifestyle,"Apps, Games & Software",DR
2026-05-20,Netflix ,66,0,876,Expense,Leisure & Lifestyle,"Tv, Music & Streaming",DR
2026-05-21,Chiropractor ,60,0,816,Expense,Personal,Health & Medical,DR
2026-05-21,The Body Shop ,82,0,734,Expense,Personal,Hair & Beauty,DR
2026-05-21,Kumon ,41,0,693,Expense,Personal,Education,DR
2026-05-21,David Jones ,25,0,668,Expense,Personal,Clothing & Accessories,DR
2026-05-22,Zone Bowling ,39,0,629,Expense,Leisure & Lifestyle,Entertainment,DR
2026-05-22,Le Creuset ,10,0,619,Expense,Household,"Furniture, Electronics & Homewares",DR
2026-05-24,JAX Tyres ,51,0,568,Expense,Transport,"Car Insurance, Rego & Maintenance",DR
2026-05-24,Airbnb Host Income ,51,0,517,Income,Income,Other Income,DR
2026-05-25,Beachfront Markets ,44,0,473,Expense,Personal,Clothing & Accessories,DR
2026-05-25,Coles Express ,26,0,447,Expense,Transport,Fuel,DR
2026-05-26,QBE Insurance Claim Payout ,22,0,425,Income,Income,Other Income,DR
2026-05-26,Dental Clinic ,12,0,413,Expense,Personal,Health & Medical,DR
2026-05-27,Interest Payment from Commonwealth Bank ,32,0,381,Income,Income,Investments,DR
2026-05-27,Budget Direct Car Insurance ,26,0,355,Expense,Transport,"Car Insurance, Rego & Maintenance",DR
2026-05-28,The Coffee Club ,33,0,322,Expense,Leisure & Lifestyle,Restaurants & Cafes,DR
2026-05-28,Westpac Dividend Deposit ,29,0,293,Income,Income,Investments,DR
2026-05-28,Airbnb Host Income ,12,0,281,Income,Income,Other Income,DR
2026-06-01,Monthly Income,0,6542,6823,Income,Income,Wages,CR
2026-06-03,Aqua Fun Park ,670,0,6153,Expense,Leisure & Lifestyle,Holidays & Travel,DR
2026-06-04,Chemist Warehouse ,163,0,5990,Expense,Personal,Health & Medical,DR
2026-06-05,Billabong ,152,0,5838,Expense,Personal,Clothing & Accessories,DR
2026-06-06, Fantastic Furniture ,441,0,5397,Expense,Household,"Furniture, Electronics & Homewares",DR
2026-06-06,Zone Bowling ,10,0,5387,Expense,Leisure & Lifestyle,Entertainment,DR
2026-06-06,Domino’s Pizza ,249,0,5138,Expense,Leisure & Lifestyle,Takeaway,DR
2026-06-06,Montessori Schools ,344,0,4794,Expense,Personal,Education,DR
2026-06-07,Karate for Kids ,6,0,4788,Expense,Personal,Fitness & Wellbeing,DR
2026-06-09,Village Cinemas ,218,0,4570,Expense,Leisure & Lifestyle,Entertainment,DR
2026-06-10,Soccer Clubs ,285,0,4285,Expense,Personal,Fitness & Wellbeing,DR
2026-06-10, Metricon ,184,0,4101,Expense,Household,Maintenance & Improvements,DR
2026-06-10,JAX Tyres ,288,0,3813,Expense,Transport,"Car Insurance, Rego & Maintenance",DR
2026-06-10,The Sydney Morning Herald ,351,0,3462,Expense,Personal,Education,DR
2026-06-10,Freedom Furniture ,176,0,3286,Expense,Household,Maintenance & Improvements,DR
2026-06-11,Caltex ,39,0,3247,Expense,Transport,Fuel,DR
2026-06-12,Medicare Claim ,256,0,2991,Expense,Personal,Health & Medical,DR
2026-06-12,Dymocks ,138,0,2853,Expense,Leisure & Lifestyle,Hobbies,DR
2026-06-14,Payday Advance ,79,0,2774,Income,Income,Other Income,DR
2026-06-14,MyCar Tyre & Auto ,230,0,2544,Expense,Transport,"Car Insurance, Rego & Maintenance",DR
2026-06-15,Bunnings Warehouse ,22,0,2522,Expense,Household,Maintenance & Improvements,DR
2026-06-15,Catholic Education Office ,60,0,2462,Expense,Personal,Education,DR
2026-06-16,Booktopia ,223,0,2239,Expense,Leisure & Lifestyle,Hobbies,DR
2026-06-16,Endota Spa ,84,0,2155,Expense,Personal,Fitness & Wellbeing,DR
2026-06-17,Billabong ,70,0,2085,Expense,Personal,Clothing & Accessories,DR
2026-06-17,EB Games ,201,0,1884,Expense,Leisure & Lifestyle,"Apps, Games & Software",DR
2026-06-19,Toys 'R' Us ,68,0,1816,Expense,Personal,CHildren & Family,DR
2026-06-19,Vodafone Prepaid ,168,0,1648,Expense,Personal,Mobile Phone,DR
2026-06-20,Sydney Water ,142,0,1506,Expense,Household,Utilities,DR
2026-06-20,CommSec Share Trading Gains ,27,0,1479,Income,Income,Investments,DR
2026-06-21,ABC Reading Eggs ,140,0,1339,Expense,Personal,Education,DR
2026-06-22,National Hearing Care ,22,0,1317,Expense,Personal,Health & Medical,DR
2026-06-22,Local Fish and Chips ,80,0,1237,Expense,Leisure & Lifestyle,Takeaway,DR
2026-06-22,The Baxter Inn ,27,0,1210,Expense,Leisure & Lifestyle,Pubs & Bars,DR
2026-06-23,Massage Therapy Center ,82,0,1128,Expense,Personal,Health & Medical,DR
2026-06-23,The Rocks Bar and Pub ,22,0,1106,Expense,Leisure & Lifestyle,Pubs & Bars,DR
2026-06-25,The Ivy ,77,0,1029,Expense,Leisure & Lifestyle,Pubs & Bars,DR
2026-06-25, EnergyAustralia ,26,0,1003,Expense,Household,Utilities,DR
2026-06-25,Liquorland ,81,0,922,Expense,Leisure & Lifestyle,Alcohol,DR
2026-06-26,Big W ,65,0,857,Expense,Personal,Children & Family,DR
2026-06-26,Taronga Zoo ,27,0,830,Expense,Leisure & Lifestyle,Entertainment,DR
2026-06-27,Centrelink JobSeeker Payment ,28,0,802,Income,Income,Other Income,DR
2026-06-27,Guardian Childcare & Education ,68,0,734,Expense,Personal,Children & Family,DR
2026-06-28, Fantastic Furniture ,41,0,693,Expense,Household,"Furniture, Electronics & Homewares",DR
2026-07-01,Monthly Income,0,6542,7235,Income,Income,Wages,CR
2026-07-02,IKEA ,327,0,6908,Expense,Household,Maintenance & Improvements,DR
2026-07-02,AustralianSuper Pension ,389,0,6519,Income,Income,Other Income,DR
2026-07-02,Ballet Schools ,17,0,6502,Expense,Personal,Fitness & Wellbeing,DR
2026-07-03,McDonald’s ,170,0,6332,Expense,Leisure & Lifestyle,Takeaway,DR
2026-07-03,Beacon Lighting ,93,0,6239,Expense,Household,Maintenance & Improvements,DR
2026-07-04,BrewDog ,164,0,6075,Expense,Leisure & Lifestyle,Alcohol,DR
2026-07-05,NRMA Roadside Assistance ,165,0,5910,Expense,Transport,"Car Insurance, Rego & Maintenance",DR
2026-07-06,Optus ,462,0,5448,Expense,Personal,Mobile Phone,DR
2026-07-07,Local Hospital ,112,0,5336,Expense,Personal,Health & Medical,DR
2026-07-07,The Espy ,489,0,4847,Expense,Leisure & Lifestyle,Pubs & Bars,DR
2026-07-07,Rip Curl ,92,0,4755,Expense,Personal,Clothing & Accessories,DR
2026-07-07,Green Slip Insurance ,319,0,4436,Expense,Transport,"Car Insurance, Rego & Maintenance",DR
2026-07-10,Ballet Schools ,93,0,4343,Expense,Personal,Fitness & Wellbeing,DR
2026-07-11,The Baxter Inn ,344,0,3999,Expense,Leisure & Lifestyle,Pubs & Bars,DR
2026-07-11,Bulk Billing Doctor ,104,0,3895,Expense,Personal,Health & Medical,DR
2026-07-11,Chiropractor ,297,0,3598,Expense,Personal,Health & Medical,DR
2026-07-11,Specsavers ,311,0,3287,Expense,Personal,Health & Medical,DR
2026-07-11,Tennis Australia ,171,0,3116,Expense,Personal,Fitness & Wellbeing,DR
2026-07-12,Queensland Urban Utilities ,156,0,2960,Expense,Household,Utilities,DR
2026-07-13,Kmart ,184,0,2776,Expense,Personal,Children & Family,DR
2026-07-13,Greencross Vets ,240,0,2536,Expense,Household,Pets,DR
2026-07-14,Village Cinemas ,208,0,2328,Expense,Leisure & Lifestyle,Entertainment,DR
2026-07-14, Jim’s Building Inspections ,70,0,2258,Expense,Household,Maintenance & Improvements,DR
2026-07-16,Anytime Fitness ,122,0,2136,Expense,Personal,Fitness & Wellbeing,DR
2026-07-16,Platypus Shoes ,22,0,2114,Expense,Personal,Clothing & Accessories,DR
2026-07-16, Rentokil ,19,0,2095,Expense,Household,Maintenance & Improvements,DR
2026-07-17,Timezone ,194,0,1901,Expense,Leisure & Lifestyle,Entertainment,DR
2026-07-19,David Jones ,167,0,1734,Expense,Personal,Clothing & Accessories,DR
2026-07-22,The Athlete's Foot ,27,0,1707,Expense,Personal,Clothing & Accessories,DR
2026-07-22,Snap Fitness ,156,0,1551,Expense,Personal,Fitness & Wellbeing,DR
2026-07-23,Domino’s Pizza ,149,0,1402,Expense,Leisure & Lifestyle,Takeaway,DR
2026-07-23,Surfstitch ,50,0,1352,Expense,Personal,Clothing & Accessories,DR
2026-07-23,Optus ,108,0,1244,Expense,Personal,Mobile Phone,DR
2026-07-24,Kumon ,36,0,1208,Expense,Personal,Education,DR
2026-07-24,Autobarn ,101,0,1107,Expense,Transport,"Car Insurance, Rego & Maintenance",DR
2026-07-24,G8 Education ,43,0,1064,Expense,Personal,Children & Family,DR
2026-07-26,Physiotherapy Clinic ,79,0,985,Expense,Personal,Health & Medical,DR
2026-07-26,Target ,27,0,958,Expense,Personal,Clothing & Accessories,DR
2026-07-26,Barbeques Galore ,27,0,931,Expense,Household,"Furniture, Electronics & Homewares",DR
2026-07-27, Jim's Mowing ,9,0,922,Expense,Household,Maintenance & Improvements,DR
2026-07-27,Guzman y Gomez ,64,0,858,Expense,Leisure & Lifestyle,Takeaway,DR
2026-07-27,The Coffee Club ,35,0,823,Expense,Leisure & Lifestyle,Restaurants & Cafes,DR
2026-07-28,Dental Clinic ,73,0,750,Expense,Personal,Health & Medical,DR
2026-08-01,Monthly Income,0,6542,7292,Income,Income,Wages,CR
2026-08-02, Fantastic Furniture ,659,0,6633,Expense,Household,"Furniture, Electronics & Homewares",DR
2026-08-02,Sunnybank Hotel ,418,0,6215,Expense,Leisure & Lifestyle,Pubs & Bars,DR
2026-08-03,AustralianSuper Pension ,238,0,5977,Income,Income,Other Income,DR
2026-08-06,Event Cinemas ,536,0,5441,Expense,Leisure & Lifestyle,Entertainment,DR
2026-08-07,Priceline Pharmacy ,51,0,5390,Expense,Personal,Health & Medical,DR
2026-08-08,Coles ,217,0,5173,Expense,Household,Groceries,DR
2026-08-09,Coles ,89,0,5084,Expense,Household,Groceries,DR
2026-08-09,EnergyAustralia ,31,0,5053,Expense,Household,Utilities,DR
2026-08-09,The Rocks Bar and Pub ,382,0,4671,Expense,Leisure & Lifestyle,Pubs & Bars,DR
2026-08-12,VetLove ,202,0,4469,Expense,Household,Pets,DR
2026-08-14,G8 Education ,163,0,4306,Expense,Personal,Children & Family,DR
2026-08-15,Uber ,10,0,4296,Expense,Transport,Taxies & Share Cars,DR
2026-08-17,Who Gives A Crap ,187,0,4109,Expense,Household,Groceries,DR
2026-08-19,Menulog ,198,0,3911,Expense,Leisure & Lifestyle,Takeaway,DR
2026-08-19,Priceline Pharmacy ,245,0,3666,Expense,Personal,Health & Medical,DR
2026-08-19,The Victory Hotel ,225,0,3441,Expense,Leisure & Lifestyle,Pubs & Bars,DR
2026-08-20,Medicare Claim ,57,0,3384,Expense,Personal,Health & Medical,DR
2026-08-20,Little Athletics ,224,0,3160,Expense,Personal,Fitness & Wellbeing,DR
2026-08-20,Freedom Furniture ,293,0,2867,Expense,Household,Maintenance & Improvements,DR
2026-08-21,Westpac Dividend Deposit ,222,0,2645,Income,Income,Investments,DR
2026-08-21,Soccer Clubs ,216,0,2429,Expense,Personal,Fitness & Wellbeing,DR
2026-08-21,Surfstitch ,6,0,2423,Expense,Personal,Clothing & Accessories,DR
2026-08-22,Mathnasium ,64,0,2359,Expense,Personal,Education,DR
2026-08-22,Audible ,234,0,2125,Expense,Leisure & Lifestyle,"Tv, Music & Streaming",DR
2026-08-23,MyCar Tyre & Auto ,145,0,1980,Expense,Transport,"Car Insurance, Rego & Maintenance",DR
2026-08-23,Ladbrokes ,52,0,1928,Expense,Leisure & Lifestyle,Lottery & Gambling,DR
2026-08-25,Sylvan Learning ,16,0,1912,Expense,Personal,Education,DR
2026-08-28,Child Support Agency Deposit ,55,0,1857,Income,Income,Other Income,DR
2026-08-28,Quay Restaurant ,80,0,1777,Expense,Leisure & Lifestyle,Pubs & Bars,DR
2026-09-01,Monthly Income,0,6542,8319,Income,Income,Wages,CR
2026-09-02,Ballet Schools ,610,0,7709,Expense,Personal,Fitness & Wellbeing,DR
2026-09-03,Autobarn ,750,0,6959,Expense,Transport,"Car Insurance, Rego & Maintenance",DR
2026-09-04,Local Hospital ,500,0,6459,Expense,Personal,Health & Medical,DR
2026-09-07,Crown Perth ,299,0,6160,Expense,Leisure & Lifestyle,Pubs & Bars,DR
2026-09-07,Camp Australia ,69,0,6091,Expense,Leisure & Lifestyle,Hobbies,DR
2026-09-07,Event Cinemas ,321,0,5770,Expense,Leisure & Lifestyle,Entertainment,DR
2026-09-09, Slater and Gordon Lawyers ,470,0,5300,Expense,Personal,Life Admin,DR
2026-09-09,Myer ,54,0,5246,Expense,Personal,Clothing & Accessories,DR
2026-09-09,Endota Spa ,191,0,5055,Expense,Personal,Fitness & Wellbeing,DR
2026-09-10,Taronga Zoo ,152,0,4903,Expense,Leisure & Lifestyle,Entertainment,DR
2026-09-12,Kumon ,357,0,4546,Expense,Personal,Education,DR
2026-09-15,Disney+ ,439,0,4107,Expense,Leisure & Lifestyle,"Tv, Music & Streaming",DR
2026-09-16,Stan ,239,0,3868,Expense,Leisure & Lifestyle,"Tv, Music & Streaming",DR
2026-09-18,Gardening Australia ,348,0,3520,Expense,Household,Maintenance & Improvements,DR
2026-09-21,The Iconic ,246,0,3274,Expense,Personal,Clothing & Accessories,DR
2026-09-21,Campion Education ,65,0,3209,Expense,Personal,Children & Family,DR
2026-09-22,Fitness First ,234,0,2975,Expense,Personal,Fitness & Wellbeing,DR
2026-09-23,Stand Up Paddleboard Rental ,147,0,2828,Expense,Personal,Fitness & Wellbeing,DR
2026-09-26,Petbarn ,177,0,2651,Expense,Household,Pets,DR
2026-09-28,Flight Centre ,211,0,2440,Expense,Leisure & Lifestyle,Holidays & Travel,DR
2026-10-01,Monthly Income,0,6542,8982,Income,Income,Wages,CR
2026-10-02,TerryWhite Chemmart ,459,0,8523,Expense,Personal,Health & Medical,DR
2026-10-02,Campion Education ,86,0,8437,Expense,Personal,Children & Family,DR
2026-10-02,Flight Centre ,587,0,7850,Expense,Leisure & Lifestyle,Holidays & Travel,DR
2026-10-02,Boost Juice Bars ,319,0,7531,Expense,Leisure & Lifestyle,Takeaway,DR
2026-10-03,National Hearing Care ,518,0,7013,Expense,Personal,Health & Medical,DR
2026-10-03,Beachfront Markets ,563,0,6450,Expense,Personal,Clothing & Accessories,DR
2026-10-04,YMCA ,433,0,6017,Expense,Personal,Fitness & Wellbeing,DR
2026-10-04, NRMA Insurance ,127,0,5890,Expense,Household,Rates & Insurance,DR
2026-10-04,McDonald’s ,529,0,5361,Expense,Leisure & Lifestyle,Takeaway,DR
2026-10-05,The Sydney Morning Herald ,159,0,5202,Expense,Personal,Education,DR
2026-10-05,Flight Centre ,315,0,4887,Expense,Leisure & Lifestyle,Holidays & Travel,DR
2026-10-07,Beachside Caravan Park ,462,0,4425,Expense,Leisure & Lifestyle,Holidays & Travel,DR
2026-10-08, Rentokil ,355,0,4070,Expense,Household,Maintenance & Improvements,DR
2026-10-08,OfficeMax ,376,0,3694,Expense,Personal,Life Admin,DR
2026-10-09,The Brisbane Hotel ,229,0,3465,Expense,Leisure & Lifestyle,Pubs & Bars,DR
2026-10-09, Ray White Real Estate ,161,0,3304,Expense,Personal,Life Admin,DR
2026-10-09,Snap Fitness ,48,0,3256,Expense,Personal,Fitness & Wellbeing,DR
2026-10-10,Myer ,273,0,2983,Expense,Personal,Clothing & Accessories,DR
2026-10-10,Priceline Pharmacy ,224,0,2759,Expense,Personal,Health & Medical,DR
2026-10-11,King Swim ,253,0,2506,Expense,Personal,Fitness & Wellbeing,DR
2026-10-11,Binge ,132,0,2374,Expense,Leisure & Lifestyle,"Tv, Music & Streaming",DR
2026-10-11,JB HiFi,192,0,2182,Expense,Leisure & Lifestyle,Electronics,DR
2026-10-12,The Coffee Club ,135,0,2047,Expense,Leisure & Lifestyle,Restaurants & Cafes,DR
2026-10-13,Scouts Australia ,83,0,1964,Expense,Leisure & Lifestyle,Hobbies,DR
2026-10-14, BSA Ltd ,66,0,1898,Expense,Household,Maintenance & Improvements,DR
2026-10-14,Sunnybank Hotel ,21,0,1877,Expense,Leisure & Lifestyle,Pubs & Bars,DR
2026-10-16,Bridgestone Select ,28,0,1849,Expense,Transport,"Car Insurance, Rego & Maintenance",DR
2026-10-17,The Sydney Morning Herald ,103,0,1746,Expense,Personal,Education,DR
2026-10-18,Culture Kings ,133,0,1613,Expense,Personal,Clothing & Accessories,DR
2026-10-18,Kumon ,148,0,1465,Expense,Personal,Education,DR
2026-10-18,Café Nero ,71,0,1394,Expense,Leisure & Lifestyle,Restaurants & Cafes,DR
2026-10-18,Beachside Yoga Classes ,40,0,1354,Expense,Personal,Fitness & Wellbeing,DR
2026-10-19,Mathnasium ,131,0,1223,Expense,Personal,Education,DR
2026-10-20,Swim Australia ,100,0,1123,Expense,Personal,Fitness & Wellbeing,DR
2026-10-21, Ray White Real Estate ,91,0,1032,Expense,Personal,Life Admin,DR
2026-10-21,Ballet Schools ,98,0,934,Expense,Personal,Fitness & Wellbeing,DR
2026-10-22,Sunnybank Hotel ,55,0,879,Expense,Leisure & Lifestyle,Pubs & Bars,DR
2026-10-22,Witchery ,42,0,837,Expense,Personal,Clothing & Accessories,DR
2026-10-22,Le Creuset ,16,0,821,Expense,Household,"Furniture, Electronics & Homewares",DR
2026-10-23,Tennis Australia ,51,0,770,Expense,Personal,Fitness & Wellbeing,DR
2026-10-24,The Brisbane Hotel ,13,0,757,Expense,Leisure & Lifestyle,Pubs & Bars,DR
2026-10-24,Shell V Power,60,0,697,Expense,Transport,Fuel,DR
2026-10-25,Airbnb Host Income ,9,0,688,Income,Income,Other Income,DR
2026-10-26,Anytime Fitness ,36,0,652,Expense,Personal,Fitness & Wellbeing,DR
2026-10-27,Zarraffa's Coffee ,34,0,618,Expense,Leisure & Lifestyle,Restaurants & Cafes,DR
2026-10-27,YMCA ,54,0,564,Expense,Personal,Fitness & Wellbeing,DR
2026-10-28,Rooftop Bar ,49,0,515,Expense,Leisure & Lifestyle,Pubs & Bars,DR
2026-10-28,Uber ,11,0,504,Expense,Transport,Taxies & Share Cars,DR
2026-11-01,Monthly Income,0,6542,7046,Income,Income,Wages,CR
2026-11-02,Sunburn Swimwear ,570,0,6476,Expense,Personal,Clothing & Accessories,DR
2026-11-02, National Bank ,213,0,6263,Expense,Personal,Fees & Charges,DR
2026-11-03,Spotlight ,328,0,5935,Expense,Leisure & Lifestyle,Hobbies,DR
2026-11-04,Freedom Furniture ,11,0,5924,Expense,Household,Maintenance & Improvements,DR
2026-11-04,Café Nero ,78,0,5846,Expense,Leisure & Lifestyle,Restaurants & Cafes,DR
2026-11-04,Palace Cinemas ,26,0,5820,Expense,Leisure & Lifestyle,Entertainment,DR
2026-11-04,Stand Up Paddleboard Rental ,472,0,5348,Expense,Personal,Fitness & Wellbeing,DR
2026-11-04,Tennis Australia ,344,0,5004,Expense,Personal,Fitness & Wellbeing,DR
2026-11-04,ABC Reading Eggs ,13,0,4991,Expense,Personal,Education,DR
2026-11-06,The Sydney Morning Herald ,134,0,4857,Expense,Personal,Education,DR
2026-11-08,South East Water ,411,0,4446,Expense,Household,Utilities,DR
2026-11-08,Kumon ,296,0,4150,Expense,Personal,Education,DR
2026-11-08,Melbourne Central Lion Hotel ,218,0,3932,Expense,Leisure & Lifestyle,Pubs & Bars,DR
2026-11-08,Fernwood Fitness ,289,0,3643,Expense,Personal,Fitness & Wellbeing,DR
2026-11-09,Pizza Hut ,217,0,3426,Expense,Leisure & Lifestyle,Takeaway,DR
2026-11-10,EnergyAustralia ,65,0,3361,Expense,Household,Utilities,DR
2026-11-10,Optometrist ,80,0,3281,Expense,Personal,Health & Medical,DR
2026-11-11,Woolworths ,321,0,2960,Expense,Household,Groceries,DR
2026-11-12,Kayo Sports ,97,0,2863,Expense,Leisure & Lifestyle,"Tv, Music & Streaming",DR
2026-11-12,The Australian ,224,0,2639,Expense,Personal,Education,DR
2026-11-12, The Good Guys ,236,0,2403,Expense,Household,"Furniture, Electronics & Homewares",DR
2026-11-13,TerryWhite Chemmart ,58,0,2345,Expense,Personal,Health & Medical,DR
2026-11-13,Spotlight ,18,0,2327,Expense,Leisure & Lifestyle,Hobbies,DR
2026-11-14,Village Cinemas ,202,0,2125,Expense,Leisure & Lifestyle,Entertainment,DR
2026-11-15,VetLove ,65,0,2060,Expense,Household,Pets,DR
2026-11-16,Westpac Dividend Deposit ,181,0,1879,Income,Income,Investments,DR
2026-11-16,Guzman y Gomez ,179,0,1700,Expense,Leisure & Lifestyle,Takeaway,DR
2026-11-18, Commonwealth Bank ,38,0,1662,Expense,Household,Rent & Mortgage,DR
2026-11-18,AustralianSuper Pension ,143,0,1519,Income,Income,Other Income,DR
2026-11-18,Kumon ,71,0,1448,Expense,Personal,Education,DR
2026-11-18,JAX Tyres ,47,0,1401,Expense,Transport,"Car Insurance, Rego & Maintenance",DR
2026-11-18,Uber ,56,0,1345,Expense,Transport,Taxies & Share Cars,DR
2026-11-19,The Brisbane Hotel ,130,0,1215,Expense,Leisure & Lifestyle,Pubs & Bars,DR
2026-11-21,AustralianSuper Pension ,77,0,1138,Income,Income,Other Income,DR
2026-11-23,Zone Bowling ,32,0,1106,Expense,Leisure & Lifestyle,Entertainment,DR
2026-11-23,Petbarn ,7,0,1099,Expense,Household,Pets,DR
2026-11-24,Rooftop Bar ,5,0,1094,Expense,Leisure & Lifestyle,Pubs & Bars,DR
2026-11-25,F45 Training ,20,0,1074,Expense,Personal,Fitness & Wellbeing,DR
2026-11-25,Ballet Schools ,70,0,1004,Expense,Personal,Fitness & Wellbeing,DR
2026-11-26,Child Support Agency Deposit ,36,0,968,Income,Income,Other Income,DR
2026-11-26,BWS ,61,0,907,Expense,Leisure & Lifestyle,Alcohol,DR
2026-11-26,Origin Energy ,53,0,854,Expense,Household,Utilities,DR
2026-11-28,Audible ,36,0,818,Expense,Leisure & Lifestyle,"Tv, Music & Streaming",DR
2026-12-01,Monthly Income,0,6542,7360,Income,Income,Wages,CR
2026-12-02,Sea Kayak Tours ,212,0,7148,Expense,Leisure & Lifestyle,Holidays & Travel,DR
2026-12-02,JAX Tyres ,206,0,6942,Expense,Transport,"Car Insurance, Rego & Maintenance",DR
2026-12-02,Jetts Fitness ,284,0,6658,Expense,Personal,Fitness & Wellbeing,DR
2026-12-02,The Iconic ,663,0,5995,Expense,Personal,Clothing & Accessories,DR
2026-12-03,Child Support Agency Deposit ,442,0,5553,Income,Income,Other Income,DR
2026-12-04, Brisbane City Council ,61,0,5492,Expense,Household,Rates & Insurance,DR
2026-12-04,Beach Café ,173,0,5319,Expense,Leisure & Lifestyle,Restaurants & Cafes,DR
2026-12-04,Tennis Australia ,335,0,4984,Expense,Personal,Fitness & Wellbeing,DR
2026-12-04,Tabcorp ,457,0,4527,Expense,Leisure & Lifestyle,Lottery & Gambling,DR
2026-12-05,CommSec Share Trading Gains ,451,0,4076,Income,Income,Investments,DR
2026-12-07,KU Children's Services ,33,0,4043,Expense,Personal,Children & Family,DR
2026-12-08,Supercheap Auto ,9,0,4034,Expense,Transport,"Car Insurance, Rego & Maintenance",DR
2026-12-08, EnergyAustralia ,48,0,3986,Expense,Household,Utilities,DR
2026-12-10,Bridgestone Select ,381,0,3605,Expense,Transport,"Car Insurance, Rego & Maintenance",DR
2026-12-10,Soccer Clubs ,358,0,3247,Expense,Personal,Fitness & Wellbeing,DR
2026-12-11,EnergyAustralia ,149,0,3098,Expense,Household,Utilities,DR
2026-12-12,Gardening Australia ,174,0,2924,Expense,Household,Maintenance & Improvements,DR
2026-12-13,Child Support Agency Deposit ,188,0,2736,Income,Income,Other Income,DR
2026-12-14,Fernwood Fitness ,106,0,2630,Expense,Personal,Fitness & Wellbeing,DR
2026-12-15,Hobart Brewing Company ,252,0,2378,Expense,Leisure & Lifestyle,Pubs & Bars,DR
2026-12-16,Scouts Australia ,182,0,2196,Expense,Leisure & Lifestyle,Hobbies,DR
2026-12-17,NRMA Roadside Assistance ,143,0,2053,Expense,Transport,"Car Insurance, Rego & Maintenance",DR
2026-12-19,Event Cinemas ,29,0,2024,Expense,Leisure & Lifestyle,Entertainment,DR
2026-12-19,Anytime Fitness ,18,0,2006,Expense,Personal,Fitness & Wellbeing,DR
2026-12-19,Caltex ,160,0,1846,Expense,Transport,Fuel,DR
2026-12-19,Hungry Jack’s ,175,0,1671,Expense,Leisure & Lifestyle,Takeaway,DR
2026-12-21,Cookie ,157,0,1514,Expense,Leisure & Lifestyle,Pubs & Bars,DR
2026-12-21,City Beach ,11,0,1503,Expense,Personal,Clothing & Accessories,DR
2026-12-22,Hobart Brewing Company ,147,0,1356,Expense,Leisure & Lifestyle,Pubs & Bars,DR
2026-12-23,PayPal Transfer from Sale ,84,0,1272,Income,Income,Other Income,DR
2026-12-24,Snap Fitness ,42,0,1230,Expense,Personal,Fitness & Wellbeing,DR
2026-12-25,G8 Education ,118,0,1112,Expense,Personal,Children & Family,DR
2026-12-25,Adairs ,102,0,1010,Expense,Household,"Furniture, Electronics & Homewares",DR
2026-12-26,The Ivy ,36,0,974,Expense,Leisure & Lifestyle,Pubs & Bars,DR
2026-12-26,Snap Fitness ,33,0,941,Expense,Personal,Fitness & Wellbeing,DR
2026-12-27,Who Gives A Crap ,47,0,894,Expense,Household,Groceries,DR
2027-01-01,Monthly Income,0,6542,7436,Income,Income,Wages,CR
2027-01-02,Surf Dive 'n Ski ,466,0,6970,Expense,Personal,Clothing & Accessories,DR
2027-01-03,Stand Up Paddleboard Rental ,235,0,6735,Expense,Personal,Fitness & Wellbeing,DR
2027-01-03,Sea Kayak Tours ,302,0,6433,Expense,Leisure & Lifestyle,Holidays & Travel,DR
2027-01-04,Catholic Education Office ,436,0,5997,Expense,Personal,Education,DR
2027-01-05,EnergyAustralia ,544,0,5453,Expense,Household,Utilities,DR
2027-01-05,Westpac Dividend Deposit ,16,0,5437,Income,Income,Investments,DR
2027-01-06,Hungry Jack’s ,409,0,5028,Expense,Leisure & Lifestyle,Takeaway,DR
2027-01-06,MyCar Tyre & Auto ,441,0,4587,Expense,Transport,"Car Insurance, Rego & Maintenance",DR
2027-01-06, BSA Ltd ,178,0,4409,Expense,Household,Maintenance & Improvements,DR
2027-01-07,Bridgestone Select ,21,0,4388,Expense,Transport,"Car Insurance, Rego & Maintenance",DR
2027-01-07,Quay Restaurant ,130,0,4258,Expense,Leisure & Lifestyle,Pubs & Bars,DR
2027-01-07,Fernwood Fitness ,278,0,3980,Expense,Personal,Fitness & Wellbeing,DR
2027-01-08,Platypus Shoes ,253,0,3727,Expense,Personal,Clothing & Accessories,DR
2027-01-08,Westpac Dividend Deposit ,50,0,3677,Income,Income,Investments,DR
2027-01-09,Witchery ,69,0,3608,Expense,Personal,Clothing & Accessories,DR
2027-01-10,Binge ,89,0,3519,Expense,Leisure & Lifestyle,"Tv, Music & Streaming",DR
2027-01-11,Spotlight ,101,0,3418,Expense,Leisure & Lifestyle,Hobbies,DR
2027-01-12,Queensland Urban Utilities ,5,0,3413,Expense,Household,Utilities,DR
2027-01-12,Sylvan Learning ,211,0,3202,Expense,Personal,Education,DR
2027-01-13,Apple Music ,148,0,3054,Expense,Leisure & Lifestyle,"Tv, Music & Streaming",DR
2027-01-14, National Bank ,198,0,2856,Expense,Personal,Fees & Charges,DR
2027-01-14,VicRoads ,15,0,2841,Expense,Transport,"Car Insurance, Rego & Maintenance",DR
2027-01-14,Mathnasium ,135,0,2706,Expense,Personal,Education,DR
2027-01-15,Who Gives A Crap ,165,0,2541,Expense,Household,Groceries,DR
2027-01-16,Upwork Freelancer Payment ,201,0,2340,Income,Income,Other Income,DR
2027-01-16,BP ,194,0,2146,Expense,Transport,Fuel,DR
2027-01-17,G8 Education ,122,0,2024,Expense,Personal,Children & Family,DR
2027-01-18,Upwork Freelancer Payment ,99,0,1925,Income,Income,Other Income,DR
2027-01-19,The Sydney Morning Herald ,24,0,1901,Expense,Personal,Education,DR
2027-01-19,Adobe Creative Cloud ,121,0,1780,Expense,Leisure & Lifestyle,Hobbies,DR
2027-01-19, Meriton Apartments ,104,0,1676,Expense,Household,Rates & Insurance,DR
2027-01-19,Repco ,15,0,1661,Expense,Transport,"Car Insurance, Rego & Maintenance",DR
2027-01-19,Taronga Zoo ,135,0,1526,Expense,Leisure & Lifestyle,Entertainment,DR
2027-01-19,CommSec Share Trading Gains ,65,0,1461,Income,Income,Investments,DR
2027-01-20,Kumon ,75,0,1386,Expense,Personal,Education,DR
2027-01-21,Medicare Claim ,71,0,1315,Expense,Personal,Health & Medical,DR
2027-01-22, Brisbane City Council ,108,0,1207,Expense,Household,Rates & Insurance,DR
2027-01-22,Autobarn ,105,0,1102,Expense,Transport,"Car Insurance, Rego & Maintenance",DR
2027-01-22,Australian Veterinary Association ,50,0,1052,Expense,Household,Pets,DR
2027-01-23,David Jones ,43,0,1009,Expense,Personal,Clothing & Accessories,DR
2027-01-24,The Good Guys ,40,0,969,Expense,Household,"Furniture, Electronics & Homewares",DR
2027-01-24,Spotlight ,27,0,942,Expense,Leisure & Lifestyle,Hobbies,DR
2027-01-24,Specsavers ,28,0,914,Expense,Personal,Health & Medical,DR
2027-01-25,Apple Music ,91,0,823,Expense,Leisure & Lifestyle,"Tv, Music & Streaming",DR
2027-01-27,Microsoft 365 ,15,0,808,Expense,Personal,Education,DR
2027-01-28,Car Wash Cafe ,80,0,728,Expense,Transport,"Car Insurance, Rego & Maintenance",DR
2027-01-28,Goodstart Early Learning ,12,0,716,Expense,Personal,Children & Family,DR
2027-02-01,Monthly Income,0,6542,7258,Income,Income,Wages,CR
2027-02-03,Aqua Fun Park ,555,0,6703,Expense,Leisure & Lifestyle,Holidays & Travel,DR
2027-02-03,Menulog ,325,0,6378,Expense,Leisure & Lifestyle,Takeaway,DR
2027-02-04,Camp Australia ,182,0,6196,Expense,Leisure & Lifestyle,Hobbies,DR
2027-02-06,Beacon Lighting ,260,0,5936,Expense,Household,Maintenance & Improvements,DR
2027-02-06,Stan ,564,0,5372,Expense,Leisure & Lifestyle,"Tv, Music & Streaming",DR
2027-02-07,Local Fish and Chips ,195,0,5177,Expense,Leisure & Lifestyle,Takeaway,DR
2027-02-09,ATO Tax Refund ,418,0,4759,Income,Income,Other Income,DR
2027-02-10,Child Support Agency Deposit ,262,0,4497,Income,Income,Other Income,DR
2027-02-11,Costco ,337,0,4160,Expense,Household,Groceries,DR
2027-02-11,Jetts Fitness ,144,0,4016,Expense,Personal,Fitness & Wellbeing,DR
2027-02-12,AMF Bowling ,135,0,3881,Expense,Leisure & Lifestyle,Entertainment,DR
2027-02-12,Lorna Jane ,73,0,3808,Expense,Personal,Clothing & Accessories,DR
2027-02-13,The Victory Hotel ,52,0,3756,Expense,Leisure & Lifestyle,Pubs & Bars,DR
2027-02-13,Crown Perth ,354,0,3402,Expense,Leisure & Lifestyle,Pubs & Bars,DR
2027-02-13,QBE Insurance Claim Payout ,137,0,3265,Income,Income,Other Income,DR
2027-02-13,Karate for Kids ,234,0,3031,Expense,Personal,Fitness & Wellbeing,DR
2027-02-14,EB Games ,280,0,2751,Expense,Leisure & Lifestyle,"Apps, Games & Software",DR
2027-02-15,Boost Juice Bars ,197,0,2554,Expense,Leisure & Lifestyle,Takeaway,DR
2027-02-16,Tabcorp ,250,0,2304,Expense,Leisure & Lifestyle,Lottery & Gambling,DR
2027-02-16,King Swim ,6,0,2298,Expense,Personal,Fitness & Wellbeing,DR
2027-02-20,Priceline Pharmacy ,196,0,2102,Expense,Personal,Health & Medical,DR
2027-02-21,Car Wash Cafe ,193,0,1909,Expense,Transport,"Car Insurance, Rego & Maintenance",DR
2027-02-21,CommSec Share Trading Gains ,78,0,1831,Income,Income,Investments,DR
2027-02-23,The Ivy ,116,0,1715,Expense,Leisure & Lifestyle,Pubs & Bars,DR
2027-02-24, BSA Ltd ,31,0,1684,Expense,Household,Maintenance & Improvements,DR
2027-02-24,Sea Life Aquarium ,120,0,1564,Expense,Leisure & Lifestyle,Entertainment,DR
2027-02-25,Apple Music ,10,0,1554,Expense,Leisure & Lifestyle,"Tv, Music & Streaming",DR
2027-02-25,Harvey Norman ,6,0,1548,Expense,Household,"Furniture, Electronics & Homewares",DR
2027-03-01,Monthly Income,0,6542,8090,Income,Income,Wages,CR
2027-03-02,Upwork Freelancer Payment ,272,0,7818,Income,Income,Other Income,DR
2027-03-03,Zone Bowling ,514,0,7304,Expense,Leisure & Lifestyle,Entertainment,DR
2027-03-03,Bulk Billing Doctor ,168,0,7136,Expense,Personal,Health & Medical,DR
2027-03-04, Jim's Mowing ,11,0,7125,Expense,Household,Maintenance & Improvements,DR
2027-03-04,Adobe Creative Cloud ,551,0,6574,Expense,Leisure & Lifestyle,Hobbies,DR
2027-03-04,Grill’d ,100,0,6474,Expense,Leisure & Lifestyle,Takeaway,DR
2027-03-05,Child Support Agency Deposit ,352,0,6122,Income,Income,Other Income,DR
2027-03-05,The Espy ,82,0,6040,Expense,Leisure & Lifestyle,Pubs & Bars,DR
2027-03-05,Kumon ,412,0,5628,Expense,Personal,Education,DR
2027-03-06,Physiotherapy Clinic ,405,0,5223,Expense,Personal,Health & Medical,DR
2027-03-06,Salary Deposit from Woolworths Group ,37,0,5186,Income,Income,Wages,DR
2027-03-06,Green Slip Insurance ,344,0,4842,Expense,Transport,"Car Insurance, Rego & Maintenance",DR
2027-03-06,The Body Shop ,409,0,4433,Expense,Personal,Hair & Beauty,DR
2027-03-08,Domino’s Pizza ,389,0,4044,Expense,Leisure & Lifestyle,Takeaway,DR
2027-03-08,QBE Insurance Claim Payout ,295,0,3749,Income,Income,Other Income,DR
2027-03-08,School Locker ,319,0,3430,Expense,Personal,Children & Family,DR
2027-03-12,The Victory Hotel ,191,0,3239,Expense,Leisure & Lifestyle,Pubs & Bars,DR
2027-03-12,Binge ,166,0,3073,Expense,Leisure & Lifestyle,"Tv, Music & Streaming",DR
2027-03-13,Grill’d ,34,0,3039,Expense,Leisure & Lifestyle,Takeaway,DR
2027-03-14,Grill'd ,114,0,2925,Expense,Leisure & Lifestyle,Takeaway,DR
2027-03-15,Tabcorp ,21,0,2904,Expense,Leisure & Lifestyle,Lottery & Gambling,DR
2027-03-15,Bunnings Warehouse ,248,0,2656,Expense,Household,Maintenance & Improvements,DR
2027-03-15,City Beach ,233,0,2423,Expense,Personal,Clothing & Accessories,DR
2027-03-15,Salary Deposit from Woolworths Group ,113,0,2310,Income,Income,Wages,DR
2027-03-16,Grill'd ,76,0,2234,Expense,Leisure & Lifestyle,Takeaway,DR
2027-03-16,The Ivy ,50,0,2184,Expense,Leisure & Lifestyle,Pubs & Bars,DR
2027-03-17,Spotify ,170,0,2014,Expense,Leisure & Lifestyle,"Tv, Music & Streaming",DR
2027-03-17,Camp Australia ,177,0,1837,Expense,Leisure & Lifestyle,Hobbies,DR
2027-03-17,YMCA ,94,0,1743,Expense,Personal,Fitness & Wellbeing,DR
2027-03-17,The Rocks Bar and Pub ,149,0,1594,Expense,Leisure & Lifestyle,Pubs & Bars,DR
2027-03-19,Aqua Fun Park ,9,0,1585,Expense,Leisure & Lifestyle,Holidays & Travel,DR
2027-03-19,EB Games ,54,0,1531,Expense,Leisure & Lifestyle,"Apps, Games & Software",DR
2027-03-19,Beachfront Markets ,43,0,1488,Expense,Personal,Clothing & Accessories,DR
2027-03-19,Camp Australia ,52,0,1436,Expense,Leisure & Lifestyle,Hobbies,DR
2027-03-20,Zarraffa's Coffee ,24,0,1412,Expense,Leisure & Lifestyle,Restaurants & Cafes,DR
2027-03-20,AMF Bowling ,81,0,1331,Expense,Leisure & Lifestyle,Entertainment,DR
2027-03-21,Witchery ,19,0,1312,Expense,Personal,Clothing & Accessories,DR
2027-03-22,Spotlight ,129,0,1183,Expense,Leisure & Lifestyle,Hobbies,DR
2027-03-22,City Beach ,109,0,1074,Expense,Personal,Clothing & Accessories,DR
2027-03-22,Booktopia ,91,0,983,Expense,Leisure & Lifestyle,Hobbies,DR
2027-03-22,Kayo Sports ,14,0,969,Expense,Leisure & Lifestyle,"Tv, Music & Streaming",DR
2027-03-23,Timezone ,56,0,913,Expense,Leisure & Lifestyle,Entertainment,DR
2027-03-23,Microsoft 365 ,36,0,877,Expense,Personal,Education,DR
2027-03-24,Scouts Australia ,75,0,802,Expense,Leisure & Lifestyle,Hobbies,DR
2027-03-25,McDonald’s ,61,0,741,Expense,Leisure & Lifestyle,Takeaway,DR
2027-03-25,Coles Express ,11,0,730,Expense,Transport,Fuel,DR
2027-03-25,Flight Centre ,54,0,676,Expense,Leisure & Lifestyle,Holidays & Travel,DR
2027-03-25,Pathology Lab ,56,0,620,Expense,Personal,Health & Medical,DR
2027-03-26,Childcare Payments ,5,0,615,Expense,Personal,Children & Family,DR
2027-03-26,Audible ,17,0,598,Expense,Leisure & Lifestyle,"Tv, Music & Streaming",DR
2027-03-26,Zone Bowling ,27,0,571,Expense,Leisure & Lifestyle,Entertainment,DR
2027-03-27,CommSec Share Trading Gains ,56,0,515,Income,Income,Investments,DR
2027-03-27,Fitness First ,31,0,484,Expense,Personal,Fitness & Wellbeing,DR
2027-03-28,Stan ,26,0,458,Expense,Leisure & Lifestyle,"Tv, Music & Streaming",DR
2027-04-01,Monthly Income,0,6542,7000,Income,Income,Wages,CR
2027-04-03,Karate for Kids ,166,0,6834,Expense,Personal,Fitness & Wellbeing,DR
2027-04-04,Platypus Shoes ,471,0,6363,Expense,Personal,Clothing & Accessories,DR
2027-04-05,The Iconic ,328,0,6035,Expense,Personal,Clothing & Accessories,DR
2027-04-05,Beachside Yoga Classes ,347,0,5688,Expense,Personal,Fitness & Wellbeing,DR
2027-04-06,Ice Cream Parlour ,233,0,5455,Expense,Leisure & Lifestyle,Takeaway,DR
2027-04-07,Adairs ,318,0,5137,Expense,Household,"Furniture, Electronics & Homewares",DR
2027-04-09,The Ivy ,24,0,5113,Expense,Leisure & Lifestyle,Pubs & Bars,DR
2027-04-10,Palace Cinemas ,417,0,4696,Expense,Leisure & Lifestyle,Entertainment,DR
2027-04-10,ATO Tax Refund ,366,0,4330,Income,Income,Other Income,DR
2027-04-10,Rebel Sport ,240,0,4090,Expense,Personal,Fitness & Wellbeing,DR
2027-04-11,Apple Music ,38,0,4052,Expense,Leisure & Lifestyle,"Tv, Music & Streaming",DR
2027-04-11,Sylvan Learning ,335,0,3717,Expense,Personal,Education,DR
2027-04-12,Little Athletics ,227,0,3490,Expense,Personal,Fitness & Wellbeing,DR
2027-04-12,Acupuncture Clinic ,34,0,3456,Expense,Personal,Health & Medical,DR
2027-04-12,Pizza Hut ,25,0,3431,Expense,Leisure & Lifestyle,Takeaway,DR
2027-04-12, Brisbane City Council ,180,0,3251,Expense,Household,Rates & Insurance,DR
2027-04-12,Queensland Urban Utilities ,137,0,3114,Expense,Household,Utilities,DR
2027-04-12,The Athlete's Foot ,14,0,3100,Expense,Personal,Clothing & Accessories,DR
2027-04-13,Mathnasium ,164,0,2936,Expense,Personal,Education,DR
2027-04-14,The Good Guys ,239,0,2697,Expense,Household,"Furniture, Electronics & Homewares",DR
2027-04-15,Budget Direct Car Insurance ,196,0,2501,Expense,Transport,"Car Insurance, Rego & Maintenance",DR
2027-04-15,Dymocks ,108,0,2393,Expense,Leisure & Lifestyle,Hobbies,DR
2027-04-16,Coles ,140,0,2253,Expense,Household,Groceries,DR
2027-04-16,F45 Training ,194,0,2059,Expense,Personal,Fitness & Wellbeing,DR
2027-04-16,F45 Training ,174,0,1885,Expense,Personal,Fitness & Wellbeing,DR
2027-04-17,Supercheap Auto ,156,0,1729,Expense,Transport,"Car Insurance, Rego & Maintenance",DR
2027-04-17,Disney+ ,96,0,1633,Expense,Leisure & Lifestyle,"Tv, Music & Streaming",DR
2027-04-19,Repco ,28,0,1605,Expense,Transport,"Car Insurance, Rego & Maintenance",DR
2027-04-19, Commonwealth Bank ,121,0,1484,Expense,Household,Rent & Mortgage,DR
2027-04-19,Domino’s Pizza ,37,0,1447,Expense,Leisure & Lifestyle,Takeaway,DR
2027-04-19,CommSec Share Trading Gains ,95,0,1352,Income,Income,Investments,DR
2027-04-20,Lorna Jane ,108,0,1244,Expense,Personal,Clothing & Accessories,DR
2027-04-20,EnergyAustralia ,64,0,1180,Expense,Household,Utilities,DR
2027-04-22,Big W ,13,0,1167,Expense,Personal,Children & Family,DR
2027-04-23,Beachfront Markets ,84,0,1083,Expense,Personal,Clothing & Accessories,DR
2027-04-23,PayPal Transfer from Sale ,107,0,976,Income,Income,Other Income,DR
2027-04-23,Harvey Norman ,34,0,942,Expense,Household,"Furniture, Electronics & Homewares",DR
2027-04-25,Jetts Fitness ,17,0,925,Expense,Personal,Fitness & Wellbeing,DR
2027-04-25,ALDI ,57,0,868,Expense,Household,Groceries,DR
2027-04-27,David Jones ,35,0,833,Expense,Personal,Clothing & Accessories,DR
2027-04-27,G8 Education ,15,0,818,Expense,Personal,Children & Family,DR
2027-04-28,Aqua Fun Park ,79,0,739,Expense,Leisure & Lifestyle,Holidays & Travel,DR
2027-04-28,Greencross Vets ,34,0,705,Expense,Household,Pets,DR
2027-04-28,Menulog ,6,0,699,Expense,Leisure & Lifestyle,Takeaway,DR
2027-04-28,Palace Cinemas ,33,0,666,Expense,Leisure & Lifestyle,Entertainment,DR
2027-04-28,Eat Street Northshore ,47,0,619,Expense,Leisure & Lifestyle,Pubs & Bars,DR
2027-05-01,Monthly Income,0,6542,7161,Income,Income,Wages,CR
2027-05-02,KU Children's Services ,230,0,6931,Expense,Personal,Children & Family,DR
2027-05-04,Eau De Vie ,330,0,6601,Expense,Leisure & Lifestyle,Pubs & Bars,DR
2027-05-05,Muffin Break ,227,0,6374,Expense,Leisure & Lifestyle,Restaurants & Cafes,DR
2027-05-06,Disney+ ,346,0,6028,Expense,Leisure & Lifestyle,"Tv, Music & Streaming",DR
2027-05-06,Binge ,290,0,5738,Expense,Leisure & Lifestyle,"Tv, Music & Streaming",DR
2027-05-07,NRMA Roadside Assistance ,314,0,5424,Expense,Transport,"Car Insurance, Rego & Maintenance",DR
2027-05-07,MyCar Tyre & Auto ,427,0,4997,Expense,Transport,"Car Insurance, Rego & Maintenance",DR
2027-05-08,Mathnasium ,19,0,4978,Expense,Personal,Education,DR
2027-05-08,Priceline Pharmacy ,235,0,4743,Expense,Personal,Health & Medical,DR
2027-05-08,Café Nero ,384,0,4359,Expense,Leisure & Lifestyle,Restaurants & Cafes,DR
2027-05-09,Costco ,201,0,4158,Expense,Household,Groceries,DR
2027-05-10,Zone Bowling ,28,0,4130,Expense,Leisure & Lifestyle,Entertainment,DR
2027-05-10,Snap Fitness ,82,0,4048,Expense,Personal,Fitness & Wellbeing,DR
2027-05-10,Queensland Urban Utilities ,178,0,3870,Expense,Household,Utilities,DR
2027-05-10,Beachfront Markets ,88,0,3782,Expense,Personal,Clothing & Accessories,DR
2027-05-11,The Victory Hotel ,218,0,3564,Expense,Leisure & Lifestyle,Pubs & Bars,DR
2027-05-11,Budget Direct Car Insurance ,143,0,3421,Expense,Transport,"Car Insurance, Rego & Maintenance",DR
2027-05-11,Petbarn ,78,0,3343,Expense,Household,Pets,DR
2027-05-13,VetLove ,54,0,3289,Expense,Household,Pets,DR
2027-05-14,Spotlight ,255,0,3034,Expense,Leisure & Lifestyle,Hobbies,DR
2027-05-15,Spotlight ,40,0,2994,Expense,Leisure & Lifestyle,Hobbies,DR
2027-05-15,TerryWhite Chemmart ,53,0,2941,Expense,Personal,Health & Medical,DR
2027-05-16, Commonwealth Bank ,118,0,2823,Expense,Household,Rent & Mortgage,DR
2027-05-16,Disney+ ,232,0,2591,Expense,Leisure & Lifestyle,"Tv, Music & Streaming",DR
2027-05-17,KU Children's Services ,190,0,2401,Expense,Personal,Children & Family,DR
2027-05-17,SEQTA ,116,0,2285,Expense,Personal,Education,DR
2027-05-18,Guzman y Gomez ,70,0,2215,Expense,Leisure & Lifestyle,Takeaway,DR
2027-05-18,Aqua Fun Park ,105,0,2110,Expense,Leisure & Lifestyle,Holidays & Travel,DR
2027-05-18,Rebel Sport ,63,0,2047,Expense,Personal,Fitness & Wellbeing,DR
2027-05-19,Barbeques Galore ,138,0,1909,Expense,Household,"Furniture, Electronics & Homewares",DR
2027-05-19,Medicare Claim ,75,0,1834,Expense,Personal,Health & Medical,DR
2027-05-19, EnergyAustralia ,171,0,1663,Expense,Household,Utilities,DR
2027-05-20,Beachfront Markets ,140,0,1523,Expense,Personal,Clothing & Accessories,DR
2027-05-21,Adobe Creative Cloud ,97,0,1426,Expense,Leisure & Lifestyle,Hobbies,DR
2027-05-21, Jim's Mowing ,22,0,1404,Expense,Household,Maintenance & Improvements,DR
2027-05-22,Australian Veterinary Association ,103,0,1301,Expense,Household,Pets,DR
2027-05-23,Surf Dive 'n Ski ,93,0,1208,Expense,Personal,Clothing & Accessories,DR
2027-05-24,Barbeques Galore ,80,0,1128,Expense,Household,"Furniture, Electronics & Homewares",DR
2027-05-25,The Good Guys ,32,0,1096,Expense,Household,"Furniture, Electronics & Homewares",DR
2027-05-25,Lorna Jane ,8,0,1088,Expense,Personal,Clothing & Accessories,DR
2027-05-25,Platypus Shoes ,20,0,1068,Expense,Personal,Clothing & Accessories,DR
2027-05-26,Amazon Prime ,35,0,1033,Expense,Leisure & Lifestyle,"Tv, Music & Streaming",DR
2027-05-26,Adairs ,35,0,998,Expense,Household,"Furniture, Electronics & Homewares",DR
2027-05-28,Beachside Yoga Classes ,81,0,917,Expense,Personal,Fitness & Wellbeing,DR
2027-05-28,Zarraffa's Coffee ,83,0,834,Expense,Leisure & Lifestyle,Restaurants & Cafes,DR
2027-05-28,Childcare Payments ,9,0,825,Expense,Personal,Children & Family,DR
2027-06-01,Monthly Income,0,6542,7367,Income,Income,Wages,CR
2027-06-03,Witchery ,669,0,6698,Expense,Personal,Clothing & Accessories,DR
2027-06-06,Platypus Shoes ,462,0,6236,Expense,Personal,Clothing & Accessories,DR
2027-06-08,Costco ,306,0,5930,Expense,Household,Groceries,DR
2027-06-09,Sunnybank Hotel ,551,0,5379,Expense,Leisure & Lifestyle,Pubs & Bars,DR
2027-06-10,The Victory Hotel ,205,0,5174,Expense,Leisure & Lifestyle,Pubs & Bars,DR
2027-06-10,Dymocks ,344,0,4830,Expense,Leisure & Lifestyle,Hobbies,DR
2027-06-10,SEQTA ,287,0,4543,Expense,Personal,Education,DR
2027-06-11, Slater and Gordon Lawyers ,395,0,4148,Expense,Personal,Life Admin,DR
2027-06-12,Rebel Sport ,276,0,3872,Expense,Personal,Fitness & Wellbeing,DR
2027-06-12,Optometrist ,347,0,3525,Expense,Personal,Health & Medical,DR
2027-06-13,Origin Energy ,177,0,3348,Expense,Household,Utilities,DR
2027-06-14,Montessori Schools ,43,0,3305,Expense,Personal,Education,DR
2027-06-14,Chemist Warehouse ,125,0,3180,Expense,Personal,Health & Medical,DR
2027-06-14,T2 Tea ,262,0,2918,Expense,Personal,Fitness & Wellbeing,DR
2027-06-15,Green Slip Insurance ,291,0,2627,Expense,Transport,"Car Insurance, Rego & Maintenance",DR
2027-06-17,Gardening Australia ,104,0,2523,Expense,Household,Maintenance & Improvements,DR
2027-06-17,Coles Express ,189,0,2334,Expense,Transport,Fuel,DR
2027-06-21,Palace Cinemas ,49,0,2285,Expense,Leisure & Lifestyle,Entertainment,DR
2027-06-22,MyCar Tyre & Auto ,129,0,2156,Expense,Transport,"Car Insurance, Rego & Maintenance",DR
2027-06-23,Caltex ,81,0,2075,Expense,Transport,Fuel,DR
2027-06-24,Audible ,41,0,2034,Expense,Leisure & Lifestyle,"Tv, Music & Streaming",DR
2027-06-25,Harris Farm Markets ,188,0,1846,Expense,Household,Groceries,DR
2027-06-25,The Ivy ,58,0,1788,Expense,Leisure & Lifestyle,Pubs & Bars,DR
2027-06-26,Gardening Australia ,143,0,1645,Expense,Household,Maintenance & Improvements,DR
2027-06-27,Child Support Agency Deposit ,76,0,1569,Income,Income,Other Income,DR
2027-06-27,Village Cinemas ,45,0,1524,Expense,Leisure & Lifestyle,Entertainment,DR
2027-06-28,Crown Perth ,104,0,1420,Expense,Leisure & Lifestyle,Pubs & Bars,DR
2027-07-01,Monthly Income,0,6542,7962,Income,Income,Wages,CR
2027-07-03,VetLove ,114,0,7848,Expense,Household,Pets,DR
2027-07-03,Optus ,678,0,7170,Expense,Personal,Mobile Phone,DR
2027-07-04,PayPal Transfer from Sale ,393,0,6777,Income,Income,Other Income,DR
2027-07-04,JAX Tyres ,194,0,6583,Expense,Transport,"Car Insurance, Rego & Maintenance",DR
2027-07-04,Specsavers ,149,0,6434,Expense,Personal,Health & Medical,DR
2027-07-05,KU Children's Services ,300,0,6134,Expense,Personal,Children & Family,DR
2027-07-05,Ice Cream Parlour ,358,0,5776,Expense,Leisure & Lifestyle,Takeaway,DR
2027-07-05,Telstra ,427,0,5349,Expense,Personal,Mobile Phone,DR
2027-07-05,Goodstart Early Learning ,324,0,5025,Expense,Personal,Children & Family,DR
2027-07-07,The Body Shop ,18,0,5007,Expense,Personal,Hair & Beauty,DR
2027-07-07,Amazon Prime ,496,0,4511,Expense,Leisure & Lifestyle,"Tv, Music & Streaming",DR
2027-07-09,Gold's Gym ,5,0,4506,Expense,Personal,Fitness & Wellbeing,DR
2027-07-10,The Iconic ,220,0,4286,Expense,Personal,Clothing & Accessories,DR
2027-07-10,Ballet Schools ,125,0,4161,Expense,Personal,Fitness & Wellbeing,DR
2027-07-11,Jetts Fitness ,238,0,3923,Expense,Personal,Fitness & Wellbeing,DR
2027-07-13,City Beach ,26,0,3897,Expense,Personal,Clothing & Accessories,DR
2027-07-14, Meriton Apartments ,271,0,3626,Expense,Household,Rates & Insurance,DR
2027-07-15,QBE Insurance Claim Payout ,92,0,3534,Income,Income,Other Income,DR
2027-07-16,Zarraffa's Coffee ,197,0,3337,Expense,Leisure & Lifestyle,Restaurants & Cafes,DR
2027-07-17,JB HiFi,161,0,3176,Expense,Leisure & Lifestyle,Electronics,DR
2027-07-18,Timezone ,83,0,3093,Expense,Leisure & Lifestyle,Entertainment,DR
2027-07-20,Repco ,288,0,2805,Expense,Transport,"Car Insurance, Rego & Maintenance",DR
2027-07-20,Autobarn ,156,0,2649,Expense,Transport,"Car Insurance, Rego & Maintenance",DR
2027-07-21,Witchery ,208,0,2441,Expense,Personal,Clothing & Accessories,DR
2027-07-22,Dymocks ,55,0,2386,Expense,Leisure & Lifestyle,Hobbies,DR
2027-07-22,Taronga Zoo ,9,0,2377,Expense,Leisure & Lifestyle,Entertainment,DR
2027-07-22,Telstra ,214,0,2163,Expense,Personal,Mobile Phone,DR
2027-07-22,Endota Spa ,133,0,2030,Expense,Personal,Fitness & Wellbeing,DR
2027-07-23,Sylvan Learning ,162,0,1868,Expense,Personal,Education,DR
2027-07-24, Ray White Real Estate ,168,0,1700,Expense,Personal,Life Admin,DR
2027-07-24,Stand Up Paddleboard Rental ,128,0,1572,Expense,Personal,Fitness & Wellbeing,DR
2027-07-26,Coles ,53,0,1519,Expense,Household,Groceries,DR
2027-07-28,Sunnybank Hotel ,134,0,1385,Expense,Leisure & Lifestyle,Pubs & Bars,DR
2027-07-28,Taronga Zoo ,128,0,1257,Expense,Leisure & Lifestyle,Entertainment,DR
2027-07-28,F45 Training ,18,0,1239,Expense,Personal,Fitness & Wellbeing,DR
2027-07-28,BrewDog ,25,0,1214,Expense,Leisure & Lifestyle,Alcohol,DR
2027-08-01,Monthly Income,0,6542,7756,Income,Income,Wages,CR
2027-08-03,Tabcorp ,12,0,7744,Expense,Leisure & Lifestyle,Lottery & Gambling,DR
2027-08-04,Who Gives A Crap ,438,0,7306,Expense,Household,Groceries,DR
2027-08-05,QBE Insurance Claim Payout ,635,0,6671,Income,Income,Other Income,DR
2027-08-05, Commonwealth Bank ,468,0,6203,Expense,Household,Rent & Mortgage,DR
2027-08-06,Stan ,65,0,6138,Expense,Leisure & Lifestyle,"Tv, Music & Streaming",DR
2027-08-08, Meriton Apartments ,10,0,6128,Expense,Household,Rates & Insurance,DR
2027-08-08, Meriton Apartments ,45,0,6083,Expense,Household,Rates & Insurance,DR
2027-08-10,Harris Farm Markets ,600,0,5483,Expense,Household,Groceries,DR
2027-08-10,Local Fish and Chips ,376,0,5107,Expense,Leisure & Lifestyle,Takeaway,DR
2027-08-10,Harvey Norman ,377,0,4730,Expense,Household,"Furniture, Electronics & Homewares",DR
2027-08-11,Culture Kings ,164,0,4566,Expense,Personal,Clothing & Accessories,DR
2027-08-11,Gardening Australia ,278,0,4288,Expense,Household,Maintenance & Improvements,DR
2027-08-12,Budget Direct Car Insurance ,45,0,4243,Expense,Transport,"Car Insurance, Rego & Maintenance",DR
2027-08-12,Jetts Fitness ,336,0,3907,Expense,Personal,Fitness & Wellbeing,DR
2027-08-14,School Locker ,148,0,3759,Expense,Personal,Children & Family,DR
2027-08-15,Who Gives A Crap ,134,0,3625,Expense,Household,Groceries,DR
2027-08-16,Sea Life Aquarium ,91,0,3534,Expense,Leisure & Lifestyle,Entertainment,DR
2027-08-16,F45 Training ,92,0,3442,Expense,Personal,Fitness & Wellbeing,DR
2027-08-17, Metricon ,244,0,3198,Expense,Household,Maintenance & Improvements,DR
2027-08-17,Timezone ,82,0,3116,Expense,Leisure & Lifestyle,Entertainment,DR
2027-08-17,Origin Energy ,212,0,2904,Expense,Household,Utilities,DR
2027-08-17,Chinatown Night Market ,233,0,2671,Expense,Leisure & Lifestyle,Pubs & Bars,DR
2027-08-18,Costco ,203,0,2468,Expense,Household,Groceries,DR
2027-08-18,BWS ,188,0,2280,Expense,Leisure & Lifestyle,Alcohol,DR
2027-08-19,Who Gives A Crap ,183,0,2097,Expense,Household,Groceries,DR
2027-08-19,AMF Bowling ,153,0,1944,Expense,Leisure & Lifestyle,Entertainment,DR
2027-08-20,Sunnybank Hotel ,11,0,1933,Expense,Leisure & Lifestyle,Pubs & Bars,DR
2027-08-21,Country Road ,159,0,1774,Expense,Personal,Clothing & Accessories,DR
2027-08-21,Le Creuset ,86,0,1688,Expense,Household,"Furniture, Electronics & Homewares",DR
2027-08-22,Microsoft 365 ,92,0,1596,Expense,Personal,Education,DR
2027-08-23,TerryWhite Chemmart ,105,0,1491,Expense,Personal,Health & Medical,DR
2027-08-23,Origin Energy ,97,0,1394,Expense,Household,Utilities,DR
2027-08-24, Meriton Apartments ,30,0,1364,Expense,Household,Rates & Insurance,DR
2027-08-25,The Coffee Club ,30,0,1334,Expense,Leisure & Lifestyle,Restaurants & Cafes,DR
2027-08-25,Car Wash Cafe ,54,0,1280,Expense,Transport,"Car Insurance, Rego & Maintenance",DR
2027-08-26,Green Slip Insurance ,14,0,1266,Expense,Transport,"Car Insurance, Rego & Maintenance",DR
2027-08-26,JB HiFi,104,0,1162,Expense,Leisure & Lifestyle,Electronics,DR
2027-08-26,PayPal Transfer from Sale ,18,0,1144,Income,Income,Other Income,DR
2027-08-27,Childcare Payments ,106,0,1038,Expense,Personal,Children & Family,DR
2027-08-28,Menulog ,6,0,1032,Expense,Leisure & Lifestyle,Takeaway,DR
2027-08-28,Child Support Agency Deposit ,102,0,930,Income,Income,Other Income,DR
2027-09-01,Monthly Income,0,6542,7472,Income,Income,Wages,CR
2027-09-02,Karate for Kids ,47,0,7425,Expense,Personal,Fitness & Wellbeing,DR
2027-09-03,National Hearing Care ,574,0,6851,Expense,Personal,Health & Medical,DR
2027-09-05,Gardening Australia ,515,0,6336,Expense,Household,Maintenance & Improvements,DR
2027-09-05,Montessori Schools ,395,0,5941,Expense,Personal,Education,DR
2027-09-10,Officeworks ,523,0,5418,Expense,Personal,Life Admin,DR
2027-09-10,Tabcorp ,399,0,5019,Expense,Leisure & Lifestyle,Lottery & Gambling,DR
2027-09-12,Optus ,96,0,4923,Expense,Personal,Mobile Phone,DR
2027-09-12,Little Athletics ,216,0,4707,Expense,Personal,Fitness & Wellbeing,DR
2027-09-14,Hobart Brewing Company ,386,0,4321,Expense,Leisure & Lifestyle,Pubs & Bars,DR
2027-09-14,F45 Training ,397,0,3924,Expense,Personal,Fitness & Wellbeing,DR
2027-09-14, Fantastic Furniture ,19,0,3905,Expense,Household,"Furniture, Electronics & Homewares",DR
2027-09-15,Sydney Water ,246,0,3659,Expense,Household,Utilities,DR
2027-09-17,The Baxter Inn ,231,0,3428,Expense,Leisure & Lifestyle,Pubs & Bars,DR
2027-09-20,Timezone ,11,0,3417,Expense,Leisure & Lifestyle,Entertainment,DR
2027-09-20,Budget Direct Car Insurance ,172,0,3245,Expense,Transport,"Car Insurance, Rego & Maintenance",DR
2027-09-20,F45 Training ,206,0,3039,Expense,Personal,Fitness & Wellbeing,DR
2027-09-21,Hobart Brewing Company ,209,0,2830,Expense,Leisure & Lifestyle,Pubs & Bars,DR
2027-09-21,Dan Murphy’s ,212,0,2618,Expense,Leisure & Lifestyle,Alcohol,DR
2027-09-22,Target ,261,0,2357,Expense,Personal,Clothing & Accessories,DR
2027-09-23,Woolworths ,180,0,2177,Expense,Household,Groceries,DR
2027-09-24,Physiotherapy Clinic ,151,0,2026,Expense,Personal,Health & Medical,DR
2027-09-25,EnergyAustralia ,13,0,2013,Expense,Household,Utilities,DR
2027-09-27,Dental Clinic ,74,0,1939,Expense,Personal,Health & Medical,DR
2027-09-27, BSA Ltd ,146,0,1793,Expense,Household,Maintenance & Improvements,DR
2027-09-27,IKEA ,68,0,1725,Expense,Household,Maintenance & Improvements,DR
2027-09-27,Local Hospital ,71,0,1654,Expense,Personal,Health & Medical,DR
2027-09-28,Beachfront Markets ,63,0,1591,Expense,Personal,Clothing & Accessories,DR
2027-10-01,Monthly Income,0,6542,8133,Income,Income,Wages,CR
2027-10-02, The Good Guys ,379,0,7754,Expense,Household,"Furniture, Electronics & Homewares",DR
2027-10-02,Sea Kayak Tours ,740,0,7014,Expense,Leisure & Lifestyle,Holidays & Travel,DR
2027-10-03,YMCA ,46,0,6968,Expense,Personal,Fitness & Wellbeing,DR
2027-10-05,Stan ,424,0,6544,Expense,Leisure & Lifestyle,"Tv, Music & Streaming",DR
2027-10-06,Culture Kings ,47,0,6497,Expense,Personal,Clothing & Accessories,DR
2027-10-07,Acupuncture Clinic ,448,0,6049,Expense,Personal,Health & Medical,DR
2027-10-08,Freedom Furniture ,463,0,5586,Expense,Household,Maintenance & Improvements,DR
2027-10-08,Rental Deposit from RealEstate.com.au ,389,0,5197,Income,Income,Other Income,DR
2027-10-08,Health Food Store ,396,0,4801,Expense,Personal,Fitness & Wellbeing,DR
2027-10-08,Microsoft 365 ,204,0,4597,Expense,Personal,Education,DR
2027-10-09,Binge ,69,0,4528,Expense,Leisure & Lifestyle,"Tv, Music & Streaming",DR
2027-10-10,Domino’s Pizza ,105,0,4423,Expense,Leisure & Lifestyle,Takeaway,DR
2027-10-11,Big W ,241,0,4182,Expense,Personal,Children & Family,DR
2027-10-12,The Ivy ,71,0,4111,Expense,Leisure & Lifestyle,Pubs & Bars,DR
2027-10-12,Coles Express ,295,0,3816,Expense,Transport,Fuel,DR
2027-10-12,Kayo Sports ,313,0,3503,Expense,Leisure & Lifestyle,"Tv, Music & Streaming",DR
2027-10-13,Massage Therapy Center ,49,0,3454,Expense,Personal,Health & Medical,DR
2027-10-13,BWS ,140,0,3314,Expense,Leisure & Lifestyle,Alcohol,DR
2027-10-16, NRMA Insurance ,38,0,3276,Expense,Household,Rates & Insurance,DR
2027-10-16,Harris Farm Markets ,262,0,3014,Expense,Household,Groceries,DR
2027-10-17,City Beach ,51,0,2963,Expense,Personal,Clothing & Accessories,DR
2027-10-17,Disney+ ,33,0,2930,Expense,Leisure & Lifestyle,"Tv, Music & Streaming",DR
2027-10-18,Kumon ,190,0,2740,Expense,Personal,Education,DR
2027-10-18,AGL Energy ,56,0,2684,Expense,Household,Utilities,DR
2027-10-21,JAX Tyres ,239,0,2445,Expense,Transport,"Car Insurance, Rego & Maintenance",DR
2027-10-21,Budget Direct Car Insurance ,202,0,2243,Expense,Transport,"Car Insurance, Rego & Maintenance",DR
2027-10-21,Costco ,97,0,2146,Expense,Household,Groceries,DR
2027-10-23,King Swim ,77,0,2069,Expense,Personal,Fitness & Wellbeing,DR
2027-10-25,The Rocks Bar and Pub ,152,0,1917,Expense,Leisure & Lifestyle,Pubs & Bars,DR
2027-10-26,Caltex Woolworths ,124,0,1793,Expense,Transport,Fuel,DR
2027-10-26,Interest Payment from Commonwealth Bank ,13,0,1780,Income,Income,Investments,DR
2027-10-27,Supercheap Auto ,115,0,1665,Expense,Transport,"Car Insurance, Rego & Maintenance",DR
2027-10-28,Beach Café ,108,0,1557,Expense,Leisure & Lifestyle,Restaurants & Cafes,DR
2027-10-28,YMCA ,83,0,1474,Expense,Personal,Fitness & Wellbeing,DR
2027-11-01,Monthly Income,0,6542,8016,Income,Income,Wages,CR
2027-11-02,Zarraffa's Coffee ,226,0,7790,Expense,Leisure & Lifestyle,Restaurants & Cafes,DR
2027-11-02,Big W ,194,0,7596,Expense,Personal,Children & Family,DR
2027-11-03,Rooftop Bar ,343,0,7253,Expense,Leisure & Lifestyle,Pubs & Bars,DR
2027-11-03,The Iconic ,117,0,7136,Expense,Personal,Clothing & Accessories,DR
2027-11-03,Booktopia ,123,0,7013,Expense,Leisure & Lifestyle,Hobbies,DR
2027-11-04,Microsoft 365 ,88,0,6925,Expense,Personal,Education,DR
2027-11-04,Beacon Lighting ,323,0,6602,Expense,Household,Maintenance & Improvements,DR
2027-11-05,Coles ,513,0,6089,Expense,Household,Groceries,DR
2027-11-08,Target ,311,0,5778,Expense,Personal,Clothing & Accessories,DR
2027-11-08,Taronga Zoo ,304,0,5474,Expense,Leisure & Lifestyle,Entertainment,DR
2027-11-08,TerryWhite Chemmart ,388,0,5086,Expense,Personal,Health & Medical,DR
2027-11-10,School Locker ,357,0,4729,Expense,Personal,Children & Family,DR
2027-11-10,Massage Therapy Center ,379,0,4350,Expense,Personal,Health & Medical,DR
2027-11-11,JAX Tyres ,116,0,4234,Expense,Transport,"Car Insurance, Rego & Maintenance",DR
2027-11-11,Rip Curl ,19,0,4215,Expense,Personal,Clothing & Accessories,DR
2027-11-13,Service NSW ,118,0,4097,Expense,Transport,"Car Insurance, Rego & Maintenance",DR
2027-11-14,T2 Tea ,391,0,3706,Expense,Personal,Fitness & Wellbeing,DR
2027-11-15,EnergyAustralia ,139,0,3567,Expense,Household,Utilities,DR
2027-11-17,Country Road ,137,0,3430,Expense,Personal,Clothing & Accessories,DR
2027-11-21,Eat Street Northshore ,340,0,3090,Expense,Leisure & Lifestyle,Pubs & Bars,DR
2027-11-21,Toys 'R' Us ,287,0,2803,Expense,Personal,CHildren & Family,DR
2027-11-21,Westpac Dividend Deposit ,145,0,2658,Income,Income,Investments,DR
2027-11-22,Audible ,208,0,2450,Expense,Leisure & Lifestyle,"Tv, Music & Streaming",DR
2027-11-24,Kayo Sports ,180,0,2270,Expense,Leisure & Lifestyle,"Tv, Music & Streaming",DR
2027-11-24, NSW Land Registry Services ,164,0,2106,Expense,Personal,Life Admin,DR
2027-11-25,eBay Sales Proceeds ,86,0,2020,Income,Income,Other Income,DR
2027-11-25,PayPal Transfer from Sale ,54,0,1966,Income,Income,Other Income,DR
2027-11-28,Who Gives A Crap ,123,0,1843,Expense,Household,Groceries,DR
2027-12-01,Monthly Income,0,6542,8385,Income,Income,Wages,CR
2027-12-02,Shell V Power,46,0,8339,Expense,Transport,Fuel,DR
2027-12-03,Karate for Kids ,275,0,8064,Expense,Personal,Fitness & Wellbeing,DR
2027-12-07, Brisbane City Council ,214,0,7850,Expense,Household,Rates & Insurance,DR
2027-12-07,Stan ,89,0,7761,Expense,Leisure & Lifestyle,"Tv, Music & Streaming",DR
2027-12-08,Massage Therapy Center ,356,0,7405,Expense,Personal,Health & Medical,DR
2027-12-09,Payday Advance ,383,0,7022,Income,Income,Other Income,DR
2027-12-10,Caltex Woolworths ,320,0,6702,Expense,Transport,Fuel,DR
2027-12-10,KU Children's Services ,157,0,6545,Expense,Personal,Children & Family,DR
2027-12-11,Swim Australia ,35,0,6510,Expense,Personal,Fitness & Wellbeing,DR
2027-12-11,G8 Education ,472,0,6038,Expense,Personal,Children & Family,DR
2027-12-14,Childcare Payments ,184,0,5854,Expense,Personal,Children & Family,DR
2027-12-14,Flight Centre ,66,0,5788,Expense,Leisure & Lifestyle,Holidays & Travel,DR
2027-12-14,KU Children's Services ,377,0,5411,Expense,Personal,Children & Family,DR
2027-12-15,Woolworths ,518,0,4893,Expense,Household,Groceries,DR
2027-12-18,Beach Café ,396,0,4497,Expense,Leisure & Lifestyle,Restaurants & Cafes,DR
2027-12-18,Car Wash Cafe ,450,0,4047,Expense,Transport,"Car Insurance, Rego & Maintenance",DR
2027-12-21,Culture Kings ,20,0,4027,Expense,Personal,Clothing & Accessories,DR
2027-12-22,King Swim ,124,0,3903,Expense,Personal,Fitness & Wellbeing,DR
2027-12-24,Who Gives A Crap ,335,0,3568,Expense,Household,Groceries,DR
2027-12-24, Slater and Gordon Lawyers ,241,0,3327,Expense,Personal,Life Admin,DR
2027-12-27,The Baxter Inn ,307,0,3020,Expense,Leisure & Lifestyle,Pubs & Bars,DR
2028-01-01,Monthly Income,0,6542,9562,Income,Income,Wages,CR
2028-01-02,The Body Shop ,751,0,8811,Expense,Personal,Hair & Beauty,DR
2028-01-03,Country Road ,740,0,8071,Expense,Personal,Clothing & Accessories,DR
2028-01-03,Boost Juice Bars ,641,0,7430,Expense,Leisure & Lifestyle,Takeaway,DR
2028-01-03,Big W ,99,0,7331,Expense,Personal,Children & Family,DR
2028-01-04,Shell V Power,601,0,6730,Expense,Transport,Fuel,DR
2028-01-06,Billabong ,110,0,6620,Expense,Personal,Clothing & Accessories,DR
2028-01-06,Rip Curl ,49,0,6571,Expense,Personal,Clothing & Accessories,DR
2028-01-07,BP ,378,0,6193,Expense,Transport,Fuel,DR
2028-01-08,VetLove ,522,0,5671,Expense,Household,Pets,DR
2028-01-08,Salary Deposit from Woolworths Group ,103,0,5568,Income,Income,Wages,DR
2028-01-09,Queensland Urban Utilities ,87,0,5481,Expense,Household,Utilities,DR
2028-01-11,eBay Sales Proceeds ,285,0,5196,Income,Income,Other Income,DR
2028-01-11,National Hearing Care ,369,0,4827,Expense,Personal,Health & Medical,DR
2028-01-12, NRMA Insurance ,137,0,4690,Expense,Household,Rates & Insurance,DR
2028-01-13,Grill’d ,123,0,4567,Expense,Leisure & Lifestyle,Takeaway,DR
2028-01-15,Sea Kayak Tours ,231,0,4336,Expense,Leisure & Lifestyle,Holidays & Travel,DR
2028-01-16,Optometrist ,407,0,3929,Expense,Personal,Health & Medical,DR
2028-01-17,MyCar Tyre & Auto ,72,0,3857,Expense,Transport,"Car Insurance, Rego & Maintenance",DR
2028-01-17,Fernwood Fitness ,108,0,3749,Expense,Personal,Fitness & Wellbeing,DR
2028-01-19,Rental Deposit from RealEstate.com.au ,101,0,3648,Income,Income,Other Income,DR
2028-01-19,Sea Kayak Tours ,172,0,3476,Expense,Leisure & Lifestyle,Holidays & Travel,DR
2028-01-21,Gold's Gym ,248,0,3228,Expense,Personal,Fitness & Wellbeing,DR
2028-01-21,Payday Advance ,99,0,3129,Income,Income,Other Income,DR
2028-01-22,Rip Curl ,24,0,3105,Expense,Personal,Clothing & Accessories,DR
2028-01-22,F45 Training ,164,0,2941,Expense,Personal,Fitness & Wellbeing,DR
2028-01-25,Country Road ,164,0,2777,Expense,Personal,Clothing & Accessories,DR
2028-01-25,Autobarn ,248,0,2529,Expense,Transport,"Car Insurance, Rego & Maintenance",DR
2028-01-27, NSW Land Registry Services ,80,0,2449,Expense,Personal,Life Admin,DR
2028-02-01,Monthly Income,0,6542,8991,Income,Income,Wages,CR
2028-02-06,Car Wash Cafe ,750,0,8241,Expense,Transport,"Car Insurance, Rego & Maintenance",DR
2028-02-06,Beacon Lighting ,401,0,7840,Expense,Household,Maintenance & Improvements,DR
2028-02-07,National Hearing Care ,177,0,7663,Expense,Personal,Health & Medical,DR
2028-02-07, NRMA Insurance ,414,0,7249,Expense,Household,Rates & Insurance,DR
2028-02-07,Harris Farm Markets ,385,0,6864,Expense,Household,Groceries,DR
2028-02-09,Sydney Water ,22,0,6842,Expense,Household,Utilities,DR
2028-02-09,Rip Curl ,521,0,6321,Expense,Personal,Clothing & Accessories,DR
2028-02-10,AustralianSuper Pension ,310,0,6011,Income,Income,Other Income,DR
2028-02-10,OfficeMax ,392,0,5619,Expense,Personal,Life Admin,DR
2028-02-11,Kayo Sports ,298,0,5321,Expense,Leisure & Lifestyle,"Tv, Music & Streaming",DR
2028-02-12,Amazon Prime ,61,0,5260,Expense,Leisure & Lifestyle,"Tv, Music & Streaming",DR
2028-02-13,The Iconic ,459,0,4801,Expense,Personal,Clothing & Accessories,DR
2028-02-19,SEQTA ,407,0,4394,Expense,Personal,Education,DR
2028-02-19,TerryWhite Chemmart ,7,0,4387,Expense,Personal,Health & Medical,DR
2028-02-20,Endota Spa ,211,0,4176,Expense,Personal,Fitness & Wellbeing,DR
2028-02-20,EB Games ,342,0,3834,Expense,Leisure & Lifestyle,"Apps, Games & Software",DR
2028-02-21,City Beach ,55,0,3779,Expense,Personal,Clothing & Accessories,DR
2028-02-21,Gold's Gym ,210,0,3569,Expense,Personal,Fitness & Wellbeing,DR
2028-02-24,Eat Street Northshore ,211,0,3358,Expense,Leisure & Lifestyle,Pubs & Bars,DR
2028-02-24,Green Slip Insurance ,325,0,3033,Expense,Transport,"Car Insurance, Rego & Maintenance",DR
2028-02-24,Service NSW ,123,0,2910,Expense,Transport,"Car Insurance, Rego & Maintenance",DR
2028-02-25,Myer ,65,0,2845,Expense,Personal,Clothing & Accessories,DR
2028-02-26,Harris Farm Markets ,85,0,2760,Expense,Household,Groceries,DR
2028-02-26,Flight Centre ,127,0,2633,Expense,Leisure & Lifestyle,Holidays & Travel,DR
2028-02-27,Acupuncture Clinic ,175,0,2458,Expense,Personal,Health & Medical,DR
2028-02-27,Payday Advance ,131,0,2327,Income,Income,Other Income,DR
2028-02-28,BWS ,173,0,2154,Expense,Leisure & Lifestyle,Alcohol,DR
2028-02-28,South East Water ,25,0,2129,Expense,Household,Utilities,DR
2028-02-28,Aqua Fun Park ,88,0,2041,Expense,Leisure & Lifestyle,Holidays & Travel,DR
2028-03-01,Monthly Income,0,6542,8583,Income,Income,Wages,CR
2028-03-03,Payday Advance ,36,0,8547,Income,Income,Other Income,DR
2028-03-04,Ballet Schools ,40,0,8507,Expense,Personal,Fitness & Wellbeing,DR
2028-03-04, Fantastic Furniture ,342,0,8165,Expense,Household,"Furniture, Electronics & Homewares",DR
2028-03-05,Stand Up Paddleboard Rental ,218,0,7947,Expense,Personal,Fitness & Wellbeing,DR
2028-03-05,BWS ,279,0,7668,Expense,Leisure & Lifestyle,Alcohol,DR
2028-03-05,Camp Australia ,402,0,7266,Expense,Leisure & Lifestyle,Hobbies,DR
2028-03-06, Rentokil ,563,0,6703,Expense,Household,Maintenance & Improvements,DR
2028-03-06,Specsavers ,434,0,6269,Expense,Personal,Health & Medical,DR
2028-03-06,South East Water ,467,0,5802,Expense,Household,Utilities,DR
2028-03-06,Lorna Jane ,9,0,5793,Expense,Personal,Clothing & Accessories,DR
2028-03-07,Menulog ,406,0,5387,Expense,Leisure & Lifestyle,Takeaway,DR
2028-03-07,Crown Perth ,32,0,5355,Expense,Leisure & Lifestyle,Pubs & Bars,DR
2028-03-08,Netflix ,390,0,4965,Expense,Leisure & Lifestyle,"Tv, Music & Streaming",DR
2028-03-09,Crown Perth ,34,0,4931,Expense,Leisure & Lifestyle,Pubs & Bars,DR
2028-03-09,Local Hospital ,67,0,4864,Expense,Personal,Health & Medical,DR
2028-03-09,BrewDog ,213,0,4651,Expense,Leisure & Lifestyle,Alcohol,DR
2028-03-09,Bridgestone Select ,141,0,4510,Expense,Transport,"Car Insurance, Rego & Maintenance",DR
2028-03-12,Eau De Vie ,119,0,4391,Expense,Leisure & Lifestyle,Pubs & Bars,DR
2028-03-12,Green Slip Insurance ,180,0,4211,Expense,Transport,"Car Insurance, Rego & Maintenance",DR
2028-03-13,Big W ,260,0,3951,Expense,Personal,Children & Family,DR
2028-03-14,Barbeques Galore ,85,0,3866,Expense,Household,"Furniture, Electronics & Homewares",DR
2028-03-15,Mathnasium ,305,0,3561,Expense,Personal,Education,DR
2028-03-15,Liquorland ,91,0,3470,Expense,Leisure & Lifestyle,Alcohol,DR
2028-03-16,Chiropractor ,167,0,3303,Expense,Personal,Health & Medical,DR
2028-03-17, Rentokil ,112,0,3191,Expense,Household,Maintenance & Improvements,DR
2028-03-17,Culture Kings ,10,0,3181,Expense,Personal,Clothing & Accessories,DR
2028-03-17,Upwork Freelancer Payment ,153,0,3028,Income,Income,Other Income,DR
2028-03-18,Who Gives A Crap ,222,0,2806,Expense,Household,Groceries,DR
2028-03-18,Ice Cream Parlour ,147,0,2659,Expense,Leisure & Lifestyle,Takeaway,DR
2028-03-19,Zone Bowling ,160,0,2499,Expense,Leisure & Lifestyle,Entertainment,DR
2028-03-20,AustralianSuper Pension ,37,0,2462,Income,Income,Other Income,DR
2028-03-20,Tennis Australia ,9,0,2453,Expense,Personal,Fitness & Wellbeing,DR
2028-03-21,Timezone ,128,0,2325,Expense,Leisure & Lifestyle,Entertainment,DR
2028-03-21,T2 Tea ,89,0,2236,Expense,Personal,Fitness & Wellbeing,DR
2028-03-21, Rentokil ,210,0,2026,Expense,Household,Maintenance & Improvements,DR
2028-03-22,Beachside Caravan Park ,193,0,1833,Expense,Leisure & Lifestyle,Holidays & Travel,DR
2028-03-22,AustralianSuper Pension ,11,0,1822,Income,Income,Other Income,DR
2028-03-22,Eau De Vie ,121,0,1701,Expense,Leisure & Lifestyle,Pubs & Bars,DR
2028-03-23,SEQTA ,122,0,1579,Expense,Personal,Education,DR
2028-03-23,Coles ,119,0,1460,Expense,Household,Groceries,DR
2028-03-23,YMCA ,29,0,1431,Expense,Personal,Fitness & Wellbeing,DR
2028-03-23,Australian Veterinary Association ,144,0,1287,Expense,Household,Pets,DR
2028-03-24,Big W ,74,0,1213,Expense,Personal,Children & Family,DR
2028-03-24,The Good Guys ,23,0,1190,Expense,Household,"Furniture, Electronics & Homewares",DR
2028-03-25,Sunburn Swimwear ,120,0,1070,Expense,Personal,Clothing & Accessories,DR
2028-03-25,BWS ,36,0,1034,Expense,Leisure & Lifestyle,Alcohol,DR
2028-03-25,eBay Sales Proceeds ,42,0,992,Income,Income,Other Income,DR
2028-03-26,Quay Restaurant ,31,0,961,Expense,Leisure & Lifestyle,Pubs & Bars,DR
2028-03-26,Kmart ,83,0,878,Expense,Personal,Children & Family,DR
2028-03-26,Domino’s Pizza ,37,0,841,Expense,Leisure & Lifestyle,Takeaway,DR
2028-03-27,Hungry Jack’s ,35,0,806,Expense,Leisure & Lifestyle,Takeaway,DR
2028-03-28,The Brisbane Hotel ,20,0,786,Expense,Leisure & Lifestyle,Pubs & Bars,DR
2028-03-28,Ladbrokes ,19,0,767,Expense,Leisure & Lifestyle,Lottery & Gambling,DR
2028-03-28,BrewDog ,22,0,745,Expense,Leisure & Lifestyle,Alcohol,DR
2028-03-28,Goodstart Early Learning ,44,0,701,Expense,Personal,Children & Family,DR
2028-04-01,Monthly Income,0,6542,7243,Income,Income,Wages,CR
2028-04-04,Taronga Zoo ,287,0,6956,Expense,Leisure & Lifestyle,Entertainment,DR
2028-04-07,Soccer Clubs ,631,0,6325,Expense,Personal,Fitness & Wellbeing,DR
2028-04-07,JB HiFi,444,0,5881,Expense,Leisure & Lifestyle,Electronics,DR
2028-04-08, Slater and Gordon Lawyers ,534,0,5347,Expense,Personal,Life Admin,DR
2028-04-08,Adobe Creative Cloud ,392,0,4955,Expense,Leisure & Lifestyle,Hobbies,DR
2028-04-14,Origin Energy ,305,0,4650,Expense,Household,Utilities,DR
2028-04-14,Soccer Clubs ,427,0,4223,Expense,Personal,Fitness & Wellbeing,DR
2028-04-15,Ultra Tune ,265,0,3958,Expense,Transport,"Car Insurance, Rego & Maintenance",DR
2028-04-16,eBay Sales Proceeds ,314,0,3644,Income,Income,Other Income,DR
2028-04-17,Childcare Payments ,299,0,3345,Expense,Personal,Children & Family,DR
2028-04-19,Kmart Tyre & Auto Service ,116,0,3229,Expense,Transport,"Car Insurance, Rego & Maintenance",DR
2028-04-20,Repco ,92,0,3137,Expense,Transport,"Car Insurance, Rego & Maintenance",DR
2028-04-23,Cookie ,282,0,2855,Expense,Leisure & Lifestyle,Pubs & Bars,DR
2028-04-24,Priceline Pharmacy ,232,0,2623,Expense,Personal,Health & Medical,DR
2028-04-26,Jetts Fitness ,116,0,2507,Expense,Personal,Fitness & Wellbeing,DR
2028-04-26,Big W ,227,0,2280,Expense,Personal,Children & Family,DR
2028-04-27,KU Children's Services ,43,0,2237,Expense,Personal,Children & Family,DR
2028-04-28,EnergyAustralia ,210,0,2027,Expense,Household,Utilities,DR
2028-04-28,Stan ,95,0,1932,Expense,Leisure & Lifestyle,"Tv, Music & Streaming",DR
2028-04-28,Palace Cinemas ,165,0,1767,Expense,Leisure & Lifestyle,Entertainment,DR
2028-05-01,Monthly Income,0,6542,8309,Income,Income,Wages,CR
2028-05-02,Foxtel ,458,0,7851,Expense,Leisure & Lifestyle,"Tv, Music & Streaming",DR
2028-05-03,Optus ,493,0,7358,Expense,Personal,Mobile Phone,DR
2028-05-03,IKEA ,89,0,7269,Expense,Household,Maintenance & Improvements,DR
2028-05-03,Billabong ,317,0,6952,Expense,Personal,Clothing & Accessories,DR
2028-05-03,Specsavers ,152,0,6800,Expense,Personal,Health & Medical,DR
2028-05-04,Bridgestone Select ,652,0,6148,Expense,Transport,"Car Insurance, Rego & Maintenance",DR
2028-05-05,Dan Murphy’s ,372,0,5776,Expense,Leisure & Lifestyle,Alcohol,DR
2028-05-05,The Brisbane Hotel ,452,0,5324,Expense,Leisure & Lifestyle,Pubs & Bars,DR
2028-05-07,Uber ,518,0,4806,Expense,Transport,Taxies & Share Cars,DR
2028-05-07,CommSec Share Trading Gains ,366,0,4440,Income,Income,Investments,DR
2028-05-08,The Coffee Club ,60,0,4380,Expense,Leisure & Lifestyle,Restaurants & Cafes,DR
2028-05-08,Green Slip Insurance ,239,0,4141,Expense,Transport,"Car Insurance, Rego & Maintenance",DR
2028-05-09,Harvey Norman ,370,0,3771,Expense,Household,"Furniture, Electronics & Homewares",DR
2028-05-10,Costco ,100,0,3671,Expense,Household,Groceries,DR
2028-05-10, EnergyAustralia ,368,0,3303,Expense,Household,Utilities,DR
2028-05-10,Caltex Woolworths ,250,0,3053,Expense,Transport,Fuel,DR
2028-05-11,Adairs ,70,0,2983,Expense,Household,"Furniture, Electronics & Homewares",DR
2028-05-13,Caltex ,36,0,2947,Expense,Transport,Fuel,DR
2028-05-13,Eau De Vie ,137,0,2810,Expense,Leisure & Lifestyle,Pubs & Bars,DR
2028-05-14,Coles Express ,156,0,2654,Expense,Transport,Fuel,DR
2028-05-15,YMCA ,227,0,2427,Expense,Personal,Fitness & Wellbeing,DR
2028-05-16,The Rocks Bar and Pub ,166,0,2261,Expense,Leisure & Lifestyle,Pubs & Bars,DR
2028-05-16,Childcare Payments ,146,0,2115,Expense,Personal,Children & Family,DR
2028-05-17,Centrelink JobSeeker Payment ,122,0,1993,Income,Income,Other Income,DR
2028-05-17,Harris Farm Markets ,129,0,1864,Expense,Household,Groceries,DR
2028-05-17,G8 Education ,167,0,1697,Expense,Personal,Children & Family,DR
2028-05-18,Dymocks ,147,0,1550,Expense,Leisure & Lifestyle,Hobbies,DR
2028-05-18,Bulk Billing Doctor ,44,0,1506,Expense,Personal,Health & Medical,DR
2028-05-18,Caltex ,40,0,1466,Expense,Transport,Fuel,DR
2028-05-19,Hobart Brewing Company ,75,0,1391,Expense,Leisure & Lifestyle,Pubs & Bars,DR
2028-05-19,Domino’s Pizza ,46,0,1345,Expense,Leisure & Lifestyle,Takeaway,DR
2028-05-19,Local Fish and Chips ,95,0,1250,Expense,Leisure & Lifestyle,Takeaway,DR
2028-05-20,NRMA Roadside Assistance ,76,0,1174,Expense,Transport,"Car Insurance, Rego & Maintenance",DR
2028-05-22,Amazon Prime ,6,0,1168,Expense,Leisure & Lifestyle,"Tv, Music & Streaming",DR
2028-05-22, Jim's Mowing ,47,0,1121,Expense,Household,Maintenance & Improvements,DR
2028-05-22,Budget Direct Car Insurance ,88,0,1033,Expense,Transport,"Car Insurance, Rego & Maintenance",DR
2028-05-23,Origin Energy ,82,0,951,Expense,Household,Utilities,DR
2028-05-24,Kayo Sports ,28,0,923,Expense,Leisure & Lifestyle,"Tv, Music & Streaming",DR
2028-05-24, NRMA Insurance ,18,0,905,Expense,Household,Rates & Insurance,DR
2028-05-25,Specsavers ,50,0,855,Expense,Personal,Health & Medical,DR
2028-05-25, Fantastic Furniture ,55,0,800,Expense,Household,"Furniture, Electronics & Homewares",DR
2028-05-27,Adairs ,26,0,774,Expense,Household,"Furniture, Electronics & Homewares",DR
2028-05-27,Optometrist ,14,0,760,Expense,Personal,Health & Medical,DR
2028-05-28,Autobarn ,72,0,688,Expense,Transport,"Car Insurance, Rego & Maintenance",DR
2028-05-28,AGL Energy ,46,0,642,Expense,Household,Utilities,DR
2028-06-01,Monthly Income,0,6542,7184,Income,Income,Wages,CR
2028-06-02,School Locker ,386,0,6798,Expense,Personal,Children & Family,DR
2028-06-03,Gold's Gym ,39,0,6759,Expense,Personal,Fitness & Wellbeing,DR
2028-06-03,Beachside Yoga Classes ,407,0,6352,Expense,Personal,Fitness & Wellbeing,DR
2028-06-04,Target ,51,0,6301,Expense,Personal,Clothing & Accessories,DR
2028-06-04, Commonwealth Bank ,209,0,6092,Expense,Household,Rent & Mortgage,DR
2028-06-05,Beachside Caravan Park ,13,0,6079,Expense,Leisure & Lifestyle,Holidays & Travel,DR
2028-06-05,Optus ,317,0,5762,Expense,Personal,Mobile Phone,DR
2028-06-05,Sea Kayak Tours ,346,0,5416,Expense,Leisure & Lifestyle,Holidays & Travel,DR
2028-06-06,Interest Payment from Commonwealth Bank ,528,0,4888,Income,Income,Investments,DR
2028-06-06, Commonwealth Bank ,223,0,4665,Expense,Household,Rent & Mortgage,DR
2028-06-06,Amazon Prime ,286,0,4379,Expense,Leisure & Lifestyle,"Tv, Music & Streaming",DR
2028-06-08,Bridgestone Select ,287,0,4092,Expense,Transport,"Car Insurance, Rego & Maintenance",DR
2028-06-09,Ladbrokes ,188,0,3904,Expense,Leisure & Lifestyle,Lottery & Gambling,DR
2028-06-09,F45 Training ,278,0,3626,Expense,Personal,Fitness & Wellbeing,DR
2028-06-09,Foxtel ,287,0,3339,Expense,Leisure & Lifestyle,"Tv, Music & Streaming",DR
2028-06-10,Decathlon ,159,0,3180,Expense,Personal,Fitness & Wellbeing,DR
2028-06-10,Harvey Norman ,213,0,2967,Expense,Household,"Furniture, Electronics & Homewares",DR
2028-06-10,Adairs ,150,0,2817,Expense,Household,"Furniture, Electronics & Homewares",DR
2028-06-10,Upwork Freelancer Payment ,166,0,2651,Income,Income,Other Income,DR
2028-06-11,Optus ,172,0,2479,Expense,Personal,Mobile Phone,DR
2028-06-11,Tennis Australia ,114,0,2365,Expense,Personal,Fitness & Wellbeing,DR
2028-06-11,Beachside Caravan Park ,139,0,2226,Expense,Leisure & Lifestyle,Holidays & Travel,DR
2028-06-13,Kumon ,71,0,2155,Expense,Personal,Education,DR
2028-06-14, NRMA Insurance ,127,0,2028,Expense,Household,Rates & Insurance,DR
2028-06-14,Woolworths ,19,0,2009,Expense,Household,Groceries,DR
2028-06-14,Beacon Lighting ,131,0,1878,Expense,Household,Maintenance & Improvements,DR
2028-06-14,Ballet Schools ,101,0,1777,Expense,Personal,Fitness & Wellbeing,DR
2028-06-15,Beachside Yoga Classes ,87,0,1690,Expense,Personal,Fitness & Wellbeing,DR
2028-06-15,Sunnybank Hotel ,54,0,1636,Expense,Leisure & Lifestyle,Pubs & Bars,DR
2028-06-15,Disney+ ,161,0,1475,Expense,Leisure & Lifestyle,"Tv, Music & Streaming",DR
2028-06-17,Kumon ,46,0,1429,Expense,Personal,Education,DR
2028-06-17,MyCar Tyre & Auto ,40,0,1389,Expense,Transport,"Car Insurance, Rego & Maintenance",DR
2028-06-18,Quay Restaurant ,88,0,1301,Expense,Leisure & Lifestyle,Pubs & Bars,DR
2028-06-19,The Coffee Club ,83,0,1218,Expense,Leisure & Lifestyle,Restaurants & Cafes,DR
2028-06-20,Gold's Gym ,86,0,1132,Expense,Personal,Fitness & Wellbeing,DR
2028-06-22,The Body Shop ,17,0,1115,Expense,Personal,Hair & Beauty,DR
2028-06-22, Fantastic Furniture ,80,0,1035,Expense,Household,"Furniture, Electronics & Homewares",DR
2028-06-22,Beachside Yoga Classes ,22,0,1013,Expense,Personal,Fitness & Wellbeing,DR
2028-06-24,Payday Advance ,58,0,955,Income,Income,Other Income,DR
2028-06-24,Camp Australia ,66,0,889,Expense,Leisure & Lifestyle,Hobbies,DR
2028-06-24,IKEA ,82,0,807,Expense,Household,Maintenance & Improvements,DR
2028-06-25,Ladbrokes ,75,0,732,Expense,Leisure & Lifestyle,Lottery & Gambling,DR
2028-06-25,AustralianSuper Pension ,63,0,669,Income,Income,Other Income,DR
2028-06-25,Big W ,17,0,652,Expense,Personal,Children & Family,DR
2028-06-25,Autobarn ,43,0,609,Expense,Transport,"Car Insurance, Rego & Maintenance",DR
2028-06-27,Rooftop Bar ,21,0,588,Expense,Leisure & Lifestyle,Pubs & Bars,DR
2028-06-27,Amazon Prime ,7,0,581,Expense,Leisure & Lifestyle,"Tv, Music & Streaming",DR
2028-06-27,Guardian Childcare & Education ,24,0,557,Expense,Personal,Children & Family,DR
2028-06-27,Sunburn Swimwear ,33,0,524,Expense,Personal,Clothing & Accessories,DR
2028-06-27,Microsoft 365 ,25,0,499,Expense,Personal,Education,DR
2028-06-28,Tennis Australia ,22,0,477,Expense,Personal,Fitness & Wellbeing,DR
2028-07-01,Monthly Income,0,6542,7019,Income,Income,Wages,CR
2028-07-02,Scouts Australia ,448,0,6571,Expense,Leisure & Lifestyle,Hobbies,DR
2028-07-03,Disney+ ,186,0,6385,Expense,Leisure & Lifestyle,"Tv, Music & Streaming",DR
2028-07-03,OfficeMax ,142,0,6243,Expense,Personal,Life Admin,DR
2028-07-03,CommSec Share Trading Gains ,599,0,5644,Income,Income,Investments,DR
2028-07-04,Village Cinemas ,98,0,5546,Expense,Leisure & Lifestyle,Entertainment,DR
2028-07-05,Health Food Store ,396,0,5150,Expense,Personal,Fitness & Wellbeing,DR
2028-07-09,Cookie ,420,0,4730,Expense,Leisure & Lifestyle,Pubs & Bars,DR
2028-07-09,Sea Kayak Tours ,135,0,4595,Expense,Leisure & Lifestyle,Holidays & Travel,DR
2028-07-09,The Baxter Inn ,76,0,4519,Expense,Leisure & Lifestyle,Pubs & Bars,DR
2028-07-09,Binge ,129,0,4390,Expense,Leisure & Lifestyle,"Tv, Music & Streaming",DR
2028-07-09,Audible ,272,0,4118,Expense,Leisure & Lifestyle,"Tv, Music & Streaming",DR
2028-07-09, Jim’s Building Inspections ,142,0,3976,Expense,Household,Maintenance & Improvements,DR
2028-07-11,Hungry Jack’s ,283,0,3693,Expense,Leisure & Lifestyle,Takeaway,DR
2028-07-11,Surfstitch ,171,0,3522,Expense,Personal,Clothing & Accessories,DR
2028-07-11,Platypus Shoes ,242,0,3280,Expense,Personal,Clothing & Accessories,DR
2028-07-12, EnergyAustralia ,151,0,3129,Expense,Household,Utilities,DR
2028-07-14,Grill'd ,59,0,3070,Expense,Leisure & Lifestyle,Takeaway,DR
2028-07-15,Beachside Yoga Classes ,27,0,3043,Expense,Personal,Fitness & Wellbeing,DR
2028-07-15,Aqua Fun Park ,176,0,2867,Expense,Leisure & Lifestyle,Holidays & Travel,DR
2028-07-16,Green Slip Insurance ,87,0,2780,Expense,Transport,"Car Insurance, Rego & Maintenance",DR
2028-07-17,Kayo Sports ,92,0,2688,Expense,Leisure & Lifestyle,"Tv, Music & Streaming",DR
2028-07-17,Pathology Lab ,18,0,2670,Expense,Personal,Health & Medical,DR
2028-07-20,Sylvan Learning ,221,0,2449,Expense,Personal,Education,DR
2028-07-21,Taronga Zoo ,87,0,2362,Expense,Leisure & Lifestyle,Entertainment,DR
2028-07-21, Fantastic Furniture ,103,0,2259,Expense,Household,"Furniture, Electronics & Homewares",DR
2028-07-21,Goodstart Early Learning ,191,0,2068,Expense,Personal,Children & Family,DR
2028-07-24,Kmart ,122,0,1946,Expense,Personal,Children & Family,DR
2028-07-25,Zone Bowling ,45,0,1901,Expense,Leisure & Lifestyle,Entertainment,DR
2028-07-28,Karate for Kids ,91,0,1810,Expense,Personal,Fitness & Wellbeing,DR
2028-07-28,Centrelink JobSeeker Payment ,59,0,1751,Income,Income,Other Income,DR
2028-07-28,McDonald’s ,7,0,1744,Expense,Leisure & Lifestyle,Takeaway,DR
2028-08-01,Monthly Income,0,6542,8286,Income,Income,Wages,CR
2028-08-02,BWS ,282,0,8004,Expense,Leisure & Lifestyle,Alcohol,DR
2028-08-03,SEQTA ,279,0,7725,Expense,Personal,Education,DR
2028-08-03,Kayo Sports ,414,0,7311,Expense,Leisure & Lifestyle,"Tv, Music & Streaming",DR
2028-08-04,Liquorland ,106,0,7205,Expense,Leisure & Lifestyle,Alcohol,DR
2028-08-05,South East Water ,36,0,7169,Expense,Household,Utilities,DR
2028-08-05,Woolworths ,414,0,6755,Expense,Household,Groceries,DR
2028-08-06,Sunburn Swimwear ,484,0,6271,Expense,Personal,Clothing & Accessories,DR
2028-08-06,Service NSW ,154,0,6117,Expense,Transport,"Car Insurance, Rego & Maintenance",DR
2028-08-07,Queensland Urban Utilities ,419,0,5698,Expense,Household,Utilities,DR
2028-08-07,Adobe Creative Cloud ,331,0,5367,Expense,Leisure & Lifestyle,Hobbies,DR
2028-08-08,Sea Kayak Tours ,467,0,4900,Expense,Leisure & Lifestyle,Holidays & Travel,DR
2028-08-10,Rooftop Bar ,414,0,4486,Expense,Leisure & Lifestyle,Pubs & Bars,DR
2028-08-11,Café Nero ,316,0,4170,Expense,Leisure & Lifestyle,Restaurants & Cafes,DR
2028-08-12, NSW Land Registry Services ,409,0,3761,Expense,Personal,Life Admin,DR
2028-08-15,Local Hospital ,306,0,3455,Expense,Personal,Health & Medical,DR
2028-08-16,JAX Tyres ,273,0,3182,Expense,Transport,"Car Insurance, Rego & Maintenance",DR
2028-08-17,Chemist Warehouse ,59,0,3123,Expense,Personal,Health & Medical,DR
2028-08-19,Who Gives A Crap ,202,0,2921,Expense,Household,Groceries,DR
2028-08-24,Harris Farm Markets ,102,0,2819,Expense,Household,Groceries,DR
2028-08-24,Stand Up Paddleboard Rental ,162,0,2657,Expense,Personal,Fitness & Wellbeing,DR
2028-08-24, Rentokil ,159,0,2498,Expense,Household,Maintenance & Improvements,DR
2028-08-24,Gardening Australia ,13,0,2485,Expense,Household,Maintenance & Improvements,DR
2028-08-25,Swim Australia ,121,0,2364,Expense,Personal,Fitness & Wellbeing,DR
2028-08-26, National Bank ,70,0,2294,Expense,Personal,Fees & Charges,DR
2028-08-26,Rip Curl ,83,0,2211,Expense,Personal,Clothing & Accessories,DR
2028-09-01,Monthly Income,0,6542,8753,Income,Income,Wages,CR
2028-09-03,Campion Education ,128,0,8625,Expense,Personal,Children & Family,DR
2028-09-03, Rentokil ,572,0,8053,Expense,Household,Maintenance & Improvements,DR
2028-09-04,Guzman y Gomez ,351,0,7702,Expense,Leisure & Lifestyle,Takeaway,DR
2028-09-04,Uber ,98,0,7604,Expense,Transport,Taxies & Share Cars,DR
2028-09-04,Eau De Vie ,28,0,7576,Expense,Leisure & Lifestyle,Pubs & Bars,DR
2028-09-05,Caltex ,82,0,7494,Expense,Transport,Fuel,DR
2028-09-08, Fantastic Furniture ,158,0,7336,Expense,Household,"Furniture, Electronics & Homewares",DR
2028-09-08,BWS ,123,0,7213,Expense,Leisure & Lifestyle,Alcohol,DR
2028-09-09,Queensland Urban Utilities ,168,0,7045,Expense,Household,Utilities,DR
2028-09-10,Sea Kayak Tours ,302,0,6743,Expense,Leisure & Lifestyle,Holidays & Travel,DR
2028-09-10,Ballet Schools ,133,0,6610,Expense,Personal,Fitness & Wellbeing,DR
2028-09-10,Service NSW ,27,0,6583,Expense,Transport,"Car Insurance, Rego & Maintenance",DR
2028-09-11,VetLove ,416,0,6167,Expense,Household,Pets,DR
2028-09-11,Payday Advance ,72,0,6095,Income,Income,Other Income,DR
2028-09-12,The Ivy ,10,0,6085,Expense,Leisure & Lifestyle,Pubs & Bars,DR
2028-09-12,Kmart ,106,0,5979,Expense,Personal,Children & Family,DR
2028-09-12,Culture Kings ,148,0,5831,Expense,Personal,Clothing & Accessories,DR
2028-09-12,The Ivy ,527,0,5304,Expense,Leisure & Lifestyle,Pubs & Bars,DR
2028-09-13,Chinatown Night Market ,16,0,5288,Expense,Leisure & Lifestyle,Pubs & Bars,DR
2028-09-15,Australian Veterinary Association ,166,0,5122,Expense,Household,Pets,DR
2028-09-15,Sylvan Learning ,496,0,4626,Expense,Personal,Education,DR
2028-09-15,Adairs ,125,0,4501,Expense,Household,"Furniture, Electronics & Homewares",DR
2028-09-16,Culture Kings ,287,0,4214,Expense,Personal,Clothing & Accessories,DR
2028-09-16,Target ,250,0,3964,Expense,Personal,Clothing & Accessories,DR
2028-09-16,Stand Up Paddleboard Rental ,197,0,3767,Expense,Personal,Fitness & Wellbeing,DR
2028-09-17,McDonald’s ,122,0,3645,Expense,Leisure & Lifestyle,Takeaway,DR
2028-09-19,Spotify ,357,0,3288,Expense,Leisure & Lifestyle,"Tv, Music & Streaming",DR
2028-09-20,Sylvan Learning ,125,0,3163,Expense,Personal,Education,DR
2028-09-20,Dan Murphy’s ,172,0,2991,Expense,Leisure & Lifestyle,Alcohol,DR
2028-09-21,Ladbrokes ,35,0,2956,Expense,Leisure & Lifestyle,Lottery & Gambling,DR
2028-09-21,National Hearing Care ,35,0,2921,Expense,Personal,Health & Medical,DR
2028-09-21,Bunnings Warehouse ,139,0,2782,Expense,Household,Maintenance & Improvements,DR
2028-09-21,Surfstitch ,138,0,2644,Expense,Personal,Clothing & Accessories,DR
2028-09-22, Slater and Gordon Lawyers ,25,0,2619,Expense,Personal,Life Admin,DR
2028-09-22,The Espy ,216,0,2403,Expense,Leisure & Lifestyle,Pubs & Bars,DR
2028-09-23,Pizza Hut ,194,0,2209,Expense,Leisure & Lifestyle,Takeaway,DR
2028-09-23,Rip Curl ,14,0,2195,Expense,Personal,Clothing & Accessories,DR
2028-09-24,Decathlon ,39,0,2156,Expense,Personal,Fitness & Wellbeing,DR
2028-09-24,Kayo Sports ,38,0,2118,Expense,Leisure & Lifestyle,"Tv, Music & Streaming",DR
2028-09-25,McDonald’s ,212,0,1906,Expense,Leisure & Lifestyle,Takeaway,DR
2028-09-25,Uber ,118,0,1788,Expense,Transport,Taxies & Share Cars,DR
2028-09-25,The Rocks Bar and Pub ,175,0,1613,Expense,Leisure & Lifestyle,Pubs & Bars,DR
2028-09-26,Apple Store ,47,0,1566,Expense,Leisure & Lifestyle,Electronics,DR
2028-09-26,F45 Training ,102,0,1464,Expense,Personal,Fitness & Wellbeing,DR
2028-09-26,JB HiFi,83,0,1381,Expense,Leisure & Lifestyle,Electronics,DR
2028-09-26,Acupuncture Clinic ,54,0,1327,Expense,Personal,Health & Medical,DR
2028-09-26,Upwork Freelancer Payment ,66,0,1261,Income,Income,Other Income,DR
2028-09-26, Metricon ,45,0,1216,Expense,Household,Maintenance & Improvements,DR
2028-09-27,OfficeMax ,33,0,1183,Expense,Personal,Life Admin,DR
2028-09-27,Endota Spa ,6,0,1177,Expense,Personal,Fitness & Wellbeing,DR
2028-09-28,Platypus Shoes ,51,0,1126,Expense,Personal,Clothing & Accessories,DR
2028-09-28,Supercheap Auto ,98,0,1028,Expense,Transport,"Car Insurance, Rego & Maintenance",DR
2028-10-01,Monthly Income,0,6542,7570,Income,Income,Wages,CR
2028-10-02,Quay Restaurant ,355,0,7215,Expense,Leisure & Lifestyle,Pubs & Bars,DR
2028-10-03,Airbnb Host Income ,168,0,7047,Income,Income,Other Income,DR
2028-10-03,F45 Training ,207,0,6840,Expense,Personal,Fitness & Wellbeing,DR
2028-10-04,Sea Kayak Tours ,372,0,6468,Expense,Leisure & Lifestyle,Holidays & Travel,DR
2028-10-05,JB HiFi,625,0,5843,Expense,Leisure & Lifestyle,Electronics,DR
2028-10-05,ATO Tax Refund ,159,0,5684,Income,Income,Other Income,DR
2028-10-05,PayPal Transfer from Sale ,220,0,5464,Income,Income,Other Income,DR
2028-10-07,Event Cinemas ,369,0,5095,Expense,Leisure & Lifestyle,Entertainment,DR
2028-10-07,Beach Café ,419,0,4676,Expense,Leisure & Lifestyle,Restaurants & Cafes,DR
2028-10-08,NRMA Roadside Assistance ,125,0,4551,Expense,Transport,"Car Insurance, Rego & Maintenance",DR
2028-10-08,G8 Education ,306,0,4245,Expense,Personal,Children & Family,DR
2028-10-08,Salary Deposit from Woolworths Group ,40,0,4205,Income,Income,Wages,DR
2028-10-09,Caltex ,167,0,4038,Expense,Transport,Fuel,DR
2028-10-09,Service NSW ,344,0,3694,Expense,Transport,"Car Insurance, Rego & Maintenance",DR
2028-10-10, NSW Land Registry Services ,28,0,3666,Expense,Personal,Life Admin,DR
2028-10-11,TerryWhite Chemmart ,76,0,3590,Expense,Personal,Health & Medical,DR
2028-10-11,Airbnb Host Income ,130,0,3460,Income,Income,Other Income,DR
2028-10-11,Big W ,82,0,3378,Expense,Personal,Children & Family,DR
2028-10-11,The Baxter Inn ,316,0,3062,Expense,Leisure & Lifestyle,Pubs & Bars,DR
2028-10-12,Optometrist ,222,0,2840,Expense,Personal,Health & Medical,DR
2028-10-12,Surfstitch ,131,0,2709,Expense,Personal,Clothing & Accessories,DR
2028-10-14,Supercheap Auto ,38,0,2671,Expense,Transport,"Car Insurance, Rego & Maintenance",DR
2028-10-15,Bunnings Warehouse ,123,0,2548,Expense,Household,Maintenance & Improvements,DR
2028-10-16,Service NSW ,214,0,2334,Expense,Transport,"Car Insurance, Rego & Maintenance",DR
2028-10-16,Rooftop Bar ,105,0,2229,Expense,Leisure & Lifestyle,Pubs & Bars,DR
2028-10-16,Sydney Water ,212,0,2017,Expense,Household,Utilities,DR
2028-10-16,AGL Energy ,84,0,1933,Expense,Household,Utilities,DR
2028-10-17,The Victory Hotel ,128,0,1805,Expense,Leisure & Lifestyle,Pubs & Bars,DR
2028-10-17, NSW Land Registry Services ,51,0,1754,Expense,Personal,Life Admin,DR
2028-10-18,Gardening Australia ,160,0,1594,Expense,Household,Maintenance & Improvements,DR
2028-10-18,Domino’s Pizza ,33,0,1561,Expense,Leisure & Lifestyle,Takeaway,DR
2028-10-18,Ladbrokes ,56,0,1505,Expense,Leisure & Lifestyle,Lottery & Gambling,DR
2028-10-18,Goodstart Early Learning ,78,0,1427,Expense,Personal,Children & Family,DR
2028-10-19,KU Children's Services ,89,0,1338,Expense,Personal,Children & Family,DR
2028-10-19,CommSec Share Trading Gains ,53,0,1285,Income,Income,Investments,DR
2028-10-19,The Victory Hotel ,45,0,1240,Expense,Leisure & Lifestyle,Pubs & Bars,DR
2028-10-20,Medicare Claim ,29,0,1211,Expense,Personal,Health & Medical,DR
2028-10-20,Lorna Jane ,16,0,1195,Expense,Personal,Clothing & Accessories,DR
2028-10-20,Australian Veterinary Association ,35,0,1160,Expense,Household,Pets,DR
2028-10-21,The Ivy ,89,0,1071,Expense,Leisure & Lifestyle,Pubs & Bars,DR
2028-10-21,Café Nero ,55,0,1016,Expense,Leisure & Lifestyle,Restaurants & Cafes,DR
2028-10-22,Grill’d ,41,0,975,Expense,Leisure & Lifestyle,Takeaway,DR
2028-10-23,Caltex ,34,0,941,Expense,Transport,Fuel,DR
2028-10-24,VicRoads ,87,0,854,Expense,Transport,"Car Insurance, Rego & Maintenance",DR
2028-10-25,Menulog ,70,0,784,Expense,Leisure & Lifestyle,Takeaway,DR
2028-10-25,Taronga Zoo ,21,0,763,Expense,Leisure & Lifestyle,Entertainment,DR
2028-10-25,ATO Tax Refund ,68,0,695,Income,Income,Other Income,DR
2028-10-26,Kmart Tyre & Auto Service ,13,0,682,Expense,Transport,"Car Insurance, Rego & Maintenance",DR
2028-10-27,Timezone ,26,0,656,Expense,Leisure & Lifestyle,Entertainment,DR
2028-10-27,Amazon Prime ,16,0,640,Expense,Leisure & Lifestyle,"Tv, Music & Streaming",DR
2028-10-28,Stand Up Paddleboard Rental ,52,0,588,Expense,Personal,Fitness & Wellbeing,DR
2028-10-28,Stand Up Paddleboard Rental ,26,0,562,Expense,Personal,Fitness & Wellbeing,DR
2028-10-28,Montessori Schools ,56,0,506,Expense,Personal,Education,DR
2028-11-01,Monthly Income,0,6542,7048,Income,Income,Wages,CR
2028-11-02,Big W ,343,0,6705,Expense,Personal,Children & Family,DR
2028-11-02, National Bank ,660,0,6045,Expense,Personal,Fees & Charges,DR
2028-11-04,Microsoft 365 ,126,0,5919,Expense,Personal,Education,DR
2028-11-06,Tennis Australia ,586,0,5333,Expense,Personal,Fitness & Wellbeing,DR
2028-11-06,Catholic Education Office ,288,0,5045,Expense,Personal,Education,DR
2028-11-08,Eat Street Northshore ,299,0,4746,Expense,Leisure & Lifestyle,Pubs & Bars,DR
2028-11-10,Apple Store ,286,0,4460,Expense,Leisure & Lifestyle,Electronics,DR
2028-11-10,Priceline Pharmacy ,186,0,4274,Expense,Personal,Health & Medical,DR
2028-11-15,TerryWhite Chemmart ,229,0,4045,Expense,Personal,Health & Medical,DR
2028-11-16,Local Hospital ,23,0,4022,Expense,Personal,Health & Medical,DR
2028-11-17,Kmart ,349,0,3673,Expense,Personal,Children & Family,DR
2028-11-18,The Athlete's Foot ,121,0,3552,Expense,Personal,Clothing & Accessories,DR
2028-11-19,Priceline Pharmacy ,253,0,3299,Expense,Personal,Health & Medical,DR
2028-11-21,Ultra Tune ,62,0,3237,Expense,Transport,"Car Insurance, Rego & Maintenance",DR
2028-11-23,Rental Deposit from RealEstate.com.au ,86,0,3151,Income,Income,Other Income,DR
2028-11-25,Stan ,248,0,2903,Expense,Leisure & Lifestyle,"Tv, Music & Streaming",DR
2028-11-25,Jetts Fitness ,78,0,2825,Expense,Personal,Fitness & Wellbeing,DR
2028-11-26,Adobe Creative Cloud ,266,0,2559,Expense,Leisure & Lifestyle,Hobbies,DR
2028-11-27,VetLove ,172,0,2387,Expense,Household,Pets,DR
2028-11-27,BP ,164,0,2223,Expense,Transport,Fuel,DR
2028-12-01,Monthly Income,0,6542,8765,Income,Income,Wages,CR
2028-12-02,Boost Juice Bars ,661,0,8104,Expense,Leisure & Lifestyle,Takeaway,DR
2028-12-05,Greencross Vets ,53,0,8051,Expense,Household,Pets,DR
2028-12-05,Hungry Jack’s ,714,0,7337,Expense,Leisure & Lifestyle,Takeaway,DR
2028-12-05,The Athlete's Foot ,541,0,6796,Expense,Personal,Clothing & Accessories,DR
2028-12-06,Local Hospital ,142,0,6654,Expense,Personal,Health & Medical,DR
2028-12-06,Quay Restaurant ,662,0,5992,Expense,Leisure & Lifestyle,Pubs & Bars,DR
2028-12-07,David Jones ,452,0,5540,Expense,Personal,Clothing & Accessories,DR
2028-12-07,Caltex ,87,0,5453,Expense,Transport,Fuel,DR
2028-12-08,Beach Café ,334,0,5119,Expense,Leisure & Lifestyle,Restaurants & Cafes,DR
2028-12-09,Spotify ,197,0,4922,Expense,Leisure & Lifestyle,"Tv, Music & Streaming",DR
2028-12-11,AustralianSuper Pension ,161,0,4761,Income,Income,Other Income,DR
2028-12-11,Physiotherapy Clinic ,302,0,4459,Expense,Personal,Health & Medical,DR
2028-12-12,Boost Juice Bars ,360,0,4099,Expense,Leisure & Lifestyle,Takeaway,DR
2028-12-13,G8 Education ,143,0,3956,Expense,Personal,Children & Family,DR
2028-12-13,The Good Guys ,196,0,3760,Expense,Household,"Furniture, Electronics & Homewares",DR
2028-12-13,Australian Veterinary Association ,108,0,3652,Expense,Household,Pets,DR
2028-12-15,Shell V Power,99,0,3553,Expense,Transport,Fuel,DR
2028-12-16,Chiropractor ,315,0,3238,Expense,Personal,Health & Medical,DR
2028-12-16,Caltex ,148,0,3090,Expense,Transport,Fuel,DR
2028-12-17,Scouts Australia ,283,0,2807,Expense,Leisure & Lifestyle,Hobbies,DR
2028-12-17,MyCar Tyre & Auto ,261,0,2546,Expense,Transport,"Car Insurance, Rego & Maintenance",DR
2028-12-17,Coles ,66,0,2480,Expense,Household,Groceries,DR
2028-12-17, The Good Guys ,191,0,2289,Expense,Household,"Furniture, Electronics & Homewares",DR
2028-12-17, BSA Ltd ,31,0,2258,Expense,Household,Maintenance & Improvements,DR
2028-12-18, BSA Ltd ,103,0,2155,Expense,Household,Maintenance & Improvements,DR
2028-12-18,The Coffee Club ,99,0,2056,Expense,Leisure & Lifestyle,Restaurants & Cafes,DR
2028-12-18,The Australian ,190,0,1866,Expense,Personal,Education,DR
2028-12-19,IKEA ,186,0,1680,Expense,Household,Maintenance & Improvements,DR
2028-12-20,Beachside Yoga Classes ,76,0,1604,Expense,Personal,Fitness & Wellbeing,DR
2028-12-20,Camp Australia ,148,0,1456,Expense,Leisure & Lifestyle,Hobbies,DR
2028-12-20,ALDI ,94,0,1362,Expense,Household,Groceries,DR
2028-12-21,CommSec Share Trading Gains ,16,0,1346,Income,Income,Investments,DR
2028-12-21,Massage Therapy Center ,41,0,1305,Expense,Personal,Health & Medical,DR
2028-12-23,Pathology Lab ,13,0,1292,Expense,Personal,Health & Medical,DR
2028-12-24,OfficeMax ,103,0,1189,Expense,Personal,Life Admin,DR
2028-12-25,Kumon ,94,0,1095,Expense,Personal,Education,DR
2028-12-25,Acupuncture Clinic ,98,0,997,Expense,Personal,Health & Medical,DR
2028-12-25,David Jones ,23,0,974,Expense,Personal,Clothing & Accessories,DR
2028-12-26,Foxtel ,81,0,893,Expense,Leisure & Lifestyle,"Tv, Music & Streaming",DR
2028-12-28,Hungry Jack’s ,12,0,881,Expense,Leisure & Lifestyle,Takeaway,DR
2028-12-28,Uber ,19,0,862,Expense,Transport,Taxies & Share Cars,DR
2029-01-01,Monthly Income,0,6542,7404,Income,Income,Wages,CR
2029-01-02,Car Wash Cafe ,624,0,6780,Expense,Transport,"Car Insurance, Rego & Maintenance",DR
2029-01-02,Child Support Agency Deposit ,254,0,6526,Income,Income,Other Income,DR
2029-01-04,Surfstitch ,70,0,6456,Expense,Personal,Clothing & Accessories,DR
2029-01-05,Catholic Education Office ,344,0,6112,Expense,Personal,Education,DR
2029-01-05,South East Water ,517,0,5595,Expense,Household,Utilities,DR
2029-01-06,Origin Energy ,406,0,5189,Expense,Household,Utilities,DR
2029-01-06,Tabcorp ,355,0,4834,Expense,Leisure & Lifestyle,Lottery & Gambling,DR
2029-01-07,Foxtel ,234,0,4600,Expense,Leisure & Lifestyle,"Tv, Music & Streaming",DR
2029-01-07,Ballet Schools ,319,0,4281,Expense,Personal,Fitness & Wellbeing,DR
2029-01-07,Lorna Jane ,373,0,3908,Expense,Personal,Clothing & Accessories,DR
2029-01-08,Freedom Furniture ,172,0,3736,Expense,Household,Maintenance & Improvements,DR
2029-01-08,Country Road ,358,0,3378,Expense,Personal,Clothing & Accessories,DR
2029-01-08,Domino’s Pizza ,182,0,3196,Expense,Leisure & Lifestyle,Takeaway,DR
2029-01-08,ALDI ,215,0,2981,Expense,Household,Groceries,DR
2029-01-08,Audible ,125,0,2856,Expense,Leisure & Lifestyle,"Tv, Music & Streaming",DR
2029-01-08,The Rocks Bar and Pub ,96,0,2760,Expense,Leisure & Lifestyle,Pubs & Bars,DR
2029-01-10,Zarraffa's Coffee ,274,0,2486,Expense,Leisure & Lifestyle,Restaurants & Cafes,DR
2029-01-11,BWS ,18,0,2468,Expense,Leisure & Lifestyle,Alcohol,DR
2029-01-11,NRMA Roadside Assistance ,50,0,2418,Expense,Transport,"Car Insurance, Rego & Maintenance",DR
2029-01-11,Woolworths ,45,0,2373,Expense,Household,Groceries,DR
2029-01-11,Audible ,152,0,2221,Expense,Leisure & Lifestyle,"Tv, Music & Streaming",DR
2029-01-11,Beachside Caravan Park ,212,0,2009,Expense,Leisure & Lifestyle,Holidays & Travel,DR
2029-01-12,Green Slip Insurance ,114,0,1895,Expense,Transport,"Car Insurance, Rego & Maintenance",DR
2029-01-12, Ray White Real Estate ,70,0,1825,Expense,Personal,Life Admin,DR
2029-01-12,Sunburn Swimwear ,72,0,1753,Expense,Personal,Clothing & Accessories,DR
2029-01-12,Health Food Store ,12,0,1741,Expense,Personal,Fitness & Wellbeing,DR
2029-01-12,Ice Cream Parlour ,64,0,1677,Expense,Leisure & Lifestyle,Takeaway,DR
2029-01-13,Little Athletics ,141,0,1536,Expense,Personal,Fitness & Wellbeing,DR
2029-01-13,Ice Cream Parlour ,110,0,1426,Expense,Leisure & Lifestyle,Takeaway,DR
2029-01-13,Timezone ,15,0,1411,Expense,Leisure & Lifestyle,Entertainment,DR
2029-01-14,Muffin Break ,137,0,1274,Expense,Leisure & Lifestyle,Restaurants & Cafes,DR
2029-01-14,Ladbrokes ,100,0,1174,Expense,Leisure & Lifestyle,Lottery & Gambling,DR
2029-01-14,KU Children's Services ,17,0,1157,Expense,Personal,Children & Family,DR
2029-01-14,BWS ,69,0,1088,Expense,Leisure & Lifestyle,Alcohol,DR
2029-01-14,Kmart ,24,0,1064,Expense,Personal,Children & Family,DR
2029-01-16,Gardening Australia ,79,0,985,Expense,Household,Maintenance & Improvements,DR
2029-01-16,Sea Life Aquarium ,6,0,979,Expense,Leisure & Lifestyle,Entertainment,DR
2029-01-16,The Victory Hotel ,53,0,926,Expense,Leisure & Lifestyle,Pubs & Bars,DR
2029-01-17,Stan ,77,0,849,Expense,Leisure & Lifestyle,"Tv, Music & Streaming",DR
2029-01-17,Kmart ,9,0,840,Expense,Personal,Children & Family,DR
2029-01-18,Rip Curl ,38,0,802,Expense,Personal,Clothing & Accessories,DR
2029-01-19,Origin Energy ,26,0,776,Expense,Household,Utilities,DR
2029-01-19,EB Games ,51,0,725,Expense,Leisure & Lifestyle,"Apps, Games & Software",DR
2029-01-19,Queensland Urban Utilities ,22,0,703,Expense,Household,Utilities,DR
2029-01-19,Catholic Education Office ,70,0,633,Expense,Personal,Education,DR
2029-01-19,Menulog ,13,0,620,Expense,Leisure & Lifestyle,Takeaway,DR
2029-01-20,QBE Insurance Claim Payout ,56,0,564,Income,Income,Other Income,DR
2029-01-21,Queensland Urban Utilities ,6,0,558,Expense,Household,Utilities,DR
2029-01-22,Centrelink JobSeeker Payment ,6,0,552,Income,Income,Other Income,DR
2029-01-23,Australian Veterinary Association ,8,0,544,Expense,Household,Pets,DR
2029-01-23,Tabcorp ,50,0,494,Expense,Leisure & Lifestyle,Lottery & Gambling,DR
2029-01-23,Pathology Lab ,22,0,472,Expense,Personal,Health & Medical,DR
2029-01-23, NSW Land Registry Services ,17,0,455,Expense,Personal,Life Admin,DR
2029-01-25,Optometrist ,20,0,435,Expense,Personal,Health & Medical,DR
2029-01-27,Barbeques Galore ,39,0,396,Expense,Household,"Furniture, Electronics & Homewares",DR
2029-01-27, Jim’s Building Inspections ,37,0,359,Expense,Household,Maintenance & Improvements,DR
2029-01-27,Jetts Fitness ,12,0,347,Expense,Personal,Fitness & Wellbeing,DR
2029-01-28, NSW Land Registry Services ,29,0,318,Expense,Personal,Life Admin,DR
2029-01-28,Officeworks ,6,0,312,Expense,Personal,Life Admin,DR
2029-02-01,Monthly Income,0,6542,6854,Income,Income,Wages,CR
2029-02-02,Gold's Gym ,420,0,6434,Expense,Personal,Fitness & Wellbeing,DR
2029-02-03,Hobart Brewing Company ,578,0,5856,Expense,Leisure & Lifestyle,Pubs & Bars,DR
2029-02-04,QBE Insurance Claim Payout ,63,0,5793,Income,Income,Other Income,DR
2029-02-04,City Beach ,10,0,5783,Expense,Personal,Clothing & Accessories,DR
2029-02-05,The Athlete's Foot ,83,0,5700,Expense,Personal,Clothing & Accessories,DR
2029-02-07,IKEA ,322,0,5378,Expense,Household,Maintenance & Improvements,DR
2029-02-07,Rooftop Bar ,340,0,5038,Expense,Leisure & Lifestyle,Pubs & Bars,DR
2029-02-07,Coles Express ,461,0,4577,Expense,Transport,Fuel,DR
2029-02-08,AustralianSuper Pension ,118,0,4459,Income,Income,Other Income,DR
2029-02-08,Booktopia ,37,0,4422,Expense,Leisure & Lifestyle,Hobbies,DR
2029-02-08,ATO Tax Refund ,165,0,4257,Income,Income,Other Income,DR
2029-02-09,Rooftop Bar ,50,0,4207,Expense,Leisure & Lifestyle,Pubs & Bars,DR
2029-02-09,Priceline Pharmacy ,407,0,3800,Expense,Personal,Health & Medical,DR
2029-02-09,Medicare Claim ,71,0,3729,Expense,Personal,Health & Medical,DR
2029-02-10, Jim’s Building Inspections ,292,0,3437,Expense,Household,Maintenance & Improvements,DR
2029-02-10,The Rocks Bar and Pub ,118,0,3319,Expense,Leisure & Lifestyle,Pubs & Bars,DR
2029-02-10,Beachfront Markets ,72,0,3247,Expense,Personal,Clothing & Accessories,DR
2029-02-10,Kumon ,100,0,3147,Expense,Personal,Education,DR
2029-02-10, Ray White Real Estate ,109,0,3038,Expense,Personal,Life Admin,DR
2029-02-10,Netflix ,6,0,3032,Expense,Leisure & Lifestyle,"Tv, Music & Streaming",DR
2029-02-11,Gardening Australia ,295,0,2737,Expense,Household,Maintenance & Improvements,DR
2029-02-11,Toys 'R' Us ,37,0,2700,Expense,Personal,CHildren & Family,DR
2029-02-12,Quay Restaurant ,14,0,2686,Expense,Leisure & Lifestyle,Pubs & Bars,DR
2029-02-12,Snap Fitness ,110,0,2576,Expense,Personal,Fitness & Wellbeing,DR
2029-02-13,Swim Australia ,89,0,2487,Expense,Personal,Fitness & Wellbeing,DR
2029-02-14,The Athlete's Foot ,67,0,2420,Expense,Personal,Clothing & Accessories,DR
2029-02-14,Apple Store ,91,0,2329,Expense,Leisure & Lifestyle,Electronics,DR
2029-02-14,Child Support Agency Deposit ,70,0,2259,Income,Income,Other Income,DR
2029-02-15,King Swim ,38,0,2221,Expense,Personal,Fitness & Wellbeing,DR
2029-02-15,Palace Cinemas ,21,0,2200,Expense,Leisure & Lifestyle,Entertainment,DR
2029-02-15,Spotlight ,20,0,2180,Expense,Leisure & Lifestyle,Hobbies,DR
2029-02-15,Hungry Jack’s ,20,0,2160,Expense,Leisure & Lifestyle,Takeaway,DR
2029-02-16,Tabcorp ,136,0,2024,Expense,Leisure & Lifestyle,Lottery & Gambling,DR
2029-02-18,Goodstart Early Learning ,133,0,1891,Expense,Personal,Children & Family,DR
2029-02-18,Beach Café ,31,0,1860,Expense,Leisure & Lifestyle,Restaurants & Cafes,DR
2029-02-20,Cookie ,11,0,1849,Expense,Leisure & Lifestyle,Pubs & Bars,DR
2029-02-21,Kumon ,164,0,1685,Expense,Personal,Education,DR
2029-02-22,Lorna Jane ,77,0,1608,Expense,Personal,Clothing & Accessories,DR
2029-02-22,Kayo Sports ,42,0,1566,Expense,Leisure & Lifestyle,"Tv, Music & Streaming",DR
2029-02-23,Domino’s Pizza ,151,0,1415,Expense,Leisure & Lifestyle,Takeaway,DR
2029-02-23,EB Games ,104,0,1311,Expense,Leisure & Lifestyle,"Apps, Games & Software",DR
2029-02-23,Target ,115,0,1196,Expense,Personal,Clothing & Accessories,DR
2029-02-25,Woolworths ,13,0,1183,Expense,Household,Groceries,DR
2029-02-25,Boost Juice Bars ,13,0,1170,Expense,Leisure & Lifestyle,Takeaway,DR
2029-02-26,ABC Reading Eggs ,12,0,1158,Expense,Personal,Education,DR
2029-02-26, Jim's Mowing ,97,0,1061,Expense,Household,Maintenance & Improvements,DR
2029-02-27,Telstra ,49,0,1012,Expense,Personal,Mobile Phone,DR
2029-02-28,Karate for Kids ,92,0,920,Expense,Personal,Fitness & Wellbeing,DR
2029-02-28,Beachside Caravan Park ,36,0,884,Expense,Leisure & Lifestyle,Holidays & Travel,DR
2029-03-01,Monthly Income,0,6542,7426,Income,Income,Wages,CR
2029-03-02,Flight Centre ,82,0,7344,Expense,Leisure & Lifestyle,Holidays & Travel,DR
2029-03-03,Coles Express ,220,0,7124,Expense,Transport,Fuel,DR
2029-03-04,Village Cinemas ,482,0,6642,Expense,Leisure & Lifestyle,Entertainment,DR
2029-03-04,Supercheap Auto ,618,0,6024,Expense,Transport,"Car Insurance, Rego & Maintenance",DR
2029-03-04,OfficeMax ,388,0,5636,Expense,Personal,Life Admin,DR
2029-03-05,Specsavers ,289,0,5347,Expense,Personal,Health & Medical,DR
2029-03-05,Payday Advance ,297,0,5050,Income,Income,Other Income,DR
2029-03-07,Rooftop Bar ,398,0,4652,Expense,Leisure & Lifestyle,Pubs & Bars,DR
2029-03-07,Sunburn Swimwear ,365,0,4287,Expense,Personal,Clothing & Accessories,DR
2029-03-07, Slater and Gordon Lawyers ,59,0,4228,Expense,Personal,Life Admin,DR
2029-03-08,AustralianSuper Pension ,341,0,3887,Income,Income,Other Income,DR
2029-03-08,Stan ,130,0,3757,Expense,Leisure & Lifestyle,"Tv, Music & Streaming",DR
2029-03-08,Target ,157,0,3600,Expense,Personal,Clothing & Accessories,DR
2029-03-08,Event Cinemas ,140,0,3460,Expense,Leisure & Lifestyle,Entertainment,DR
2029-03-10,Harvey Norman ,243,0,3217,Expense,Household,"Furniture, Electronics & Homewares",DR
2029-03-12,Muffin Break ,275,0,2942,Expense,Leisure & Lifestyle,Restaurants & Cafes,DR
2029-03-12,EnergyAustralia ,130,0,2812,Expense,Household,Utilities,DR
2029-03-12,Spotlight ,237,0,2575,Expense,Leisure & Lifestyle,Hobbies,DR
2029-03-12, Fantastic Furniture ,51,0,2524,Expense,Household,"Furniture, Electronics & Homewares",DR
2029-03-12,Bunnings Warehouse ,89,0,2435,Expense,Household,Maintenance & Improvements,DR
2029-03-14,ABC Reading Eggs ,73,0,2362,Expense,Personal,Education,DR
2029-03-14,Gardening Australia ,172,0,2190,Expense,Household,Maintenance & Improvements,DR
2029-03-15,Freedom Furniture ,67,0,2123,Expense,Household,Maintenance & Improvements,DR
2029-03-15,ATO Tax Refund ,180,0,1943,Income,Income,Other Income,DR
2029-03-16,South East Water ,74,0,1869,Expense,Household,Utilities,DR
2029-03-16,Beach Café ,64,0,1805,Expense,Leisure & Lifestyle,Restaurants & Cafes,DR
2029-03-16,The Iconic ,41,0,1764,Expense,Personal,Clothing & Accessories,DR
2029-03-17,Montessori Schools ,116,0,1648,Expense,Personal,Education,DR
2029-03-17, Commonwealth Bank ,90,0,1558,Expense,Household,Rent & Mortgage,DR
2029-03-17,Spotify ,126,0,1432,Expense,Leisure & Lifestyle,"Tv, Music & Streaming",DR
2029-03-17,Physiotherapy Clinic ,141,0,1291,Expense,Personal,Health & Medical,DR
2029-03-18,Quay Restaurant ,46,0,1245,Expense,Leisure & Lifestyle,Pubs & Bars,DR
2029-03-18,AMF Bowling ,93,0,1152,Expense,Leisure & Lifestyle,Entertainment,DR
2029-03-18, Jim’s Building Inspections ,83,0,1069,Expense,Household,Maintenance & Improvements,DR
2029-03-18,Caltex Woolworths ,72,0,997,Expense,Transport,Fuel,DR
2029-03-19, National Bank ,28,0,969,Expense,Personal,Fees & Charges,DR
2029-03-20,Greencross Vets ,12,0,957,Expense,Household,Pets,DR
2029-03-20,The Baxter Inn ,60,0,897,Expense,Leisure & Lifestyle,Pubs & Bars,DR
2029-03-21,Childcare Payments ,23,0,874,Expense,Personal,Children & Family,DR
2029-03-22,Priceline Pharmacy ,22,0,852,Expense,Personal,Health & Medical,DR
2029-03-22,YMCA ,60,0,792,Expense,Personal,Fitness & Wellbeing,DR
2029-03-22,ALDI ,48,0,744,Expense,Household,Groceries,DR
2029-03-23,The Iconic ,59,0,685,Expense,Personal,Clothing & Accessories,DR
2029-03-23,The Baxter Inn ,35,0,650,Expense,Leisure & Lifestyle,Pubs & Bars,DR
2029-03-24,Catholic Education Office ,23,0,627,Expense,Personal,Education,DR
2029-03-25,The Good Guys ,15,0,612,Expense,Household,"Furniture, Electronics & Homewares",DR
2029-03-25,Harvey Norman ,56,0,556,Expense,Household,"Furniture, Electronics & Homewares",DR
2029-03-26,Sunnybank Hotel ,37,0,519,Expense,Leisure & Lifestyle,Pubs & Bars,DR
2029-04-01,Monthly Income,0,6542,7061,Income,Income,Wages,CR
2029-04-02,Chinatown Night Market ,474,0,6587,Expense,Leisure & Lifestyle,Pubs & Bars,DR
2029-04-02,Myer ,300,0,6287,Expense,Personal,Clothing & Accessories,DR
2029-04-03,Audible ,613,0,5674,Expense,Leisure & Lifestyle,"Tv, Music & Streaming",DR
2029-04-04,Airbnb Host Income ,41,0,5633,Income,Income,Other Income,DR
2029-04-04,Target ,535,0,5098,Expense,Personal,Clothing & Accessories,DR
2029-04-04,Music Academy ,199,0,4899,Expense,Leisure & Lifestyle,Hobbies,DR
2029-04-04,Binge ,348,0,4551,Expense,Leisure & Lifestyle,"Tv, Music & Streaming",DR
2029-04-05,Vodafone Prepaid ,244,0,4307,Expense,Personal,Mobile Phone,DR
2029-04-06,Child Support Agency Deposit ,256,0,4051,Income,Income,Other Income,DR
2029-04-07,Chinatown Night Market ,297,0,3754,Expense,Leisure & Lifestyle,Pubs & Bars,DR
2029-04-08,Menulog ,237,0,3517,Expense,Leisure & Lifestyle,Takeaway,DR
2029-04-08,Sydney Water ,329,0,3188,Expense,Household,Utilities,DR
2029-04-09,Booktopia ,127,0,3061,Expense,Leisure & Lifestyle,Hobbies,DR
2029-04-09,South East Water ,127,0,2934,Expense,Household,Utilities,DR
2029-04-11,Netflix ,281,0,2653,Expense,Leisure & Lifestyle,"Tv, Music & Streaming",DR
2029-04-11,Sea Kayak Tours ,224,0,2429,Expense,Leisure & Lifestyle,Holidays & Travel,DR
2029-04-11,T2 Tea ,138,0,2291,Expense,Personal,Fitness & Wellbeing,DR
2029-04-12,Spotify ,26,0,2265,Expense,Leisure & Lifestyle,"Tv, Music & Streaming",DR
2029-04-12,F45 Training ,33,0,2232,Expense,Personal,Fitness & Wellbeing,DR
2029-04-12,Who Gives A Crap ,85,0,2147,Expense,Household,Groceries,DR
2029-04-13,Microsoft 365 ,100,0,2047,Expense,Personal,Education,DR
2029-04-13,OfficeMax ,89,0,1958,Expense,Personal,Life Admin,DR
2029-04-14,Guardian Childcare & Education ,102,0,1856,Expense,Personal,Children & Family,DR
2029-04-15,Priceline Pharmacy ,133,0,1723,Expense,Personal,Health & Medical,DR
2029-04-15,Eat Street Northshore ,62,0,1661,Expense,Leisure & Lifestyle,Pubs & Bars,DR
2029-04-17,Gardening Australia ,17,0,1644,Expense,Household,Maintenance & Improvements,DR
2029-04-17,The Victory Hotel ,42,0,1602,Expense,Leisure & Lifestyle,Pubs & Bars,DR
2029-04-18,Apple Store ,161,0,1441,Expense,Leisure & Lifestyle,Electronics,DR
2029-04-18,Snap Fitness ,119,0,1322,Expense,Personal,Fitness & Wellbeing,DR
2029-04-19,Adairs ,85,0,1237,Expense,Household,"Furniture, Electronics & Homewares",DR
2029-04-20, National Bank ,89,0,1148,Expense,Personal,Fees & Charges,DR
2029-04-20,Dental Clinic ,12,0,1136,Expense,Personal,Health & Medical,DR
2029-04-20,Rental Deposit from RealEstate.com.au ,48,0,1088,Income,Income,Other Income,DR
2029-04-21,Salary Deposit from Woolworths Group ,35,0,1053,Income,Income,Wages,DR
2029-04-22,Sunnybank Hotel ,73,0,980,Expense,Leisure & Lifestyle,Pubs & Bars,DR
2029-04-22, Jim's Mowing ,20,0,960,Expense,Household,Maintenance & Improvements,DR
2029-04-22,F45 Training ,29,0,931,Expense,Personal,Fitness & Wellbeing,DR
2029-04-22,Bunnings Warehouse ,77,0,854,Expense,Household,Maintenance & Improvements,DR
2029-04-23,Greencross Vets ,55,0,799,Expense,Household,Pets,DR
2029-04-23,Mathnasium ,65,0,734,Expense,Personal,Education,DR
2029-04-24,Camp Australia ,64,0,670,Expense,Leisure & Lifestyle,Hobbies,DR
2029-04-24, The Good Guys ,13,0,657,Expense,Household,"Furniture, Electronics & Homewares",DR
2029-04-24,Dymocks ,53,0,604,Expense,Leisure & Lifestyle,Hobbies,DR
2029-04-27,Grill’d ,40,0,564,Expense,Leisure & Lifestyle,Takeaway,DR
2029-04-27,Microsoft 365 ,41,0,523,Expense,Personal,Education,DR
2029-04-27,The Sydney Morning Herald ,38,0,485,Expense,Personal,Education,DR
2029-04-28,Netflix ,24,0,461,Expense,Leisure & Lifestyle,"Tv, Music & Streaming",DR
2029-04-28,Australian Veterinary Association ,7,0,454,Expense,Household,Pets,DR
2029-05-01,Monthly Income,0,6542,6996,Income,Income,Wages,CR
2029-05-02, Jim’s Building Inspections ,609,0,6387,Expense,Household,Maintenance & Improvements,DR
2029-05-05,Health Food Store ,350,0,6037,Expense,Personal,Fitness & Wellbeing,DR
2029-05-06,Disney+ ,538,0,5499,Expense,Leisure & Lifestyle,"Tv, Music & Streaming",DR
2029-05-06,Optus ,278,0,5221,Expense,Personal,Mobile Phone,DR
2029-05-06,Costco ,300,0,4921,Expense,Household,Groceries,DR
2029-05-07,Repco ,212,0,4709,Expense,Transport,"Car Insurance, Rego & Maintenance",DR
2029-05-07,Campion Education ,217,0,4492,Expense,Personal,Children & Family,DR
2029-05-08,Child Support Agency Deposit ,249,0,4243,Income,Income,Other Income,DR
2029-05-09,Netflix ,308,0,3935,Expense,Leisure & Lifestyle,"Tv, Music & Streaming",DR
2029-05-09,Supercheap Auto ,387,0,3548,Expense,Transport,"Car Insurance, Rego & Maintenance",DR
2029-05-09,Who Gives A Crap ,281,0,3267,Expense,Household,Groceries,DR
2029-05-10,Tennis Australia ,12,0,3255,Expense,Personal,Fitness & Wellbeing,DR
2029-05-10,Physiotherapy Clinic ,193,0,3062,Expense,Personal,Health & Medical,DR
2029-05-10,YMCA ,245,0,2817,Expense,Personal,Fitness & Wellbeing,DR
2029-05-12,Muffin Break ,80,0,2737,Expense,Leisure & Lifestyle,Restaurants & Cafes,DR
2029-05-12,Timezone ,135,0,2602,Expense,Leisure & Lifestyle,Entertainment,DR
2029-05-12,Interest Payment from Commonwealth Bank ,159,0,2443,Income,Income,Investments,DR
2029-05-13, NRMA Insurance ,205,0,2238,Expense,Household,Rates & Insurance,DR
2029-05-14,Budget Direct Car Insurance ,165,0,2073,Expense,Transport,"Car Insurance, Rego & Maintenance",DR
2029-05-14,Campion Education ,192,0,1881,Expense,Personal,Children & Family,DR
2029-05-14,Childcare Payments ,75,0,1806,Expense,Personal,Children & Family,DR
2029-05-15,Rip Curl ,153,0,1653,Expense,Personal,Clothing & Accessories,DR
2029-05-16,Repco ,106,0,1547,Expense,Transport,"Car Insurance, Rego & Maintenance",DR
2029-05-17,Health Food Store ,53,0,1494,Expense,Personal,Fitness & Wellbeing,DR
2029-05-18,King Swim ,129,0,1365,Expense,Personal,Fitness & Wellbeing,DR
2029-05-19,The Athlete's Foot ,24,0,1341,Expense,Personal,Clothing & Accessories,DR
2029-05-19, Ray White Real Estate ,63,0,1278,Expense,Personal,Life Admin,DR
2029-05-21,Platypus Shoes ,75,0,1203,Expense,Personal,Clothing & Accessories,DR
2029-05-22,Health Food Store ,44,0,1159,Expense,Personal,Fitness & Wellbeing,DR
2029-05-23,Fernwood Fitness ,111,0,1048,Expense,Personal,Fitness & Wellbeing,DR
2029-05-24,Le Creuset ,93,0,955,Expense,Household,"Furniture, Electronics & Homewares",DR
2029-05-25,Costco ,35,0,920,Expense,Household,Groceries,DR
2029-05-26,The Rocks Bar and Pub ,47,0,873,Expense,Leisure & Lifestyle,Pubs & Bars,DR
2029-05-27,Snap Fitness ,76,0,797,Expense,Personal,Fitness & Wellbeing,DR
2029-05-28,Fitness First ,67,0,730,Expense,Personal,Fitness & Wellbeing,DR
2029-06-01,Monthly Income,0,6542,7272,Income,Income,Wages,CR
2029-06-03,Apple Store ,582,0,6690,Expense,Leisure & Lifestyle,Electronics,DR
2029-06-03,The Body Shop ,531,0,6159,Expense,Personal,Hair & Beauty,DR
2029-06-04,Surfstitch ,552,0,5607,Expense,Personal,Clothing & Accessories,DR
2029-06-05,Adobe Creative Cloud ,228,0,5379,Expense,Leisure & Lifestyle,Hobbies,DR
2029-06-06, Ray White Real Estate ,198,0,5181,Expense,Personal,Life Admin,DR
2029-06-06, Jim's Mowing ,91,0,5090,Expense,Household,Maintenance & Improvements,DR
2029-06-06,Music Academy ,352,0,4738,Expense,Leisure & Lifestyle,Hobbies,DR
2029-06-07, NRMA Insurance ,386,0,4352,Expense,Household,Rates & Insurance,DR
2029-06-08,Repco ,216,0,4136,Expense,Transport,"Car Insurance, Rego & Maintenance",DR
2029-06-10, Meriton Apartments ,297,0,3839,Expense,Household,Rates & Insurance,DR
2029-06-12,Service NSW ,339,0,3500,Expense,Transport,"Car Insurance, Rego & Maintenance",DR
2029-06-14,Budget Direct Car Insurance ,344,0,3156,Expense,Transport,"Car Insurance, Rego & Maintenance",DR
2029-06-15,Campion Education ,153,0,3003,Expense,Personal,Children & Family,DR
2029-06-15,Repco ,174,0,2829,Expense,Transport,"Car Insurance, Rego & Maintenance",DR
2029-06-15,Domino’s Pizza ,230,0,2599,Expense,Leisure & Lifestyle,Takeaway,DR
2029-06-16,Ladbrokes ,212,0,2387,Expense,Leisure & Lifestyle,Lottery & Gambling,DR
2029-06-17,City Beach ,67,0,2320,Expense,Personal,Clothing & Accessories,DR
2029-06-18,Rebel Sport ,220,0,2100,Expense,Personal,Fitness & Wellbeing,DR
2029-06-18,Country Road ,32,0,2068,Expense,Personal,Clothing & Accessories,DR
2029-06-20,BWS ,46,0,2022,Expense,Leisure & Lifestyle,Alcohol,DR
2029-06-21,Massage Therapy Center ,183,0,1839,Expense,Personal,Health & Medical,DR
2029-06-22,Kmart ,93,0,1746,Expense,Personal,Children & Family,DR
2029-06-22,The Athlete's Foot ,112,0,1634,Expense,Personal,Clothing & Accessories,DR
2029-06-23,Foxtel ,157,0,1477,Expense,Leisure & Lifestyle,"Tv, Music & Streaming",DR
2029-06-26,Microsoft 365 ,59,0,1418,Expense,Personal,Education,DR
2029-06-27,The Rocks Bar and Pub ,58,0,1360,Expense,Leisure & Lifestyle,Pubs & Bars,DR
2029-06-28,Fitness First ,72,0,1288,Expense,Personal,Fitness & Wellbeing,DR
2029-07-01,Monthly Income,0,6542,7830,Income,Income,Wages,CR
2029-07-02,Event Cinemas ,397,0,7433,Expense,Leisure & Lifestyle,Entertainment,DR
2029-07-02,Fernwood Fitness ,711,0,6722,Expense,Personal,Fitness & Wellbeing,DR
2029-07-02,City Beach ,66,0,6656,Expense,Personal,Clothing & Accessories,DR
2029-07-04,AMF Bowling ,247,0,6409,Expense,Leisure & Lifestyle,Entertainment,DR
2029-07-04,ATO Tax Refund ,120,0,6289,Income,Income,Other Income,DR
2029-07-05,The Espy ,16,0,6273,Expense,Leisure & Lifestyle,Pubs & Bars,DR
2029-07-06,Foxtel ,226,0,6047,Expense,Leisure & Lifestyle,"Tv, Music & Streaming",DR
2029-07-09,The Iconic ,320,0,5727,Expense,Personal,Clothing & Accessories,DR
2029-07-10,Stand Up Paddleboard Rental ,458,0,5269,Expense,Personal,Fitness & Wellbeing,DR
2029-07-10, EnergyAustralia ,520,0,4749,Expense,Household,Utilities,DR
2029-07-11, NRMA Insurance ,403,0,4346,Expense,Household,Rates & Insurance,DR
2029-07-11,Microsoft 365 ,346,0,4000,Expense,Personal,Education,DR
2029-07-12,Quay Restaurant ,130,0,3870,Expense,Leisure & Lifestyle,Pubs & Bars,DR
2029-07-13,Gardening Australia ,40,0,3830,Expense,Household,Maintenance & Improvements,DR
2029-07-15,Sunnybank Hotel ,286,0,3544,Expense,Leisure & Lifestyle,Pubs & Bars,DR
2029-07-16,EnergyAustralia ,348,0,3196,Expense,Household,Utilities,DR
2029-07-18,Optometrist ,231,0,2965,Expense,Personal,Health & Medical,DR
2029-07-19,AMF Bowling ,200,0,2765,Expense,Leisure & Lifestyle,Entertainment,DR
2029-07-21,Le Creuset ,178,0,2587,Expense,Household,"Furniture, Electronics & Homewares",DR
2029-07-22,Fitness First ,179,0,2408,Expense,Personal,Fitness & Wellbeing,DR
2029-07-23,Rooftop Bar ,166,0,2242,Expense,Leisure & Lifestyle,Pubs & Bars,DR
2029-07-27,Kumon ,112,0,2130,Expense,Personal,Education,DR
2029-07-28,eBay Sales Proceeds ,50,0,2080,Income,Income,Other Income,DR
2029-08-01,Monthly Income,0,6542,8622,Income,Income,Wages,CR
2029-08-02,Australian Veterinary Association ,467,0,8155,Expense,Household,Pets,DR
2029-08-03,Salary Deposit from Woolworths Group ,552,0,7603,Income,Income,Wages,DR
2029-08-04,Fernwood Fitness ,137,0,7466,Expense,Personal,Fitness & Wellbeing,DR
2029-08-05,AMF Bowling ,144,0,7322,Expense,Leisure & Lifestyle,Entertainment,DR
2029-08-07,National Hearing Care ,388,0,6934,Expense,Personal,Health & Medical,DR
2029-08-08,Surfstitch ,133,0,6801,Expense,Personal,Clothing & Accessories,DR
2029-08-08,Apple Music ,178,0,6623,Expense,Leisure & Lifestyle,"Tv, Music & Streaming",DR
2029-08-09,Kmart Tyre & Auto Service ,612,0,6011,Expense,Transport,"Car Insurance, Rego & Maintenance",DR
2029-08-10,Witchery ,478,0,5533,Expense,Personal,Clothing & Accessories,DR
2029-08-10,Mathnasium ,521,0,5012,Expense,Personal,Education,DR
2029-08-12,Petbarn ,236,0,4776,Expense,Household,Pets,DR
2029-08-14,The Espy ,392,0,4384,Expense,Leisure & Lifestyle,Pubs & Bars,DR
2029-08-14,Dan Murphy’s ,336,0,4048,Expense,Leisure & Lifestyle,Alcohol,DR
2029-08-15,The Ivy ,149,0,3899,Expense,Leisure & Lifestyle,Pubs & Bars,DR
2029-08-17,Harvey Norman ,85,0,3814,Expense,Household,"Furniture, Electronics & Homewares",DR
2029-08-18,Sunburn Swimwear ,159,0,3655,Expense,Personal,Clothing & Accessories,DR
2029-08-19,EnergyAustralia ,32,0,3623,Expense,Household,Utilities,DR
2029-08-23,Witchery ,12,0,3611,Expense,Personal,Clothing & Accessories,DR
2029-08-26,Disney+ ,219,0,3392,Expense,Leisure & Lifestyle,"Tv, Music & Streaming",DR
2029-08-27,Eat Street Northshore ,27,0,3365,Expense,Leisure & Lifestyle,Pubs & Bars,DR
2029-08-27,Adobe Creative Cloud ,16,0,3349,Expense,Leisure & Lifestyle,Hobbies,DR
2029-08-27,Netflix ,78,0,3271,Expense,Leisure & Lifestyle,"Tv, Music & Streaming",DR
2029-09-01,Monthly Income,0,6542,9813,Income,Income,Wages,CR
2029-09-02,Dan Murphy’s ,251,0,9562,Expense,Leisure & Lifestyle,Alcohol,DR
2029-09-05,Guzman y Gomez ,117,0,9445,Expense,Leisure & Lifestyle,Takeaway,DR
2029-09-05,The Ivy ,370,0,9075,Expense,Leisure & Lifestyle,Pubs & Bars,DR
2029-09-08,King Swim ,738,0,8337,Expense,Personal,Fitness & Wellbeing,DR
2029-09-08,Aqua Fun Park ,710,0,7627,Expense,Leisure & Lifestyle,Holidays & Travel,DR
2029-09-08,AMF Bowling ,601,0,7026,Expense,Leisure & Lifestyle,Entertainment,DR
2029-09-08,Kmart ,370,0,6656,Expense,Personal,Children & Family,DR
2029-09-09,Grill’d ,383,0,6273,Expense,Leisure & Lifestyle,Takeaway,DR
2029-09-11, Brisbane City Council ,454,0,5819,Expense,Household,Rates & Insurance,DR
2029-09-11,Sylvan Learning ,221,0,5598,Expense,Personal,Education,DR
2029-09-12,VetLove ,37,0,5561,Expense,Household,Pets,DR
2029-09-12,Fernwood Fitness ,262,0,5299,Expense,Personal,Fitness & Wellbeing,DR
2029-09-12,Jetts Fitness ,194,0,5105,Expense,Personal,Fitness & Wellbeing,DR
2029-09-16,NRMA Roadside Assistance ,426,0,4679,Expense,Transport,"Car Insurance, Rego & Maintenance",DR
2029-09-18,JAX Tyres ,5,0,4674,Expense,Transport,"Car Insurance, Rego & Maintenance",DR
2029-09-21,Guardian Childcare & Education ,144,0,4530,Expense,Personal,Children & Family,DR
2029-09-21,ABC Reading Eggs ,390,0,4140,Expense,Personal,Education,DR
2029-09-22,Apple Music ,200,0,3940,Expense,Leisure & Lifestyle,"Tv, Music & Streaming",DR
2029-09-25,Eau De Vie ,60,0,3880,Expense,Leisure & Lifestyle,Pubs & Bars,DR
2029-09-26,Toys 'R' Us ,95,0,3785,Expense,Personal,CHildren & Family,DR
2029-09-27,SEQTA ,21,0,3764,Expense,Personal,Education,DR
2029-09-27,ATO Tax Refund ,97,0,3667,Income,Income,Other Income,DR
2029-09-27,City Beach ,94,0,3573,Expense,Personal,Clothing & Accessories,DR
2029-09-28,KU Children's Services ,33,0,3540,Expense,Personal,Children & Family,DR
2029-09-28,VicRoads ,336,0,3204,Expense,Transport,"Car Insurance, Rego & Maintenance",DR
