Transaction_ID,User_ID,Date,Description,Category 1,Category 2,Category 3,Debit,Credit,Balance,Type
1,123,2021-01-01,Salary,Income,Income,Wages,0,8000,8000,C
7,123,2021-01-02,Car Loan Provider,Expense,Transport,Car Repayments,184.83,0,7815.17,D
23,123,2021-01-02,Uber,Expense,Transport,Taxies & Share Cars,183.57,0,7631.6,D
11,123,2021-01-03,The Lott,Expense,Leisure & Lifestyle,Lottery & Gambling,125.57,0,7506.03,D
20,123,2021-01-03,Shell,Expense,Transport,Fuel,242.76,0,7263.27,D
6,123,2021-01-05,Mortgage Lender,Expense,Household,Rent & Mortgage,324.94,0,6938.33,D
27,123,2021-01-07,Hungry Jack's,Expense,Leisure & Lifestyle,Restaurants & Cafes,398.42,0,6539.91,D
12,123,2021-01-09,Rooftop Bar,Expense,Leisure & Lifestyle,Pubs & Bars,64.7,0,6475.21,D
22,123,2021-01-09,Sydney Olympic Park,Expense,Transport,Parking,181.37,0,6293.84,D
19,123,2021-01-15,Toys R Us,Expense,Personal,Children & Family,455.88,0,5837.96,D
26,123,2021-01-15,Home Depot,Expense,Household,Maintenance & Improvements,397.43,0,5440.53,D
17,123,2021-01-16,TransLink,Expense,Transport,Public Transport,117.17,0,5323.36,D
25,123,2021-01-16,Tutoring Service,Expense,Personal,Education,130.62,0,5192.74,D
9,123,2021-01-17,Moshtix,Expense,Leisure & Lifestyle,Events & Gigs,468.94,0,4723.8,D
15,123,2021-01-18,Tobacco Store,Expense,Leisure & Lifestyle,Tobacco & Vaping,140.15,0,4583.65,D
4,123,2021-01-19,Medibank,Expense,Personal,Health & Medical,453.87,0,4129.78,D
5,123,2021-01-19,Cotton On,Expense,Personal,Clothing & Accessories,188.93,0,3940.85,D
2,123,2021-01-20,Qantas,Expense,Leisure & Lifestyle,Holidays & Travel,293.52,0,3647.33,D
8,123,2021-01-22,EnergyAustralia,Expense,Household,Utilities,467.35,0,3179.98,D
21,123,2021-01-25,Coles,Expense,Household,Groceries,279.3,0,2900.68,D
24,123,2021-01-25,United Petroleum,Expense,Transport,Fuel,487.34,0,2413.34,D
14,123,2021-01-27,Apple Music,Expense,Leisure & Lifestyle,"Tv, Music & Streaming",198.16,0,2215.18,D
3,123,2021-01-28,IGA,Expense,Household,Groceries,146.12,0,2069.06,D
10,123,2021-01-28,Optus,Expense,Personal,Mobile Phone,226.76,0,1842.3,D
13,123,2021-01-28,Uber,Expense,Transport,Taxies & Share Cars,382.23,0,1460.07,D
28,123,2021-01-28,TAB,Expense,Leisure & Lifestyle,Lottery & Gambling,239.2,0,1220.87,D
16,123,2021-01-29,Domino's Online,Expense,Leisure & Lifestyle,Takeaway,474.06,0,746.81,D
18,123,2021-01-29,BWS,Expense,Leisure & Lifestyle,Alcohol,229.87,0,516.94,D
29,123,2021-02-01,Salary,Income,Income,Wages,0,8000,8516.94,C
38,123,2021-02-03,Landlord,Expense,Household,Rent & Mortgage,469.93,0,8047.01,D
41,123,2021-02-03,Zara,Expense,Personal,Clothing & Accessories,106.93,0,7940.08,D
40,123,2021-02-06,Sports Equipment Store,Expense,Leisure & Lifestyle,Hobbies,25.55,0,7914.53,D
34,123,2021-02-07,Bicycle Network,Expense,Transport,Cycling,75.09,0,7839.44,D
43,123,2021-02-09,Moshtix,Expense,Leisure & Lifestyle,Events & Gigs,376.98,0,7462.46,D
30,123,2021-02-12,Bank Transfer,Transfer,Transfer,Transfer,249.49,0,7212.97,D
35,123,2021-02-13,Dan Murphy's,Expense,Leisure & Lifestyle,Alcohol,394.97,0,6818.0,D
31,123,2021-02-17,Ticketek,Expense,Leisure & Lifestyle,Events & Gigs,447.92,0,6370.08,D
36,123,2021-02-18,Myki,Expense,Transport,Public Transport,152.44,0,6217.64,D
37,123,2021-02-22,GoFundMe,Expense,Personal,Gifts & Donations,330.07,0,5887.57,D
39,123,2021-02-22,Flight Centre,Expense,Leisure & Lifestyle,Holidays & Travel,258.5,0,5629.07,D
33,123,2021-02-23,Stock Purchase,Expense,Personal,Investments,315.7,0,5313.37,D
42,123,2021-02-26,Booking.com,Expense,Leisure & Lifestyle,Holidays & Travel,182.46,0,5130.91,D
44,123,2021-02-27,Music Store,Expense,Leisure & Lifestyle,Hobbies,147.64,0,4983.27,D
32,123,2021-02-28,Lowe's,Expense,Household,Maintenance & Improvements,444.29,0,4538.98,D
45,123,2021-03-01,Salary,Income,Income,Wages,0,8000,12538.98,C
57,123,2021-03-07,Deliveroo,Expense,Leisure & Lifestyle,Takeaway,61.62,0,12477.36,D
50,123,2021-03-12,Bike Shop,Expense,Transport,Cycling,119.3,0,12358.06,D
51,123,2021-03-13,Bank Transfer,Transfer,Transfer,Transfer,399.71,0,11958.35,D
53,123,2021-03-14,Ticketmaster,Expense,Leisure & Lifestyle,Events & Gigs,319.84,0,11638.51,D
55,123,2021-03-15,Toyota Finance,Expense,Transport,Car Repayments,472.93,0,11165.58,D
47,123,2021-03-16,Uniqlo,Expense,Personal,Clothing & Accessories,431.48,0,10734.1,D
56,123,2021-03-16,Lawyer,Expense,Personal,Life Admin,434.68,0,10299.42,D
46,123,2021-03-18,Rooftop Bar,Expense,Leisure & Lifestyle,Pubs & Bars,68.76,0,10230.66,D
52,123,2021-03-22,Chemist Warehouse,Expense,Personal,Health & Medical,230.45,0,10000.21,D
54,123,2021-03-22,Steam,Expense,Leisure & Lifestyle,"Apps, Games & Software",86.89,0,9913.32,D
49,123,2021-03-24,Stock Purchase,Income,Income,Investments,310.8,0,9602.52,D
48,123,2021-03-29,Cycling Apparel Store,Expense,Transport,Cycling,124.8,0,9477.72,D
58,123,2021-04-01,Salary,Income,Income,Wages,0,8000,17477.72,C
61,123,2021-04-03,NRMA,Expense,Transport,"Car Insurance, Rego & Maintenance",60.83,0,17416.89,D
63,123,2021-04-07,Post Office,Expense,Personal,Life Admin,190.02,0,17226.87,D
65,123,2021-04-07,Greencross Vets,Expense,Household,Pets,33.45,0,17193.42,D
59,123,2021-04-09,Real Estate Agency,Expense,Household,Rent & Mortgage,179.8,0,17013.62,D
68,123,2021-04-15,Secure Parking,Expense,Transport,Parking,400.43,0,16613.19,D
66,123,2021-04-17,Subway,Expense,Leisure & Lifestyle,Restaurants & Cafes,127.26,0,16485.93,D
64,123,2021-04-23,First Choice Liquor,Expense,Leisure & Lifestyle,Alcohol,66.08,0,16419.85,D
60,123,2021-04-25,Vodafone,Expense,Household,Internet,103.14,0,16316.71,D
62,123,2021-04-25,Post Office,Expense,Personal,Life Admin,298.54,0,16018.17,D
67,123,2021-04-27,Online Course Provider,Expense,Personal,Education,438.08,0,15580.09,D
69,123,2021-05-01,Salary,Income,Income,Wages,0,8000,23580.09,C
78,123,2021-05-06,McDonald's,Expense,Leisure & Lifestyle,Restaurants & Cafes,255.55,0,23324.54,D
73,123,2021-05-09,Crown Casino,Expense,Leisure & Lifestyle,Lottery & Gambling,396.95,0,22927.59,D
71,123,2021-05-12,Post Office,Expense,Personal,Life Admin,229.71,0,22697.88,D
77,123,2021-05-13,Subway,Expense,Leisure & Lifestyle,Restaurants & Cafes,452.0,0,22245.88,D
72,123,2021-05-18,Suncorp,Expense,Household,Rates & Insurance,349.08,0,21896.8,D
79,123,2021-05-18,City of Melbourne,Expense,Transport,Parking,410.63,0,21486.17,D
74,123,2021-05-20,The Iconic,Expense,Personal,Clothing & Accessories,27.02,0,21459.15,D
70,123,2021-05-23,Ticketek,Expense,Leisure & Lifestyle,Events & Gigs,287.39,0,21171.76,D
76,123,2021-05-23,Bank Transfer,Transfer,Transfer,Transfer,109.75,0,21062.01,D
75,123,2021-05-27,Bike Shop,Expense,Transport,Cycling,146.98,0,20915.03,D
80,123,2021-06-01,Salary,Income,Income,Wages,0,8000,28915.03,C
86,123,2021-06-02,AGL,Expense,Household,Utilities,236.28,0,28678.75,D
97,123,2021-06-04,Cotton On,Expense,Personal,Clothing & Accessories,157.92,0,28520.83,D
89,123,2021-06-07,Domino's Pizza,Expense,Leisure & Lifestyle,Restaurants & Cafes,249.67,0,28271.16,D
104,123,2021-06-07,Origin Energy,Expense,Household,Utilities,142.14,0,28129.02,D
87,123,2021-06-10,AGL,Expense,Household,Utilities,147.07,0,27981.95,D
82,123,2021-06-11,Anytime Fitness,Expense,Personal,Fitness & Wellbeing,181.53,0,27800.42,D
103,123,2021-06-11,Sportsbet,Expense,Leisure & Lifestyle,Lottery & Gambling,155.08,0,27645.34,D
85,123,2021-06-12,Sports Equipment Store,Expense,Leisure & Lifestyle,Hobbies,445.79,0,27199.55,D
101,123,2021-06-12,Booking.com,Expense,Leisure & Lifestyle,Holidays & Travel,43.77,0,27155.78,D
81,123,2021-06-14,Toys R Us,Expense,Personal,Children & Family,56.24,0,27099.54,D
96,123,2021-06-14,Booking.com,Expense,Leisure & Lifestyle,Holidays & Travel,332.91,0,26766.63,D
84,123,2021-06-15,GoFundMe,Expense,Personal,Gifts & Donations,146.46,0,26620.17,D
90,123,2021-06-15,PetSmart,Expense,Household,Pets,481.31,0,26138.86,D
92,123,2021-06-15,Stock Purchase,Income,Income,Investments,748.34,0,25390.52,D
99,123,2021-06-15,Uniqlo,Expense,Personal,Clothing & Accessories,277.04,0,25113.48,D
105,123,2021-06-15,Charity Organization,Expense,Personal,Gifts & Donations,114.49,0,24998.99,D
88,123,2021-06-18,Tobacco Store,Expense,Leisure & Lifestyle,Tobacco & Vaping,207.76,0,24791.23,D
91,123,2021-06-18,GoFundMe,Expense,Personal,Gifts & Donations,439.46,0,24351.77,D
95,123,2021-06-18,H&M,Expense,Personal,Clothing & Accessories,145.47,0,24206.3,D
98,123,2021-06-19,TransLink,Expense,Transport,Public Transport,336.07,0,23870.23,D
83,123,2021-06-23,Art Supply Store,Expense,Leisure & Lifestyle,Hobbies,236.84,0,23633.39,D
100,123,2021-06-24,Airbnb,Expense,Leisure & Lifestyle,Holidays & Travel,383.67,0,23249.72,D
94,123,2021-06-25,Bicycle Network,Expense,Transport,Cycling,38.68,0,23211.04,D
102,123,2021-06-27,Vape Shop,Expense,Leisure & Lifestyle,Tobacco & Vaping,365.12,0,22845.92,D
93,123,2021-06-29,Landlord,Expense,Household,Rent & Mortgage,281.68,0,22564.24,D
106,123,2021-07-01,Salary,Income,Income,Wages,0,8000,30564.24,C
116,123,2021-07-11,Expedia,Expense,Leisure & Lifestyle,Holidays & Travel,403.54,0,30160.7,D
109,123,2021-07-13,Ola,Expense,Transport,Taxies & Share Cars,41.28,0,30119.42,D
113,123,2021-07-13,Caltex,Expense,Transport,Fuel,462.39,0,29657.03,D
108,123,2021-07-14,Ticketek,Expense,Leisure & Lifestyle,Events & Gigs,31.99,0,29625.04,D
111,123,2021-07-15,MAC Cosmetics,Expense,Personal,Hair & Beauty,248.93,0,29376.11,D
112,123,2021-07-16,Shell,Expense,Transport,Fuel,366.73,0,29009.38,D
114,123,2021-07-17,Caltex,Expense,Transport,Fuel,397.98,0,28611.4,D
115,123,2021-07-18,Tatts,Expense,Leisure & Lifestyle,Lottery & Gambling,276.28,0,28335.12,D
110,123,2021-07-19,Optus,Expense,Household,Internet,179.5,0,28155.62,D
107,123,2021-07-27,AGL,Expense,Household,Utilities,470.94,0,27684.68,D
117,123,2021-08-01,Salary,Income,Income,Wages,0,8000,35684.68,C
119,123,2021-08-02,IKEA,Expense,Household,Maintenance & Improvements,119.56,0,35565.12,D
125,123,2021-08-03,Deliveroo,Expense,Leisure & Lifestyle,Takeaway,402.57,0,35162.55,D
133,123,2021-08-05,Adelaide Metro,Expense,Transport,Public Transport,420.75,0,34741.8,D
123,123,2021-08-06,Car Loan Provider,Expense,Transport,Car Repayments,401.64,0,34340.16,D
127,123,2021-08-06,7-Eleven,Expense,Transport,Fuel,89.13,0,34251.03,D
129,123,2021-08-06,Sydney Water,Expense,Household,Utilities,141.76,0,34109.27,D
126,123,2021-08-07,Art Supply Store,Expense,Leisure & Lifestyle,Hobbies,148.96,0,33960.31,D
130,123,2021-08-08,Ticketmaster,Expense,Leisure & Lifestyle,Events & Gigs,161.91,0,33798.4,D
140,123,2021-08-08,BP,Expense,Transport,Fuel,149.32,0,33649.08,D
134,123,2021-08-09,Wilson Parking,Expense,Transport,Parking,241.13,0,33407.95,D
136,123,2021-08-09,Childcare Center,Expense,Personal,Children & Family,232.03,0,33175.92,D
118,123,2021-08-11,PetSmart,Expense,Household,Pets,223.92,0,32952.0,D
132,123,2021-08-12,Rooftop Bar,Expense,Leisure & Lifestyle,Pubs & Bars,174.15,0,32777.85,D
120,123,2021-08-13,Bunnings Warehouse,Expense,Household,Maintenance & Improvements,390.94,0,32386.91,D
139,123,2021-08-14,Steam,Expense,Leisure & Lifestyle,"Apps, Games & Software",461.96,0,31924.95,D
138,123,2021-08-15,Birthday Gift,Expense,Personal,Gifts & Donations,187.68,0,31737.27,D
131,123,2021-08-19,Shell,Expense,Transport,Fuel,383.57,0,31353.7,D
135,123,2021-08-19,Suncorp,Expense,Transport,"Car Insurance, Rego & Maintenance",383.79,0,30969.91,D
122,123,2021-08-20,Bike Shop,Expense,Transport,Cycling,22.03,0,30947.88,D
124,123,2021-08-22,Linkt,Expense,Transport,Tolls,79.04,0,30868.84,D
128,123,2021-08-24,Airbnb,Expense,Leisure & Lifestyle,Holidays & Travel,356.93,0,30511.91,D
121,123,2021-08-26,Woolworths,Expense,Household,Groceries,364.62,0,30147.29,D
137,123,2021-08-28,Spotify,Expense,Leisure & Lifestyle,"Tv, Music & Streaming",50.95,0,30096.34,D
141,123,2021-09-01,Salary,Income,Income,Wages,0,8000,38096.34,C
146,123,2021-09-05,iiNet,Expense,Household,Internet,478.98,0,37617.36,D
142,123,2021-09-10,Aldi,Expense,Household,Groceries,211.55,0,37405.81,D
143,123,2021-09-13,Music Store,Expense,Leisure & Lifestyle,Hobbies,37.34,0,37368.47,D
145,123,2021-09-14,Optus,Expense,Household,Internet,384.08,0,36984.39,D
149,123,2021-09-14,Yoga Studio,Expense,Personal,Fitness & Wellbeing,83.76,0,36900.63,D
150,123,2021-09-16,Linkt,Expense,Transport,Tolls,77.45,0,36823.18,D
147,123,2021-09-20,Adelaide Metro,Expense,Transport,Public Transport,423.14,0,36400.04,D
148,123,2021-09-23,iiNet,Expense,Household,Internet,402.37,0,35997.67,D
144,123,2021-09-24,Opal Card,Expense,Transport,Public Transport,381.15,0,35616.52,D
151,123,2021-09-28,Adelaide Metro,Expense,Transport,Public Transport,124.02,0,35492.5,D
152,123,2021-10-01,Salary,Income,Income,Wages,0,8000,43492.5,C
163,123,2021-10-02,EastLink,Expense,Transport,Tolls,406.39,0,43086.11,D
166,123,2021-10-02,Car Loan Provider,Expense,Transport,Car Repayments,20.21,0,43065.9,D
156,123,2021-10-04,Stock Purchase,Expense,Personal,Investments,546.7,0,42519.2,D
164,123,2021-10-04,Spotify,Expense,Leisure & Lifestyle,"Tv, Music & Streaming",179.68,0,42339.52,D
159,123,2021-10-06,NIB,Expense,Personal,Health & Medical,174.38,0,42165.14,D
165,123,2021-10-09,13cabs,Expense,Transport,Taxies & Share Cars,483.1,0,41682.04,D
169,123,2021-10-09,Vape Shop,Expense,Leisure & Lifestyle,Tobacco & Vaping,346.28,0,41335.76,D
153,123,2021-10-11,Stock Purchase,Expense,Personal,Investments,716.41,0,40619.35,D
167,123,2021-10-11,Vodafone,Expense,Household,Internet,107.83,0,40511.52,D
160,123,2021-10-13,Stock Purchase,Expense,Personal,Investments,846.57,0,39664.95,D
170,123,2021-10-16,Sports Equipment Store,Expense,Leisure & Lifestyle,Hobbies,193.73,0,39471.22,D
168,123,2021-10-18,Ticketek,Expense,Leisure & Lifestyle,Events & Gigs,290.61,0,39180.61,D
157,123,2021-10-19,Vodafone,Expense,Household,Internet,33.98,0,39146.63,D
161,123,2021-10-20,Uniqlo,Expense,Personal,Clothing & Accessories,209.46,0,38937.17,D
162,123,2021-10-20,Sydney Water,Expense,Household,Utilities,390.6,0,38546.57,D
158,123,2021-10-21,NIB,Expense,Personal,Health & Medical,114.65,0,38431.92,D
155,123,2021-10-28,Netflix,Expense,Leisure & Lifestyle,"Tv, Music & Streaming",24.46,0,38407.46,D
154,123,2021-10-29,Cigars,Expense,Leisure & Lifestyle,Tobacco & Vaping,261.51,0,38145.95,D
171,123,2021-11-01,Salary,Income,Income,Wages,0,8000,46145.95,C
189,123,2021-11-03,University,Expense,Personal,Education,226.85,0,45919.1,D
193,123,2021-11-03,City of Melbourne,Expense,Transport,Parking,477.72,0,45441.38,D
188,123,2021-11-09,Bupa,Expense,Personal,Health & Medical,351.76,0,45089.62,D
175,123,2021-11-11,Toyota Finance,Expense,Transport,Car Repayments,167.92,0,44921.7,D
180,123,2021-11-12,Childcare Center,Expense,Personal,Children & Family,493.84,0,44427.86,D
195,123,2021-11-12,Telstra,Expense,Household,Internet,493.94,0,43933.92,D
179,123,2021-11-13,iiNet,Expense,Household,Internet,421.46,0,43512.46,D
182,123,2021-11-13,Car Dealership,Expense,Transport,Car Repayments,60.56,0,43451.9,D
177,123,2021-11-14,BP,Expense,Transport,Fuel,231.83,0,43220.07,D
187,123,2021-11-14,TransLink,Expense,Transport,Public Transport,213.73,0,43006.34,D
186,123,2021-11-15,Secure Parking,Expense,Transport,Parking,141.56,0,42864.78,D
184,123,2021-11-16,Post Office,Expense,Personal,Life Admin,227.58,0,42637.2,D
197,123,2021-11-16,Spotify,Expense,Leisure & Lifestyle,"Tv, Music & Streaming",242.0,0,42395.2,D
196,123,2021-11-17,TAB,Expense,Leisure & Lifestyle,Lottery & Gambling,349.29,0,42045.91,D
178,123,2021-11-18,Optus,Expense,Personal,Mobile Phone,111.91,0,41934.0,D
181,123,2021-11-18,MAC Cosmetics,Expense,Personal,Hair & Beauty,73.18,0,41860.82,D
190,123,2021-11-18,Apple Music,Expense,Leisure & Lifestyle,"Tv, Music & Streaming",394.01,0,41466.81,D
173,123,2021-11-19,Online Course Provider,Expense,Personal,Education,448.27,0,41018.54,D
172,123,2021-11-20,Suncorp,Expense,Household,Rates & Insurance,212.4,0,40806.14,D
174,123,2021-11-21,7-Eleven,Expense,Transport,Fuel,43.33,0,40762.81,D
183,123,2021-11-22,Mortgage Lender,Expense,Household,Rent & Mortgage,403.94,0,40358.87,D
192,123,2021-11-22,Sportsbet,Expense,Leisure & Lifestyle,Lottery & Gambling,174.28,0,40184.59,D
198,123,2021-11-22,Moshtix,Expense,Leisure & Lifestyle,Events & Gigs,200.66,0,39983.93,D
176,123,2021-11-23,Ticketmaster,Expense,Leisure & Lifestyle,Events & Gigs,84.15,0,39899.78,D
199,123,2021-11-23,IKEA,Expense,Household,Maintenance & Improvements,481.84,0,39417.94,D
191,123,2021-11-25,iiNet,Expense,Household,Internet,389.16,0,39028.78,D
194,123,2021-11-28,Hobby Store,Expense,Leisure & Lifestyle,Hobbies,305.89,0,38722.89,D
185,123,2021-11-29,Medibank,Expense,Personal,Health & Medical,374.92,0,38347.97,D
200,123,2021-12-01,Salary,Income,Income,Wages,0,8000,46347.97,C
206,123,2021-12-03,First Choice Liquor,Expense,Leisure & Lifestyle,Alcohol,400.07,0,45947.9,D
203,123,2021-12-12,Rooftop Bar,Expense,Leisure & Lifestyle,Pubs & Bars,47.67,0,45900.23,D
211,123,2021-12-14,Cotton On,Expense,Personal,Clothing & Accessories,207.16,0,45693.07,D
202,123,2021-12-16,Cigarettes,Expense,Leisure & Lifestyle,Tobacco & Vaping,217.74,0,45475.33,D
207,123,2021-12-18,Apple App Store,Expense,Leisure & Lifestyle,"Apps, Games & Software",474.56,0,45000.77,D
210,123,2021-12-21,Subway,Expense,Leisure & Lifestyle,Restaurants & Cafes,159.11,0,44841.66,D
205,123,2021-12-24,Lawyer,Expense,Personal,Life Admin,341.66,0,44500.0,D
204,123,2021-12-25,Stock Purchase,Income,Income,Investments,792.37,0,43707.63,D
201,123,2021-12-28,Stock Purchase,Expense,Personal,Investments,913.33,0,42794.3,D
208,123,2021-12-28,Uber,Expense,Transport,Taxies & Share Cars,69.32,0,42724.98,D
209,123,2021-12-28,Priceline Pharmacy,Expense,Personal,Health & Medical,480.17,0,42244.81,D
212,123,2022-01-01,Salary,Income,Income,Wages,0,8000,50244.81,C
217,123,2022-01-02,Ticketmaster,Expense,Leisure & Lifestyle,Events & Gigs,436.08,0,49808.73,D
229,123,2022-01-02,H&M,Expense,Personal,Clothing & Accessories,419.42,0,49389.31,D
227,123,2022-01-04,Allianz,Expense,Household,Rates & Insurance,360.34,0,49028.97,D
230,123,2022-01-04,PayPal,Transfer,Transfer,Transfer,211.75,0,48817.22,D
219,123,2022-01-05,GoFundMe,Expense,Personal,Gifts & Donations,298.95,0,48518.27,D
224,123,2022-01-06,Accountant,Expense,Personal,Life Admin,238.19,0,48280.08,D
232,123,2022-01-07,Expedia,Expense,Leisure & Lifestyle,Holidays & Travel,261.97,0,48018.11,D
215,123,2022-01-08,Stan,Expense,Leisure & Lifestyle,"Tv, Music & Streaming",14.08,0,48004.03,D
213,123,2022-01-10,Tutoring Service,Expense,Personal,Education,186.35,0,47817.68,D
225,123,2022-01-10,Sydney Water,Expense,Household,Utilities,331.43,0,47486.25,D
226,123,2022-01-10,Eventbrite,Expense,Leisure & Lifestyle,Events & Gigs,43.32,0,47442.93,D
228,123,2022-01-10,Printing Service,Expense,Personal,Life Admin,336.8,0,47106.13,D
221,123,2022-01-11,Costco,Expense,Household,Groceries,223.22,0,46882.91,D
216,123,2022-01-14,MAC Cosmetics,Expense,Personal,Hair & Beauty,485.44,0,46397.47,D
233,123,2022-01-14,Vodafone,Expense,Household,Internet,100.71,0,46296.76,D
222,123,2022-01-15,Charity Organization,Expense,Personal,Gifts & Donations,482.57,0,45814.19,D
223,123,2022-01-15,DiDi,Expense,Transport,Taxies & Share Cars,230.03,0,45584.16,D
220,123,2022-01-20,Stan,Expense,Leisure & Lifestyle,"Tv, Music & Streaming",266.87,0,45317.29,D
218,123,2022-01-22,The Lott,Expense,Leisure & Lifestyle,Lottery & Gambling,398.92,0,44918.37,D
231,123,2022-01-24,Online Course Provider,Expense,Personal,Education,243.42,0,44674.95,D
214,123,2022-01-26,Menulog,Expense,Leisure & Lifestyle,Takeaway,21.11,0,44653.84,D
234,123,2022-01-27,UberEats,Expense,Leisure & Lifestyle,Takeaway,11.99,0,44641.85,D
235,123,2022-02-01,Salary,Income,Income,Wages,0,8000,52641.85,C
243,123,2022-02-02,13cabs,Expense,Transport,Taxies & Share Cars,391.15,0,52250.7,D
237,123,2022-02-03,Tutoring Service,Expense,Personal,Education,336.48,0,51914.22,D
245,123,2022-02-03,Real Estate Agency,Expense,Household,Rent & Mortgage,53.8,0,51860.42,D
248,123,2022-02-04,Fitness First,Expense,Personal,Fitness & Wellbeing,96.41,0,51764.01,D
246,123,2022-02-06,Mortgage Lender,Expense,Household,Rent & Mortgage,312.43,0,51451.58,D
255,123,2022-02-09,Sports Equipment Store,Expense,Leisure & Lifestyle,Hobbies,38.05,0,51413.53,D
253,123,2022-02-10,DoorDash,Expense,Leisure & Lifestyle,Takeaway,477.0,0,50936.53,D
236,123,2022-02-11,TransLink,Expense,Transport,Public Transport,359.65,0,50576.88,D
238,123,2022-02-14,Birthday Gift,Expense,Personal,Gifts & Donations,337.71,0,50239.17,D
256,123,2022-02-16,BP,Expense,Transport,Fuel,483.71,0,49755.46,D
252,123,2022-02-17,Hobby Store,Expense,Leisure & Lifestyle,Hobbies,13.37,0,49742.09,D
254,123,2022-02-18,Lawyer,Expense,Personal,Life Admin,159.29,0,49582.8,D
241,123,2022-02-19,Cycling Apparel Store,Expense,Transport,Cycling,82.65,0,49500.15,D
249,123,2022-02-19,TransLink,Expense,Transport,Public Transport,76.16,0,49423.99,D
251,123,2022-02-19,Vodafone,Expense,Personal,Mobile Phone,138.17,0,49285.82,D
250,123,2022-02-20,Bank Transfer,Transfer,Transfer,Transfer,154.23,0,49131.59,D
247,123,2022-02-21,Venmo,Transfer,Transfer,Transfer,340.59,0,48791.0,D
239,123,2022-02-22,RACV,Expense,Transport,"Car Insurance, Rego & Maintenance",477.53,0,48313.47,D
242,123,2022-02-27,Deliveroo,Expense,Leisure & Lifestyle,Takeaway,349.76,0,47963.71,D
244,123,2022-02-27,AGL,Expense,Household,Utilities,381.08,0,47582.63,D
240,123,2022-03-01,Eventbrite,Expense,Leisure & Lifestyle,Events & Gigs,65.52,0,47517.11,D
257,123,2022-03-01,Salary,Income,Income,Wages,0,8000,55517.11,C
266,123,2022-03-04,Eventbrite,Expense,Leisure & Lifestyle,Events & Gigs,81.26,0,55435.85,D
261,123,2022-03-08,Mecca,Expense,Personal,Hair & Beauty,244.17,0,55191.68,D
263,123,2022-03-09,Sephora,Expense,Personal,Hair & Beauty,80.45,0,55111.23,D
260,123,2022-03-10,Hair Salon,Expense,Personal,Hair & Beauty,389.1,0,54722.13,D
272,123,2022-03-10,Uniqlo,Expense,Personal,Clothing & Accessories,345.96,0,54376.17,D
273,123,2022-03-11,Mecca,Expense,Personal,Hair & Beauty,124.85,0,54251.32,D
265,123,2022-03-12,BP,Expense,Transport,Fuel,120.04,0,54131.28,D
259,123,2022-03-13,CityLink,Expense,Transport,Tolls,361.68,0,53769.6,D
264,123,2022-03-13,Deliveroo,Expense,Leisure & Lifestyle,Takeaway,180.1,0,53589.5,D
267,123,2022-03-14,Amaysim,Expense,Personal,Mobile Phone,112.36,0,53477.14,D
269,123,2022-03-15,Woolworths,Expense,Household,Groceries,325.69,0,53151.45,D
270,123,2022-03-17,Birthday Gift,Expense,Personal,Gifts & Donations,495.9,0,52655.55,D
271,123,2022-03-21,13cabs,Expense,Transport,Taxies & Share Cars,254.42,0,52401.13,D
258,123,2022-03-28,Bank Transfer,Transfer,Transfer,Transfer,170.05,0,52231.08,D
262,123,2022-03-29,Charity Organization,Expense,Personal,Gifts & Donations,181.96,0,52049.12,D
268,123,2022-03-29,Zara,Expense,Personal,Clothing & Accessories,365.89,0,51683.23,D
274,123,2022-04-01,Salary,Income,Income,Wages,0,8000,59683.23,C
280,123,2022-04-08,PayPal,Transfer,Transfer,Transfer,243.0,0,59440.23,D
276,123,2022-04-12,Gym Membership,Expense,Personal,Fitness & Wellbeing,133.2,0,59307.03,D
282,123,2022-04-12,Lawyer,Expense,Personal,Life Admin,201.72,0,59105.31,D
275,123,2022-04-13,Priceline Pharmacy,Expense,Personal,Health & Medical,326.58,0,58778.73,D
284,123,2022-04-15,Bicycle Network,Expense,Transport,Cycling,479.29,0,58299.44,D
278,123,2022-04-19,Allianz,Expense,Transport,"Car Insurance, Rego & Maintenance",400.85,0,57898.59,D
281,123,2022-04-21,Telstra,Expense,Household,Internet,468.0,0,57430.59,D
277,123,2022-04-23,Art Supply Store,Expense,Leisure & Lifestyle,Hobbies,68.95,0,57361.64,D
279,123,2022-04-26,Aldi,Expense,Household,Groceries,467.71,0,56893.93,D
283,123,2022-04-28,Anytime Fitness,Expense,Personal,Fitness & Wellbeing,157.44,0,56736.49,D
285,123,2022-05-01,Salary,Income,Income,Wages,0,8000,64736.49,C
287,123,2022-05-05,Online Course Provider,Expense,Personal,Education,380.61,0,64355.88,D
294,123,2022-05-05,Toyota Finance,Expense,Transport,Car Repayments,294.57,0,64061.31,D
296,123,2022-05-06,Dan Murphy's,Expense,Leisure & Lifestyle,Alcohol,172.81,0,63888.5,D
301,123,2022-05-06,Allianz,Expense,Household,Rates & Insurance,288.87,0,63599.63,D
311,123,2022-05-06,Qantas,Expense,Leisure & Lifestyle,Holidays & Travel,119.55,0,63480.08,D
303,123,2022-05-07,Stock Purchase,Income,Income,Investments,460.5,0,63019.58,D
307,123,2022-05-07,QBE,Expense,Household,Rates & Insurance,194.02,0,62825.56,D
308,123,2022-05-07,Ticketek,Expense,Leisure & Lifestyle,Events & Gigs,267.33,0,62558.23,D
286,123,2022-05-08,Woolworths,Expense,Household,Groceries,204.85,0,62353.38,D
313,123,2022-05-08,Bunnings Warehouse,Expense,Household,Maintenance & Improvements,254.4,0,62098.98,D
289,123,2022-05-09,Lawyer,Expense,Personal,Life Admin,381.65,0,61717.33,D
295,123,2022-05-09,United Petroleum,Expense,Transport,Fuel,364.01,0,61353.32,D
306,123,2022-05-09,Telstra,Expense,Household,Internet,490.4,0,60862.92,D
299,123,2022-05-10,DiDi,Expense,Transport,Taxies & Share Cars,222.06,0,60640.86,D
302,123,2022-05-10,Childcare Center,Expense,Personal,Children & Family,257.58,0,60383.28,D
290,123,2022-05-11,Priceline Pharmacy,Expense,Personal,Health & Medical,250.38,0,60132.9,D
293,123,2022-05-11,MAC Cosmetics,Expense,Personal,Hair & Beauty,464.58,0,59668.32,D
298,123,2022-05-12,Zara,Expense,Personal,Clothing & Accessories,390.72,0,59277.6,D
309,123,2022-05-12,Woolworths,Expense,Household,Groceries,205.78,0,59071.82,D
310,123,2022-05-14,Shell,Expense,Transport,Fuel,323.82,0,58748.0,D
291,123,2022-05-16,iiNet,Expense,Household,Internet,269.72,0,58478.28,D
314,123,2022-05-17,Cigarettes,Expense,Leisure & Lifestyle,Tobacco & Vaping,199.48,0,58278.8,D
305,123,2022-05-18,AGL,Expense,Household,Utilities,361.78,0,57917.02,D
297,123,2022-05-20,Hobby Store,Expense,Leisure & Lifestyle,Hobbies,88.86,0,57828.16,D
304,123,2022-05-21,Toys R Us,Expense,Personal,Children & Family,341.33,0,57486.83,D
288,123,2022-05-22,Ticketek,Expense,Leisure & Lifestyle,Events & Gigs,74.97,0,57411.86,D
312,123,2022-05-23,Liquorland,Expense,Leisure & Lifestyle,Alcohol,27.54,0,57384.32,D
292,123,2022-05-25,H&M,Expense,Personal,Clothing & Accessories,403.76,0,56980.56,D
300,123,2022-05-25,RSPCA,Expense,Household,Pets,480.16,0,56500.4,D
315,123,2022-06-01,Salary,Income,Income,Wages,0,8000,64500.4,C
319,123,2022-06-03,Ticketmaster,Expense,Leisure & Lifestyle,Events & Gigs,257.38,0,64243.02,D
320,123,2022-06-03,Coles,Expense,Household,Groceries,291.39,0,63951.63,D
330,123,2022-06-05,Car Dealership,Expense,Transport,Car Repayments,325.59,0,63626.04,D
335,123,2022-06-07,Mortgage Lender,Expense,Household,Rent & Mortgage,209.74,0,63416.3,D
316,123,2022-06-08,Bike Shop,Expense,Transport,Cycling,307.11,0,63109.19,D
326,123,2022-06-10,IGA,Expense,Household,Groceries,132.75,0,62976.44,D
332,123,2022-06-11,IGA,Expense,Household,Groceries,160.43,0,62816.01,D
327,123,2022-06-15,Anytime Fitness,Expense,Personal,Fitness & Wellbeing,162.45,0,62653.56,D
323,123,2022-06-18,Real Estate Agency,Expense,Household,Rent & Mortgage,86.46,0,62567.1,D
329,123,2022-06-19,Priceline Pharmacy,Expense,Personal,Health & Medical,393.14,0,62173.96,D
334,123,2022-06-20,Expedia,Expense,Leisure & Lifestyle,Holidays & Travel,104.18,0,62069.78,D
318,123,2022-06-21,Mortgage Lender,Expense,Household,Rent & Mortgage,388.45,0,61681.33,D
317,123,2022-06-23,Cigarettes,Expense,Leisure & Lifestyle,Tobacco & Vaping,379.12,0,61302.21,D
321,123,2022-06-23,First Choice Liquor,Expense,Leisure & Lifestyle,Alcohol,420.48,0,60881.73,D
324,123,2022-06-25,Post Office,Expense,Personal,Life Admin,329.93,0,60551.8,D
328,123,2022-06-25,UberEats,Expense,Leisure & Lifestyle,Takeaway,146.52,0,60405.28,D
333,123,2022-06-25,Art Supply Store,Expense,Leisure & Lifestyle,Hobbies,140.36,0,60264.92,D
322,123,2022-06-26,Ola,Expense,Transport,Taxies & Share Cars,423.73,0,59841.19,D
325,123,2022-06-28,Dan Murphy's,Expense,Leisure & Lifestyle,Alcohol,37.7,0,59803.49,D
331,123,2022-06-28,Hobby Store,Expense,Leisure & Lifestyle,Hobbies,228.78,0,59574.71,D
336,123,2022-07-01,Salary,Income,Income,Wages,0,8000,67574.71,C
340,123,2022-07-02,UberEats,Expense,Leisure & Lifestyle,Takeaway,116.24,0,67458.47,D
349,123,2022-07-02,Mortgage Lender,Expense,Household,Rent & Mortgage,412.98,0,67045.49,D
341,123,2022-07-03,Google Play Store,Expense,Leisure & Lifestyle,"Apps, Games & Software",235.34,0,66810.15,D
342,123,2022-07-03,Lawyer,Expense,Personal,Life Admin,289.48,0,66520.67,D
358,123,2022-07-05,Art Supply Store,Expense,Leisure & Lifestyle,Hobbies,147.2,0,66373.47,D
353,123,2022-07-07,Fitness First,Expense,Personal,Fitness & Wellbeing,479.56,0,65893.91,D
357,123,2022-07-07,Cotton On,Expense,Personal,Clothing & Accessories,390.21,0,65503.7,D
344,123,2022-07-10,Sportsbet,Expense,Leisure & Lifestyle,Lottery & Gambling,135.06,0,65368.64,D
351,123,2022-07-11,DiDi,Expense,Transport,Taxies & Share Cars,345.1,0,65023.54,D
356,123,2022-07-12,Real Estate Agency,Expense,Household,Rent & Mortgage,255.13,0,64768.41,D
343,123,2022-07-13,Allianz,Expense,Transport,"Car Insurance, Rego & Maintenance",196.8,0,64571.61,D
348,123,2022-07-13,Ola,Expense,Transport,Taxies & Share Cars,359.19,0,64212.42,D
350,123,2022-07-13,Sports Bar,Expense,Leisure & Lifestyle,Pubs & Bars,413.33,0,63799.09,D
337,123,2022-07-14,KFC,Expense,Leisure & Lifestyle,Restaurants & Cafes,367.11,0,63431.98,D
339,123,2022-07-14,Amaysim,Expense,Personal,Mobile Phone,297.53,0,63134.45,D
360,123,2022-07-14,Stock Purchase,Income,Income,Investments,974.44,0,62160.01,D
346,123,2022-07-15,Eventbrite,Expense,Leisure & Lifestyle,Events & Gigs,24.16,0,62135.85,D
347,123,2022-07-16,AGL,Expense,Household,Utilities,70.01,0,62065.84,D
361,123,2022-07-16,Sydney Water,Expense,Household,Utilities,141.31,0,61924.53,D
364,123,2022-07-17,Optus,Expense,Personal,Mobile Phone,493.53,0,61431.0,D
345,123,2022-07-18,Stock Purchase,Expense,Personal,Investments,894.94,0,60536.06,D
359,123,2022-07-19,Dan Murphy's,Expense,Leisure & Lifestyle,Alcohol,20.4,0,60515.66,D
362,123,2022-07-21,Amaysim,Expense,Personal,Mobile Phone,457.85,0,60057.81,D
355,123,2022-07-25,BWS,Expense,Leisure & Lifestyle,Alcohol,203.38,0,59854.43,D
338,123,2022-07-27,Birthday Gift,Expense,Personal,Gifts & Donations,82.83,0,59771.6,D
352,123,2022-07-28,Caltex,Expense,Transport,Fuel,13.08,0,59758.52,D
363,123,2022-07-28,Flight Centre,Expense,Leisure & Lifestyle,Holidays & Travel,233.68,0,59524.84,D
354,123,2022-07-29,Apple Music,Expense,Leisure & Lifestyle,"Tv, Music & Streaming",156.48,0,59368.36,D
365,123,2022-08-01,Salary,Income,Income,Wages,0,8000,67368.36,C
366,123,2022-08-03,Spotify,Expense,Leisure & Lifestyle,"Tv, Music & Streaming",388.33,0,66980.03,D
377,123,2022-08-03,Subway,Expense,Leisure & Lifestyle,Restaurants & Cafes,114.56,0,66865.47,D
393,123,2022-08-04,First Choice Liquor,Expense,Leisure & Lifestyle,Alcohol,163.6,0,66701.87,D
378,123,2022-08-05,Music Store,Expense,Leisure & Lifestyle,Hobbies,315.89,0,66385.98,D
368,123,2022-08-06,Dan Murphy's,Expense,Leisure & Lifestyle,Alcohol,299.23,0,66086.75,D
373,123,2022-08-09,Landlord,Expense,Household,Rent & Mortgage,97.27,0,65989.48,D
371,123,2022-08-10,Cigars,Expense,Leisure & Lifestyle,Tobacco & Vaping,375.62,0,65613.86,D
392,123,2022-08-10,AGL,Expense,Household,Utilities,40.19,0,65573.67,D
380,123,2022-08-11,Uber,Expense,Transport,Taxies & Share Cars,180.3,0,65393.37,D
389,123,2022-08-12,Sports Equipment Store,Expense,Leisure & Lifestyle,Hobbies,340.89,0,65052.48,D
387,123,2022-08-14,Bunnings Warehouse,Expense,Household,Maintenance & Improvements,342.97,0,64709.51,D
390,123,2022-08-14,UberEats,Expense,Leisure & Lifestyle,Takeaway,282.33,0,64427.18,D
370,123,2022-08-15,Printing Service,Expense,Personal,Life Admin,91.27,0,64335.91,D
372,123,2022-08-15,DiDi,Expense,Transport,Taxies & Share Cars,58.27,0,64277.64,D
367,123,2022-08-17,Caltex,Expense,Transport,Fuel,307.07,0,63970.57,D
388,123,2022-08-18,First Choice Liquor,Expense,Leisure & Lifestyle,Alcohol,475.79,0,63494.78,D
376,123,2022-08-20,13cabs,Expense,Transport,Taxies & Share Cars,482.19,0,63012.59,D
369,123,2022-08-22,Car Loan Provider,Expense,Transport,Car Repayments,92.75,0,62919.84,D
383,123,2022-08-23,QBE,Expense,Household,Rates & Insurance,451.11,0,62468.73,D
386,123,2022-08-23,Fitness First,Expense,Personal,Fitness & Wellbeing,494.08,0,61974.65,D
375,123,2022-08-24,Sephora,Expense,Personal,Hair & Beauty,198.29,0,61776.36,D
379,123,2022-08-25,Stock Purchase,Expense,Personal,Investments,269.66,0,61506.7,D
384,123,2022-08-25,Art Supply Store,Expense,Leisure & Lifestyle,Hobbies,115.44,0,61391.26,D
385,123,2022-08-25,13cabs,Expense,Transport,Taxies & Share Cars,345.71,0,61045.55,D
374,123,2022-08-26,Car Loan Provider,Expense,Transport,Car Repayments,91.11,0,60954.44,D
382,123,2022-08-27,Subway,Expense,Leisure & Lifestyle,Restaurants & Cafes,441.69,0,60512.75,D
381,123,2022-08-29,Priceline Pharmacy,Expense,Personal,Health & Medical,247.17,0,60265.58,D
391,123,2022-08-29,Vape Shop,Expense,Leisure & Lifestyle,Tobacco & Vaping,123.78,0,60141.8,D
394,123,2022-09-01,Salary,Income,Income,Wages,0,8000,68141.8,C
411,123,2022-09-02,DiDi,Expense,Transport,Taxies & Share Cars,254.89,0,67886.91,D
413,123,2022-09-03,City of Melbourne,Expense,Transport,Parking,100.1,0,67786.81,D
406,123,2022-09-04,Vape Shop,Expense,Leisure & Lifestyle,Tobacco & Vaping,199.88,0,67586.93,D
407,123,2022-09-09,Hair Salon,Expense,Personal,Hair & Beauty,309.91,0,67277.02,D
410,123,2022-09-11,The Lott,Expense,Leisure & Lifestyle,Lottery & Gambling,422.53,0,66854.49,D
404,123,2022-09-12,Suncorp,Expense,Transport,"Car Insurance, Rego & Maintenance",15.11,0,66839.38,D
398,123,2022-09-14,Sports Equipment Store,Expense,Leisure & Lifestyle,Hobbies,411.56,0,66427.82,D
403,123,2022-09-15,Caltex,Expense,Transport,Fuel,334.91,0,66092.91,D
396,123,2022-09-16,EnergyAustralia,Expense,Household,Utilities,255.07,0,65837.84,D
412,123,2022-09-17,Real Estate Agency,Expense,Household,Rent & Mortgage,419.56,0,65418.28,D
405,123,2022-09-18,Sephora,Expense,Personal,Hair & Beauty,88.91,0,65329.37,D
402,123,2022-09-20,Opal Card,Expense,Transport,Public Transport,168.19,0,65161.18,D
395,123,2022-09-21,Greencross Vets,Expense,Household,Pets,178.13,0,64983.05,D
397,123,2022-09-22,Stock Purchase,Expense,Personal,Investments,488.62,0,64494.43,D
400,123,2022-09-22,Cycling Apparel Store,Expense,Transport,Cycling,64.14,0,64430.29,D
409,123,2022-09-22,Boost Mobile,Expense,Personal,Mobile Phone,142.32,0,64287.97,D
408,123,2022-09-26,Wilson Parking,Expense,Transport,Parking,122.32,0,64165.65,D
414,123,2022-09-26,Post Office,Expense,Personal,Life Admin,84.96,0,64080.69,D
399,123,2022-09-28,Vape Shop,Expense,Leisure & Lifestyle,Tobacco & Vaping,498.12,0,63582.57,D
401,123,2022-09-28,NRMA,Expense,Transport,"Car Insurance, Rego & Maintenance",257.37,0,63325.2,D
415,123,2022-10-01,Salary,Income,Income,Wages,0,8000,71325.2,C
420,123,2022-10-02,E-Toll,Expense,Transport,Tolls,281.86,0,71043.34,D
416,123,2022-10-03,Sydney Olympic Park,Expense,Transport,Parking,194.51,0,70848.83,D
418,123,2022-10-03,AGL,Expense,Household,Utilities,163.1,0,70685.73,D
423,123,2022-10-05,Ticketek,Expense,Leisure & Lifestyle,Events & Gigs,226.74,0,70458.99,D
429,123,2022-10-05,Petbarn,Expense,Household,Pets,477.75,0,69981.24,D
419,123,2022-10-06,AGL,Expense,Household,Utilities,109.74,0,69871.5,D
431,123,2022-10-06,Sephora,Expense,Personal,Hair & Beauty,445.68,0,69425.82,D
439,123,2022-10-07,Qantas,Expense,Leisure & Lifestyle,Holidays & Travel,102.98,0,69322.84,D
436,123,2022-10-09,Art Supply Store,Expense,Leisure & Lifestyle,Hobbies,107.59,0,69215.25,D
432,123,2022-10-10,Sports Bar,Expense,Leisure & Lifestyle,Pubs & Bars,389.19,0,68826.06,D
438,123,2022-10-10,RACV,Expense,Transport,"Car Insurance, Rego & Maintenance",63.21,0,68762.85,D
425,123,2022-10-12,University,Expense,Personal,Education,295.96,0,68466.89,D
437,123,2022-10-12,Vape Shop,Expense,Leisure & Lifestyle,Tobacco & Vaping,229.29,0,68237.6,D
441,123,2022-10-12,TPG,Expense,Household,Internet,329.39,0,67908.21,D
434,123,2022-10-15,RACV,Expense,Household,Rates & Insurance,281.98,0,67626.23,D
427,123,2022-10-16,PayPal,Transfer,Transfer,Transfer,469.54,0,67156.69,D
417,123,2022-10-19,Charity Organization,Expense,Personal,Gifts & Donations,291.58,0,66865.11,D
430,123,2022-10-19,Stock Purchase,Income,Income,Investments,296.73,0,66568.38,D
435,123,2022-10-20,EnergyAustralia,Expense,Household,Utilities,339.15,0,66229.23,D
421,123,2022-10-24,BWS,Expense,Leisure & Lifestyle,Alcohol,89.0,0,66140.23,D
422,123,2022-10-24,RACV,Expense,Household,Rates & Insurance,402.26,0,65737.97,D
426,123,2022-10-24,Flight Centre,Expense,Leisure & Lifestyle,Holidays & Travel,151.87,0,65586.1,D
428,123,2022-10-26,Booking.com,Expense,Leisure & Lifestyle,Holidays & Travel,94.68,0,65491.42,D
433,123,2022-10-26,Stock Purchase,Income,Income,Investments,807.01,0,64684.41,D
424,123,2022-10-27,Lowe's,Expense,Household,Maintenance & Improvements,159.37,0,64525.04,D
440,123,2022-10-27,Moshtix,Expense,Leisure & Lifestyle,Events & Gigs,159.12,0,64365.92,D
442,123,2022-10-29,Aldi,Expense,Household,Groceries,317.02,0,64048.9,D
443,123,2022-11-01,Salary,Income,Income,Wages,0,8000,72048.9,C
455,123,2022-11-05,Menulog,Expense,Leisure & Lifestyle,Takeaway,173.83,0,71875.07,D
449,123,2022-11-07,First Choice Liquor,Expense,Leisure & Lifestyle,Alcohol,71.39,0,71803.68,D
447,123,2022-11-10,Stock Purchase,Expense,Personal,Investments,229.74,0,71573.94,D
454,123,2022-11-11,Eventbrite,Expense,Leisure & Lifestyle,Events & Gigs,71.52,0,71502.42,D
448,123,2022-11-14,Nail Salon,Expense,Personal,Hair & Beauty,239.59,0,71262.83,D
446,123,2022-11-15,Cigars,Expense,Leisure & Lifestyle,Tobacco & Vaping,40.63,0,71222.2,D
450,123,2022-11-17,UberEats,Expense,Leisure & Lifestyle,Takeaway,410.5,0,70811.7,D
453,123,2022-11-23,Stock Purchase,Expense,Personal,Investments,585.77,0,70225.93,D
445,123,2022-11-24,Greencross Vets,Expense,Household,Pets,199.4,0,70026.53,D
452,123,2022-11-24,Uber,Expense,Transport,Taxies & Share Cars,193.37,0,69833.16,D
444,123,2022-11-29,Priceline Pharmacy,Expense,Personal,Health & Medical,273.13,0,69560.03,D
451,123,2022-11-29,Landlord,Expense,Household,Rent & Mortgage,397.71,0,69162.32,D
456,123,2022-12-01,Salary,Income,Income,Wages,0,8000,77162.32,C
457,123,2022-12-03,Hungry Jack's,Expense,Leisure & Lifestyle,Restaurants & Cafes,37.73,0,77124.59,D
468,123,2022-12-03,CityLink,Expense,Transport,Tolls,420.14,0,76704.45,D
467,123,2022-12-08,Tobacco Store,Expense,Leisure & Lifestyle,Tobacco & Vaping,470.68,0,76233.77,D
466,123,2022-12-12,Uniqlo,Expense,Personal,Clothing & Accessories,44.65,0,76189.12,D
459,123,2022-12-14,PetSmart,Expense,Household,Pets,319.95,0,75869.17,D
463,123,2022-12-15,Allianz,Expense,Household,Rates & Insurance,187.03,0,75682.14,D
458,123,2022-12-16,Stock Purchase,Expense,Personal,Investments,792.82,0,74889.32,D
461,123,2022-12-20,QBE,Expense,Transport,"Car Insurance, Rego & Maintenance",374.05,0,74515.27,D
462,123,2022-12-21,Boost Mobile,Expense,Personal,Mobile Phone,400.58,0,74114.69,D
460,123,2022-12-22,Tutoring Service,Expense,Personal,Education,438.26,0,73676.43,D
464,123,2022-12-29,Stock Purchase,Income,Income,Investments,494.75,0,73181.68,D
465,123,2022-12-29,The Lott,Expense,Leisure & Lifestyle,Lottery & Gambling,120.21,0,73061.47,D
469,123,2023-01-01,Salary,Income,Income,Wages,0,8000,81061.47,C
474,123,2023-01-03,Allianz,Expense,Household,Rates & Insurance,78.5,0,80982.97,D
486,123,2023-01-05,Sydney Olympic Park,Expense,Transport,Parking,212.93,0,80770.04,D
483,123,2023-01-06,Opal Card,Expense,Transport,Public Transport,285.21,0,80484.83,D
476,123,2023-01-08,Childcare Center,Expense,Personal,Children & Family,299.29,0,80185.54,D
473,123,2023-01-10,Hungry Jack's,Expense,Leisure & Lifestyle,Restaurants & Cafes,216.81,0,79968.73,D
481,123,2023-01-11,Spotify,Expense,Leisure & Lifestyle,"Tv, Music & Streaming",111.65,0,79857.08,D
475,123,2023-01-13,McDonald's,Expense,Leisure & Lifestyle,Restaurants & Cafes,472.19,0,79384.89,D
471,123,2023-01-16,7-Eleven,Expense,Transport,Fuel,427.39,0,78957.5,D
478,123,2023-01-17,Qantas,Expense,Leisure & Lifestyle,Holidays & Travel,128.27,0,78829.23,D
477,123,2023-01-24,Petbarn,Expense,Household,Pets,244.56,0,78584.67,D
479,123,2023-01-25,Charity Organization,Expense,Personal,Gifts & Donations,117.73,0,78466.94,D
482,123,2023-01-25,Bank Transfer,Transfer,Transfer,Transfer,439.4,0,78027.54,D
470,123,2023-01-26,McDonald's,Expense,Leisure & Lifestyle,Restaurants & Cafes,287.75,0,77739.79,D
480,123,2023-01-26,Cycling Apparel Store,Expense,Transport,Cycling,320.17,0,77419.62,D
472,123,2023-01-29,Spotify,Expense,Leisure & Lifestyle,"Tv, Music & Streaming",332.62,0,77087.0,D
484,123,2023-01-29,Priceline Pharmacy,Expense,Personal,Health & Medical,69.09,0,77017.91,D
485,123,2023-01-29,Landlord,Expense,Household,Rent & Mortgage,358.64,0,76659.27,D
487,123,2023-02-01,Salary,Income,Income,Wages,0,8000,84659.27,C
489,123,2023-02-03,Crown Casino,Expense,Leisure & Lifestyle,Lottery & Gambling,103.73,0,84555.54,D
497,123,2023-02-03,NRMA,Expense,Transport,"Car Insurance, Rego & Maintenance",26.43,0,84529.11,D
510,123,2023-02-03,Adelaide Metro,Expense,Transport,Public Transport,95.13,0,84433.98,D
503,123,2023-02-04,Art Supply Store,Expense,Leisure & Lifestyle,Hobbies,165.43,0,84268.55,D
494,123,2023-02-07,Toys R Us,Expense,Personal,Children & Family,41.17,0,84227.38,D
500,123,2023-02-08,TPG,Expense,Household,Internet,308.46,0,83918.92,D
506,123,2023-02-08,Liquorland,Expense,Leisure & Lifestyle,Alcohol,100.59,0,83818.33,D
495,123,2023-02-09,Birthday Gift,Expense,Personal,Gifts & Donations,286.59,0,83531.74,D
508,123,2023-02-09,RACV,Expense,Household,Rates & Insurance,380.54,0,83151.2,D
490,123,2023-02-10,Boost Mobile,Expense,Personal,Mobile Phone,499.19,0,82652.01,D
499,123,2023-02-12,AGL,Expense,Household,Utilities,315.77,0,82336.24,D
509,123,2023-02-12,Ola,Expense,Transport,Taxies & Share Cars,433.18,0,81903.06,D
501,123,2023-02-13,Uniqlo,Expense,Personal,Clothing & Accessories,112.89,0,81790.17,D
498,123,2023-02-14,Tobacco Store,Expense,Leisure & Lifestyle,Tobacco & Vaping,271.55,0,81518.62,D
492,123,2023-02-15,QBE,Expense,Household,Rates & Insurance,446.23,0,81072.39,D
496,123,2023-02-18,Menulog,Expense,Leisure & Lifestyle,Takeaway,439.34,0,80633.05,D
504,123,2023-02-18,DoorDash,Expense,Leisure & Lifestyle,Takeaway,220.68,0,80412.37,D
502,123,2023-02-19,Stock Purchase,Income,Income,Investments,805.9,0,79606.47,D
493,123,2023-02-20,Origin Energy,Expense,Household,Utilities,248.36,0,79358.11,D
507,123,2023-02-23,Subway,Expense,Leisure & Lifestyle,Restaurants & Cafes,436.3,0,78921.81,D
488,123,2023-02-27,Bicycle Network,Expense,Transport,Cycling,90.59,0,78831.22,D
491,123,2023-02-27,Liquorland,Expense,Leisure & Lifestyle,Alcohol,403.05,0,78428.17,D
505,123,2023-02-27,Greencross Vets,Expense,Household,Pets,115.35,0,78312.82,D
511,123,2023-02-27,Sports Equipment Store,Expense,Leisure & Lifestyle,Hobbies,318.4,0,77994.42,D
512,123,2023-03-01,Salary,Income,Income,Wages,0,8000,85994.42,C
528,123,2023-03-02,Sports Equipment Store,Expense,Leisure & Lifestyle,Hobbies,184.17,0,85810.25,D
517,123,2023-03-03,RACV,Expense,Transport,"Car Insurance, Rego & Maintenance",458.12,0,85352.13,D
527,123,2023-03-03,Fitness First,Expense,Personal,Fitness & Wellbeing,171.39,0,85180.74,D
516,123,2023-03-04,Expedia,Expense,Leisure & Lifestyle,Holidays & Travel,442.53,0,84738.21,D
520,123,2023-03-05,Suncorp,Expense,Household,Rates & Insurance,87.66,0,84650.55,D
524,123,2023-03-06,Bike Shop,Expense,Transport,Cycling,81.28,0,84569.27,D
514,123,2023-03-07,Adobe Creative Cloud,Expense,Leisure & Lifestyle,"Apps, Games & Software",206.53,0,84362.74,D
519,123,2023-03-10,Stock Purchase,Income,Income,Investments,976.58,0,83386.16,D
522,123,2023-03-10,Cigars,Expense,Leisure & Lifestyle,Tobacco & Vaping,268.45,0,83117.71,D
513,123,2023-03-15,Sports Bar,Expense,Leisure & Lifestyle,Pubs & Bars,210.21,0,82907.5,D
518,123,2023-03-18,GoFundMe,Expense,Personal,Gifts & Donations,382.78,0,82524.72,D
521,123,2023-03-18,Sephora,Expense,Personal,Hair & Beauty,166.55,0,82358.17,D
525,123,2023-03-20,City of Melbourne,Expense,Transport,Parking,104.08,0,82254.09,D
523,123,2023-03-24,YouTube Premium,Expense,Leisure & Lifestyle,"Tv, Music & Streaming",423.44,0,81830.65,D
529,123,2023-03-26,Chemist Warehouse,Expense,Personal,Health & Medical,238.2,0,81592.45,D
530,123,2023-03-26,Lawyer,Expense,Personal,Life Admin,456.17,0,81136.28,D
515,123,2023-03-27,McDonald's,Expense,Leisure & Lifestyle,Restaurants & Cafes,227.78,0,80908.5,D
526,123,2023-03-27,Adelaide Metro,Expense,Transport,Public Transport,409.94,0,80498.56,D
531,123,2023-03-28,Stock Purchase,Expense,Personal,Investments,823.98,0,79674.58,D
532,123,2023-04-01,Salary,Income,Income,Wages,0,8000,87674.58,C
535,123,2023-04-03,Domino's Pizza,Expense,Leisure & Lifestyle,Restaurants & Cafes,299.09,0,87375.49,D
543,123,2023-04-04,Myki,Expense,Transport,Public Transport,446.75,0,86928.74,D
539,123,2023-04-05,Venmo,Transfer,Transfer,Transfer,336.78,0,86591.96,D
548,123,2023-04-05,YouTube Premium,Expense,Leisure & Lifestyle,"Tv, Music & Streaming",19.23,0,86572.73,D
534,123,2023-04-06,Medibank,Expense,Personal,Health & Medical,11.56,0,86561.17,D
540,123,2023-04-06,Cycling Apparel Store,Expense,Transport,Cycling,134.11,0,86427.06,D
549,123,2023-04-07,Bicycle Network,Expense,Transport,Cycling,176.42,0,86250.64,D
538,123,2023-04-09,Vape Shop,Expense,Leisure & Lifestyle,Tobacco & Vaping,478.86,0,85771.78,D
546,123,2023-04-09,Charity Organization,Expense,Personal,Gifts & Donations,263.68,0,85508.1,D
537,123,2023-04-11,Yoga Studio,Expense,Personal,Fitness & Wellbeing,263.66,0,85244.44,D
542,123,2023-04-13,Local Pub,Expense,Leisure & Lifestyle,Pubs & Bars,206.9,0,85037.54,D
545,123,2023-04-15,TransLink,Expense,Transport,Public Transport,199.49,0,84838.05,D
533,123,2023-04-18,QBE,Expense,Transport,"Car Insurance, Rego & Maintenance",127.69,0,84710.36,D
547,123,2023-04-19,Hair Salon,Expense,Personal,Hair & Beauty,72.08,0,84638.28,D
536,123,2023-04-21,Car Loan Provider,Expense,Transport,Car Repayments,470.83,0,84167.45,D
541,123,2023-04-26,Apple App Store,Expense,Leisure & Lifestyle,"Apps, Games & Software",332.18,0,83835.27,D
544,123,2023-04-29,Eventbrite,Expense,Leisure & Lifestyle,Events & Gigs,133.83,0,83701.44,D
550,123,2023-05-01,Salary,Income,Income,Wages,0,8000,91701.44,C
559,123,2023-05-05,Bank Transfer,Transfer,Transfer,Transfer,194.35,0,91507.09,D
564,123,2023-05-07,University,Expense,Personal,Education,202.31,0,91304.78,D
560,123,2023-05-08,Sephora,Expense,Personal,Hair & Beauty,397.48,0,90907.3,D
562,123,2023-05-09,EnergyAustralia,Expense,Household,Utilities,204.85,0,90702.45,D
566,123,2023-05-09,Sydney Water,Expense,Household,Utilities,413.07,0,90289.38,D
568,123,2023-05-10,Stock Purchase,Expense,Personal,Investments,568.45,0,89720.93,D
567,123,2023-05-11,United Petroleum,Expense,Transport,Fuel,167.24,0,89553.69,D
556,123,2023-05-15,Steam,Expense,Leisure & Lifestyle,"Apps, Games & Software",391.19,0,89162.5,D
563,123,2023-05-15,The Lott,Expense,Leisure & Lifestyle,Lottery & Gambling,436.2,0,88726.3,D
565,123,2023-05-16,Car Loan Provider,Expense,Transport,Car Repayments,496.03,0,88230.27,D
552,123,2023-05-17,Music Store,Expense,Leisure & Lifestyle,Hobbies,185.79,0,88044.48,D
553,123,2023-05-22,Car Dealership,Expense,Transport,Car Repayments,472.96,0,87571.52,D
554,123,2023-05-22,City of Melbourne,Expense,Transport,Parking,83.19,0,87488.33,D
561,123,2023-05-22,Priceline Pharmacy,Expense,Personal,Health & Medical,116.91,0,87371.42,D
551,123,2023-05-24,7-Eleven,Expense,Transport,Fuel,155.1,0,87216.32,D
555,123,2023-05-26,Charity Organization,Expense,Personal,Gifts & Donations,99.45,0,87116.87,D
557,123,2023-05-26,NIB,Expense,Personal,Health & Medical,225.73,0,86891.14,D
558,123,2023-05-26,Car Dealership,Expense,Transport,Car Repayments,25.98,0,86865.16,D
569,123,2023-05-26,QBE,Expense,Transport,"Car Insurance, Rego & Maintenance",108.33,0,86756.83,D
570,123,2023-06-01,Salary,Income,Income,Wages,0,8000,94756.83,C
584,123,2023-06-02,KFC,Expense,Leisure & Lifestyle,Restaurants & Cafes,107.02,0,94649.81,D
587,123,2023-06-03,Dan Murphy's,Expense,Leisure & Lifestyle,Alcohol,170.1,0,94479.71,D
572,123,2023-06-06,PetSmart,Expense,Household,Pets,399.36,0,94080.35,D
581,123,2023-06-07,Cigarettes,Expense,Leisure & Lifestyle,Tobacco & Vaping,130.52,0,93949.83,D
585,123,2023-06-07,The Iconic,Expense,Personal,Clothing & Accessories,453.41,0,93496.42,D
586,123,2023-06-07,H&M,Expense,Personal,Clothing & Accessories,215.47,0,93280.95,D
573,123,2023-06-08,City of Melbourne,Expense,Transport,Parking,255.59,0,93025.36,D
575,123,2023-06-10,Post Office,Expense,Personal,Life Admin,430.41,0,92594.95,D
588,123,2023-06-10,RACV,Expense,Household,Rates & Insurance,457.09,0,92137.86,D
582,123,2023-06-11,McDonald's,Expense,Leisure & Lifestyle,Restaurants & Cafes,101.53,0,92036.33,D
577,123,2023-06-12,Stock Purchase,Income,Income,Investments,877.7,0,91158.63,D
579,123,2023-06-13,Stock Purchase,Income,Income,Investments,290.58,0,90868.05,D
571,123,2023-06-15,City of Melbourne,Expense,Transport,Parking,66.8,0,90801.25,D
574,123,2023-06-19,TAB,Expense,Leisure & Lifestyle,Lottery & Gambling,313.9,0,90487.35,D
578,123,2023-06-19,Apple App Store,Expense,Leisure & Lifestyle,"Apps, Games & Software",166.08,0,90321.27,D
576,123,2023-06-20,Petbarn,Expense,Household,Pets,185.47,0,90135.8,D
580,123,2023-06-27,Chemist Warehouse,Expense,Personal,Health & Medical,98.09,0,90037.71,D
583,123,2023-06-29,Stock Purchase,Income,Income,Investments,482.82,0,89554.89,D
589,123,2023-07-01,Salary,Income,Income,Wages,0,8000,97554.89,C
596,123,2023-07-02,Ticketek,Expense,Leisure & Lifestyle,Events & Gigs,349.9,0,97204.99,D
602,123,2023-07-02,Art Supply Store,Expense,Leisure & Lifestyle,Hobbies,141.13,0,97063.86,D
595,123,2023-07-03,Nail Salon,Expense,Personal,Hair & Beauty,476.01,0,96587.85,D
609,123,2023-07-03,Stock Purchase,Expense,Personal,Investments,240.99,0,96346.86,D
617,123,2023-07-04,Stock Purchase,Income,Income,Investments,644.78,0,95702.08,D
604,123,2023-07-05,KFC,Expense,Leisure & Lifestyle,Restaurants & Cafes,242.61,0,95459.47,D
598,123,2023-07-06,Bank Transfer,Transfer,Transfer,Transfer,108.74,0,95350.73,D
590,123,2023-07-07,Art Supply Store,Expense,Leisure & Lifestyle,Hobbies,473.24,0,94877.49,D
591,123,2023-07-08,Cycling Apparel Store,Expense,Transport,Cycling,375.35,0,94502.14,D
610,123,2023-07-08,KFC,Expense,Leisure & Lifestyle,Restaurants & Cafes,266.67,0,94235.47,D
613,123,2023-07-09,Music Store,Expense,Leisure & Lifestyle,Hobbies,119.33,0,94116.14,D
599,123,2023-07-11,Music Store,Expense,Leisure & Lifestyle,Hobbies,410.38,0,93705.76,D
603,123,2023-07-11,First Choice Liquor,Expense,Leisure & Lifestyle,Alcohol,58.29,0,93647.47,D
597,123,2023-07-12,Printing Service,Expense,Personal,Life Admin,266.94,0,93380.53,D
615,123,2023-07-12,PayPal,Transfer,Transfer,Transfer,329.19,0,93051.34,D
592,123,2023-07-13,Stock Purchase,Income,Income,Investments,445.97,0,92605.37,D
608,123,2023-07-14,TPG,Expense,Household,Internet,190.4,0,92414.97,D
611,123,2023-07-18,University,Expense,Personal,Education,52.52,0,92362.45,D
606,123,2023-07-21,Wilson Parking,Expense,Transport,Parking,451.76,0,91910.69,D
605,123,2023-07-22,Steam,Expense,Leisure & Lifestyle,"Apps, Games & Software",465.58,0,91445.11,D
614,123,2023-07-22,Tutoring Service,Expense,Personal,Education,60.32,0,91384.79,D
593,123,2023-07-23,AGL,Expense,Household,Utilities,420.98,0,90963.81,D
594,123,2023-07-23,Printing Service,Expense,Personal,Life Admin,208.53,0,90755.28,D
607,123,2023-07-23,Coles,Expense,Household,Groceries,111.07,0,90644.21,D
618,123,2023-07-23,Sydney Olympic Park,Expense,Transport,Parking,335.28,0,90308.93,D
612,123,2023-07-25,Optus,Expense,Household,Internet,359.45,0,89949.48,D
616,123,2023-07-25,Baby Bunting,Expense,Personal,Children & Family,183.39,0,89766.09,D
600,123,2023-07-27,Gym Membership,Expense,Personal,Fitness & Wellbeing,95.4,0,89670.69,D
601,123,2023-07-27,Suncorp,Expense,Household,Rates & Insurance,434.09,0,89236.6,D
619,123,2023-08-01,Salary,Income,Income,Wages,0,8000,97236.6,C
621,123,2023-08-02,Bike Shop,Expense,Transport,Cycling,241.95,0,96994.65,D
623,123,2023-08-03,Cigarettes,Expense,Leisure & Lifestyle,Tobacco & Vaping,327.66,0,96666.99,D
625,123,2023-08-04,Amaysim,Expense,Personal,Mobile Phone,368.13,0,96298.86,D
637,123,2023-08-05,Amaysim,Expense,Personal,Mobile Phone,462.11,0,95836.75,D
640,123,2023-08-05,Bike Shop,Expense,Transport,Cycling,274.07,0,95562.68,D
639,123,2023-08-06,Spotify,Expense,Leisure & Lifestyle,"Tv, Music & Streaming",483.27,0,95079.41,D
642,123,2023-08-08,EastLink,Expense,Transport,Tolls,413.09,0,94666.32,D
620,123,2023-08-10,7-Eleven,Expense,Transport,Fuel,243.52,0,94422.8,D
631,123,2023-08-11,Cigars,Expense,Leisure & Lifestyle,Tobacco & Vaping,151.29,0,94271.51,D
647,123,2023-08-11,Birthday Gift,Expense,Personal,Gifts & Donations,462.15,0,93809.36,D
626,123,2023-08-12,Coles,Expense,Household,Groceries,198.26,0,93611.1,D
646,123,2023-08-12,QBE,Expense,Household,Rates & Insurance,437.56,0,93173.54,D
627,123,2023-08-14,DoorDash,Expense,Leisure & Lifestyle,Takeaway,347.12,0,92826.42,D
628,123,2023-08-14,Secure Parking,Expense,Transport,Parking,459.08,0,92367.34,D
644,123,2023-08-15,Hair Salon,Expense,Personal,Hair & Beauty,62.98,0,92304.36,D
641,123,2023-08-16,TAB,Expense,Leisure & Lifestyle,Lottery & Gambling,472.88,0,91831.48,D
635,123,2023-08-17,PetSmart,Expense,Household,Pets,436.42,0,91395.06,D
645,123,2023-08-17,Google Play Store,Expense,Leisure & Lifestyle,"Apps, Games & Software",81.41,0,91313.65,D
629,123,2023-08-19,Eventbrite,Expense,Leisure & Lifestyle,Events & Gigs,486.21,0,90827.44,D
622,123,2023-08-21,Vodafone,Expense,Personal,Mobile Phone,80.52,0,90746.92,D
636,123,2023-08-21,GoFundMe,Expense,Personal,Gifts & Donations,499.83,0,90247.09,D
638,123,2023-08-21,Stock Purchase,Expense,Personal,Investments,865.92,0,89381.17,D
630,123,2023-08-23,Aldi,Expense,Household,Groceries,288.78,0,89092.39,D
624,123,2023-08-24,Car Dealership,Expense,Transport,Car Repayments,72.32,0,89020.07,D
633,123,2023-08-24,Costco,Expense,Household,Groceries,245.86,0,88774.21,D
643,123,2023-08-27,Medibank,Expense,Personal,Health & Medical,362.82,0,88411.39,D
648,123,2023-08-27,CityLink,Expense,Transport,Tolls,497.95,0,87913.44,D
632,123,2023-08-28,GoFundMe,Expense,Personal,Gifts & Donations,332.34,0,87581.1,D
634,123,2023-08-28,Steam,Expense,Leisure & Lifestyle,"Apps, Games & Software",375.36,0,87205.74,D
649,123,2023-09-01,Salary,Income,Income,Wages,0,8000,95205.74,C
667,123,2023-09-02,Tobacco Store,Expense,Leisure & Lifestyle,Tobacco & Vaping,120.02,0,95085.72,D
659,123,2023-09-03,Birthday Gift,Expense,Personal,Gifts & Donations,276.64,0,94809.08,D
652,123,2023-09-04,Stock Purchase,Expense,Personal,Investments,919.66,0,93889.42,D
650,123,2023-09-07,NRMA,Expense,Transport,"Car Insurance, Rego & Maintenance",202.93,0,93686.49,D
670,123,2023-09-08,DoorDash,Expense,Leisure & Lifestyle,Takeaway,404.74,0,93281.75,D
655,123,2023-09-09,Vape Shop,Expense,Leisure & Lifestyle,Tobacco & Vaping,325.96,0,92955.79,D
654,123,2023-09-11,Stock Purchase,Expense,Personal,Investments,568.68,0,92387.11,D
651,123,2023-09-12,Menulog,Expense,Leisure & Lifestyle,Takeaway,160.0,0,92227.11,D
658,123,2023-09-12,Hobby Store,Expense,Leisure & Lifestyle,Hobbies,71.26,0,92155.85,D
672,123,2023-09-14,GoCatch,Expense,Transport,Taxies & Share Cars,320.75,0,91835.1,D
653,123,2023-09-15,Myki,Expense,Transport,Public Transport,315.86,0,91519.24,D
664,123,2023-09-16,Cocktail Bar,Expense,Leisure & Lifestyle,Pubs & Bars,63.66,0,91455.58,D
662,123,2023-09-17,Menulog,Expense,Leisure & Lifestyle,Takeaway,336.39,0,91119.19,D
663,123,2023-09-18,Toys R Us,Expense,Personal,Children & Family,405.3,0,90713.89,D
660,123,2023-09-20,City of Melbourne,Expense,Transport,Parking,401.35,0,90312.54,D
657,123,2023-09-21,Stock Purchase,Expense,Personal,Investments,964.77,0,89347.77,D
665,123,2023-09-21,Lawyer,Expense,Personal,Life Admin,318.74,0,89029.03,D
661,123,2023-09-23,Sports Equipment Store,Expense,Leisure & Lifestyle,Hobbies,372.49,0,88656.54,D
669,123,2023-09-25,Myki,Expense,Transport,Public Transport,242.9,0,88413.64,D
668,123,2023-09-26,NIB,Expense,Personal,Health & Medical,158.44,0,88255.2,D
656,123,2023-09-29,Subway,Expense,Leisure & Lifestyle,Restaurants & Cafes,106.84,0,88148.36,D
666,123,2023-09-29,Booking.com,Expense,Leisure & Lifestyle,Holidays & Travel,48.04,0,88100.32,D
671,123,2023-09-29,IGA,Expense,Household,Groceries,179.43,0,87920.89,D
673,123,2023-10-01,Salary,Income,Income,Wages,0,8000,95920.89,C
677,123,2023-10-03,PayPal,Transfer,Transfer,Transfer,199.53,0,95721.36,D
687,123,2023-10-05,Allianz,Expense,Household,Rates & Insurance,121.67,0,95599.69,D
676,123,2023-10-07,TPG,Expense,Household,Internet,166.78,0,95432.91,D
678,123,2023-10-09,Cigarettes,Expense,Leisure & Lifestyle,Tobacco & Vaping,139.4,0,95293.51,D
688,123,2023-10-09,Cycling Apparel Store,Expense,Transport,Cycling,261.33,0,95032.18,D
686,123,2023-10-12,Real Estate Agency,Expense,Household,Rent & Mortgage,175.12,0,94857.06,D
690,123,2023-10-12,Mortgage Lender,Expense,Household,Rent & Mortgage,170.42,0,94686.64,D
692,123,2023-10-13,Ticketmaster,Expense,Leisure & Lifestyle,Events & Gigs,15.59,0,94671.05,D
685,123,2023-10-14,Cocktail Bar,Expense,Leisure & Lifestyle,Pubs & Bars,357.54,0,94313.51,D
682,123,2023-10-15,The Iconic,Expense,Personal,Clothing & Accessories,456.75,0,93856.76,D
684,123,2023-10-15,Printing Service,Expense,Personal,Life Admin,371.22,0,93485.54,D
679,123,2023-10-18,McDonald's,Expense,Leisure & Lifestyle,Restaurants & Cafes,282.99,0,93202.55,D
680,123,2023-10-18,YouTube Premium,Expense,Leisure & Lifestyle,"Tv, Music & Streaming",155.51,0,93047.04,D
674,123,2023-10-19,Expedia,Expense,Leisure & Lifestyle,Holidays & Travel,224.72,0,92822.32,D
681,123,2023-10-19,Stock Purchase,Income,Income,Investments,195.4,0,92626.92,D
691,123,2023-10-19,Apple App Store,Expense,Leisure & Lifestyle,"Apps, Games & Software",100.0,0,92526.92,D
675,123,2023-10-20,Tatts,Expense,Leisure & Lifestyle,Lottery & Gambling,420.47,0,92106.45,D
683,123,2023-10-22,Boost Mobile,Expense,Personal,Mobile Phone,40.43,0,92066.02,D
689,123,2023-10-23,Suncorp,Expense,Transport,"Car Insurance, Rego & Maintenance",68.89,0,91997.13,D
693,123,2023-11-01,Salary,Income,Income,Wages,0,8000,99997.13,C
694,123,2023-11-04,Stock Purchase,Expense,Personal,Investments,204.62,0,99792.51,D
702,123,2023-11-05,First Choice Liquor,Expense,Leisure & Lifestyle,Alcohol,72.51,0,99720.0,D
714,123,2023-11-05,Cycling Apparel Store,Expense,Transport,Cycling,203.44,0,99516.56,D
711,123,2023-11-07,Optus,Expense,Personal,Mobile Phone,274.39,0,99242.17,D
707,123,2023-11-08,Flight Centre,Expense,Leisure & Lifestyle,Holidays & Travel,471.25,0,98770.92,D
700,123,2023-11-09,Art Supply Store,Expense,Leisure & Lifestyle,Hobbies,115.73,0,98655.19,D
703,123,2023-11-09,EastLink,Expense,Transport,Tolls,274.21,0,98380.98,D
704,123,2023-11-09,Eventbrite,Expense,Leisure & Lifestyle,Events & Gigs,379.07,0,98001.91,D
708,123,2023-11-11,Stock Purchase,Expense,Personal,Investments,868.92,0,97132.99,D
705,123,2023-11-14,Art Supply Store,Expense,Leisure & Lifestyle,Hobbies,417.47,0,96715.52,D
713,123,2023-11-14,Linkt,Expense,Transport,Tolls,40.77,0,96674.75,D
695,123,2023-11-15,University,Expense,Personal,Education,426.64,0,96248.11,D
699,123,2023-11-16,First Choice Liquor,Expense,Leisure & Lifestyle,Alcohol,289.85,0,95958.26,D
706,123,2023-11-17,Bank Transfer,Transfer,Transfer,Transfer,490.24,0,95468.02,D
710,123,2023-11-18,NRMA,Expense,Household,Rates & Insurance,190.94,0,95277.08,D
701,123,2023-11-19,Google Play Store,Expense,Leisure & Lifestyle,"Apps, Games & Software",354.74,0,94922.34,D
698,123,2023-11-21,Steam,Expense,Leisure & Lifestyle,"Apps, Games & Software",258.54,0,94663.8,D
712,123,2023-11-25,Ticketek,Expense,Leisure & Lifestyle,Events & Gigs,459.18,0,94204.62,D
709,123,2023-11-26,University,Expense,Personal,Education,248.19,0,93956.43,D
696,123,2023-11-29,E-Toll,Expense,Transport,Tolls,49.59,0,93906.84,D
697,123,2023-11-29,IGA,Expense,Household,Groceries,130.17,0,93776.67,D
715,123,2023-12-01,Salary,Income,Income,Wages,0,8000,101776.67,C
726,123,2023-12-02,Landlord,Expense,Household,Rent & Mortgage,428.25,0,101348.42,D
718,123,2023-12-03,GoFundMe,Expense,Personal,Gifts & Donations,109.1,0,101239.32,D
727,123,2023-12-04,EastLink,Expense,Transport,Tolls,140.81,0,101098.51,D
729,123,2023-12-04,Hungry Jack's,Expense,Leisure & Lifestyle,Restaurants & Cafes,102.59,0,100995.92,D
735,123,2023-12-04,Cigarettes,Expense,Leisure & Lifestyle,Tobacco & Vaping,18.23,0,100977.69,D
719,123,2023-12-05,Domino's Pizza,Expense,Leisure & Lifestyle,Restaurants & Cafes,400.55,0,100577.14,D
739,123,2023-12-05,Telstra,Expense,Personal,Mobile Phone,128.52,0,100448.62,D
736,123,2023-12-06,Stock Purchase,Expense,Personal,Investments,295.7,0,100152.92,D
723,123,2023-12-07,TPG,Expense,Household,Internet,475.64,0,99677.28,D
731,123,2023-12-07,Cotton On,Expense,Personal,Clothing & Accessories,220.92,0,99456.36,D
722,123,2023-12-08,Yoga Studio,Expense,Personal,Fitness & Wellbeing,38.75,0,99417.61,D
732,123,2023-12-12,Lowe's,Expense,Household,Maintenance & Improvements,159.81,0,99257.8,D
728,123,2023-12-15,Cycling Apparel Store,Expense,Transport,Cycling,83.81,0,99173.99,D
740,123,2023-12-15,Menulog,Expense,Leisure & Lifestyle,Takeaway,271.82,0,98902.17,D
733,123,2023-12-16,DiDi,Expense,Transport,Taxies & Share Cars,390.68,0,98511.49,D
738,123,2023-12-17,IKEA,Expense,Household,Maintenance & Improvements,216.38,0,98295.11,D
720,123,2023-12-18,Secure Parking,Expense,Transport,Parking,88.59,0,98206.52,D
734,123,2023-12-18,DoorDash,Expense,Leisure & Lifestyle,Takeaway,479.55,0,97726.97,D
721,123,2023-12-20,YouTube Premium,Expense,Leisure & Lifestyle,"Tv, Music & Streaming",157.69,0,97569.28,D
724,123,2023-12-20,Uniqlo,Expense,Personal,Clothing & Accessories,258.68,0,97310.6,D
716,123,2023-12-21,Childcare Center,Expense,Personal,Children & Family,334.33,0,96976.27,D
717,123,2023-12-22,Optus,Expense,Household,Internet,376.35,0,96599.92,D
737,123,2023-12-22,Steam,Expense,Leisure & Lifestyle,"Apps, Games & Software",65.71,0,96534.21,D
730,123,2023-12-27,Stock Purchase,Expense,Personal,Investments,765.07,0,95769.14,D
725,123,2023-12-28,Domino's Pizza,Expense,Leisure & Lifestyle,Restaurants & Cafes,418.27,0,95350.87,D
741,456,2021-01-01,Salary,Income,Income,Wages,0,8000,8000,C
742,456,2021-01-09,Uber,Expense,Transport,Taxies & Share Cars,226.97,0,7773.03,D
759,456,2021-01-09,Stock Purchase,Income,Income,Investments,640.52,0,7132.51,D
754,456,2021-01-11,Medibank,Expense,Personal,Health & Medical,19.54,0,7112.97,D
743,456,2021-01-13,TAB,Expense,Leisure & Lifestyle,Lottery & Gambling,42.2,0,7070.77,D
752,456,2021-01-15,EnergyAustralia,Expense,Household,Utilities,313.21,0,6757.56,D
749,456,2021-01-16,Sydney Olympic Park,Expense,Transport,Parking,79.68,0,6677.88,D
751,456,2021-01-16,Domino's Online,Expense,Leisure & Lifestyle,Takeaway,62.64,0,6615.24,D
758,456,2021-01-16,Priceline Pharmacy,Expense,Personal,Health & Medical,380.43,0,6234.81,D
747,456,2021-01-18,TPG,Expense,Household,Internet,118.22,0,6116.59,D
748,456,2021-01-18,Google Play Store,Expense,Leisure & Lifestyle,"Apps, Games & Software",311.0,0,5805.59,D
757,456,2021-01-18,Cigarettes,Expense,Leisure & Lifestyle,Tobacco & Vaping,388.15,0,5417.44,D
753,456,2021-01-19,Stock Purchase,Expense,Personal,Investments,151.65,0,5265.79,D
745,456,2021-01-20,Car Loan Provider,Expense,Transport,Car Repayments,42.16,0,5223.63,D
755,456,2021-01-20,Yoga Studio,Expense,Personal,Fitness & Wellbeing,126.53,0,5097.1,D
760,456,2021-01-23,Toyota Finance,Expense,Transport,Car Repayments,114.67,0,4982.43,D
756,456,2021-01-25,Telstra,Expense,Personal,Mobile Phone,486.6,0,4495.83,D
750,456,2021-01-26,Lawyer,Expense,Personal,Life Admin,23.72,0,4472.11,D
744,456,2021-01-27,Car Dealership,Expense,Transport,Car Repayments,395.3,0,4076.81,D
746,456,2021-01-27,Bunnings Warehouse,Expense,Household,Maintenance & Improvements,210.56,0,3866.25,D
761,456,2021-02-01,Salary,Income,Income,Wages,0,8000,11866.25,C
766,456,2021-02-04,Stock Purchase,Expense,Personal,Investments,847.76,0,11018.49,D
770,456,2021-02-13,Tobacco Store,Expense,Leisure & Lifestyle,Tobacco & Vaping,231.52,0,10786.97,D
768,456,2021-02-14,Woolworths,Expense,Household,Groceries,341.35,0,10445.62,D
769,456,2021-02-17,Hobby Store,Expense,Leisure & Lifestyle,Hobbies,259.84,0,10185.78,D
765,456,2021-02-19,Tutoring Service,Expense,Personal,Education,401.8,0,9783.98,D
771,456,2021-02-20,Ticketek,Expense,Leisure & Lifestyle,Events & Gigs,413.31,0,9370.67,D
764,456,2021-02-22,QBE,Expense,Transport,"Car Insurance, Rego & Maintenance",490.65,0,8880.02,D
762,456,2021-02-23,DiDi,Expense,Transport,Taxies & Share Cars,199.74,0,8680.28,D
767,456,2021-02-23,Hungry Jack's,Expense,Leisure & Lifestyle,Restaurants & Cafes,279.6,0,8400.68,D
763,456,2021-02-26,University,Expense,Personal,Education,192.02,0,8208.66,D
772,456,2021-03-01,Salary,Income,Income,Wages,0,8000,16208.66,C
775,456,2021-03-02,Charity Organization,Expense,Personal,Gifts & Donations,215.48,0,15993.18,D
781,456,2021-03-02,Qantas,Expense,Leisure & Lifestyle,Holidays & Travel,67.42,0,15925.76,D
782,456,2021-03-04,Stan,Expense,Leisure & Lifestyle,"Tv, Music & Streaming",442.44,0,15483.32,D
778,456,2021-03-11,GoCatch,Expense,Transport,Taxies & Share Cars,474.91,0,15008.41,D
780,456,2021-03-12,Ola,Expense,Transport,Taxies & Share Cars,43.1,0,14965.31,D
773,456,2021-03-14,Sports Bar,Expense,Leisure & Lifestyle,Pubs & Bars,267.9,0,14697.41,D
784,456,2021-03-15,Suncorp,Expense,Household,Rates & Insurance,13.67,0,14683.74,D
783,456,2021-03-17,Cycling Apparel Store,Expense,Transport,Cycling,220.58,0,14463.16,D
776,456,2021-03-19,EnergyAustralia,Expense,Household,Utilities,119.51,0,14343.65,D
777,456,2021-03-26,Lawyer,Expense,Personal,Life Admin,301.99,0,14041.66,D
774,456,2021-03-27,Qantas,Expense,Leisure & Lifestyle,Holidays & Travel,123.94,0,13917.72,D
779,456,2021-03-27,Linkt,Expense,Transport,Tolls,449.74,0,13467.98,D
785,456,2021-04-01,Salary,Income,Income,Wages,0,8000,21467.98,C
788,456,2021-04-08,NRMA,Expense,Household,Rates & Insurance,115.93,0,21352.05,D
792,456,2021-04-08,Tobacco Store,Expense,Leisure & Lifestyle,Tobacco & Vaping,330.61,0,21021.44,D
789,456,2021-04-11,Booking.com,Expense,Leisure & Lifestyle,Holidays & Travel,49.49,0,20971.95,D
794,456,2021-04-11,Music Store,Expense,Leisure & Lifestyle,Hobbies,177.91,0,20794.04,D
787,456,2021-04-13,NRMA,Expense,Household,Rates & Insurance,192.92,0,20601.12,D
793,456,2021-04-16,Ticketek,Expense,Leisure & Lifestyle,Events & Gigs,484.75,0,20116.37,D
797,456,2021-04-16,Ticketek,Expense,Leisure & Lifestyle,Events & Gigs,378.44,0,19737.93,D
791,456,2021-04-18,Stock Purchase,Expense,Personal,Investments,861.57,0,18876.36,D
786,456,2021-04-19,Sydney Water,Expense,Household,Utilities,61.17,0,18815.19,D
790,456,2021-04-24,Aldi,Expense,Household,Groceries,290.83,0,18524.36,D
796,456,2021-04-24,UberEats,Expense,Leisure & Lifestyle,Takeaway,169.12,0,18355.24,D
795,456,2021-04-28,Apple Music,Expense,Leisure & Lifestyle,"Tv, Music & Streaming",368.41,0,17986.83,D
798,456,2021-05-01,Salary,Income,Income,Wages,0,8000,25986.83,C
810,456,2021-05-02,Tutoring Service,Expense,Personal,Education,312.61,0,25674.22,D
813,456,2021-05-03,Stock Purchase,Expense,Personal,Investments,238.63,0,25435.59,D
817,456,2021-05-05,Sydney Olympic Park,Expense,Transport,Parking,269.87,0,25165.72,D
814,456,2021-05-06,Baby Bunting,Expense,Personal,Children & Family,21.18,0,25144.54,D
802,456,2021-05-07,Car Loan Provider,Expense,Transport,Car Repayments,367.67,0,24776.87,D
808,456,2021-05-09,Domino's Online,Expense,Leisure & Lifestyle,Takeaway,204.72,0,24572.15,D
815,456,2021-05-09,DiDi,Expense,Transport,Taxies & Share Cars,430.37,0,24141.78,D
799,456,2021-05-11,Petbarn,Expense,Household,Pets,455.41,0,23686.37,D
806,456,2021-05-16,Hungry Jack's,Expense,Leisure & Lifestyle,Restaurants & Cafes,291.45,0,23394.92,D
816,456,2021-05-17,Stock Purchase,Income,Income,Investments,449.07,0,22945.85,D
809,456,2021-05-18,Tatts,Expense,Leisure & Lifestyle,Lottery & Gambling,120.0,0,22825.85,D
800,456,2021-05-20,Sports Equipment Store,Expense,Leisure & Lifestyle,Hobbies,105.44,0,22720.41,D
812,456,2021-05-20,Adelaide Metro,Expense,Transport,Public Transport,374.8,0,22345.61,D
805,456,2021-05-21,Stock Purchase,Expense,Personal,Investments,871.86,0,21473.75,D
801,456,2021-05-25,GoCatch,Expense,Transport,Taxies & Share Cars,158.47,0,21315.28,D
811,456,2021-05-25,Myki,Expense,Transport,Public Transport,430.57,0,20884.71,D
804,456,2021-05-26,Toyota Finance,Expense,Transport,Car Repayments,265.55,0,20619.16,D
803,456,2021-05-28,Local Pub,Expense,Leisure & Lifestyle,Pubs & Bars,358.05,0,20261.11,D
807,456,2021-05-28,Shell,Expense,Transport,Fuel,296.84,0,19964.27,D
818,456,2021-06-01,Salary,Income,Income,Wages,0,8000,27964.27,C
823,456,2021-06-05,Amaysim,Expense,Personal,Mobile Phone,457.11,0,27507.16,D
828,456,2021-06-05,Stock Purchase,Income,Income,Investments,877.2,0,26629.96,D
842,456,2021-06-07,Landlord,Expense,Household,Rent & Mortgage,454.69,0,26175.27,D
822,456,2021-06-09,Printing Service,Expense,Personal,Life Admin,367.58,0,25807.69,D
846,456,2021-06-09,Opal Card,Expense,Transport,Public Transport,324.29,0,25483.4,D
840,456,2021-06-10,Bunnings Warehouse,Expense,Household,Maintenance & Improvements,65.17,0,25418.23,D
841,456,2021-06-10,UberEats,Expense,Leisure & Lifestyle,Takeaway,213.13,0,25205.1,D
845,456,2021-06-11,Priceline Pharmacy,Expense,Personal,Health & Medical,276.28,0,24928.82,D
830,456,2021-06-13,Yoga Studio,Expense,Personal,Fitness & Wellbeing,131.95,0,24796.87,D
839,456,2021-06-13,Steam,Expense,Leisure & Lifestyle,"Apps, Games & Software",276.97,0,24519.9,D
834,456,2021-06-14,GoFundMe,Expense,Personal,Gifts & Donations,422.53,0,24097.37,D
826,456,2021-06-15,Aldi,Expense,Household,Groceries,172.49,0,23924.88,D
831,456,2021-06-18,PetSmart,Expense,Household,Pets,175.36,0,23749.52,D
832,456,2021-06-19,PetSmart,Expense,Household,Pets,419.53,0,23329.99,D
844,456,2021-06-19,Expedia,Expense,Leisure & Lifestyle,Holidays & Travel,53.74,0,23276.25,D
820,456,2021-06-20,Airbnb,Expense,Leisure & Lifestyle,Holidays & Travel,494.41,0,22781.84,D
838,456,2021-06-20,AGL,Expense,Household,Utilities,370.99,0,22410.85,D
833,456,2021-06-21,Apple Music,Expense,Leisure & Lifestyle,"Tv, Music & Streaming",499.72,0,21911.13,D
847,456,2021-06-21,Eventbrite,Expense,Leisure & Lifestyle,Events & Gigs,357.82,0,21553.31,D
836,456,2021-06-23,City of Melbourne,Expense,Transport,Parking,338.43,0,21214.88,D
824,456,2021-06-24,Shell,Expense,Transport,Fuel,238.96,0,20975.92,D
827,456,2021-06-24,Stock Purchase,Income,Income,Investments,180.29,0,20795.63,D
837,456,2021-06-24,The Iconic,Expense,Personal,Clothing & Accessories,324.2,0,20471.43,D
843,456,2021-06-25,Liquorland,Expense,Leisure & Lifestyle,Alcohol,37.27,0,20434.16,D
821,456,2021-06-26,Lawyer,Expense,Personal,Life Admin,182.42,0,20251.74,D
825,456,2021-06-26,IKEA,Expense,Household,Maintenance & Improvements,312.19,0,19939.55,D
835,456,2021-06-26,RACV,Expense,Transport,"Car Insurance, Rego & Maintenance",366.16,0,19573.39,D
829,456,2021-06-27,Stock Purchase,Income,Income,Investments,748.12,0,18825.27,D
819,456,2021-06-29,Hair Salon,Expense,Personal,Hair & Beauty,214.15,0,18611.12,D
848,456,2021-07-01,Salary,Income,Income,Wages,0,8000,26611.12,C
857,456,2021-07-02,Crown Casino,Expense,Leisure & Lifestyle,Lottery & Gambling,446.07,0,26165.05,D
866,456,2021-07-06,Stock Purchase,Income,Income,Investments,886.98,0,25278.07,D
852,456,2021-07-07,Apple Music,Expense,Leisure & Lifestyle,"Tv, Music & Streaming",313.9,0,24964.17,D
875,456,2021-07-07,Domino's Online,Expense,Leisure & Lifestyle,Takeaway,59.91,0,24904.26,D
856,456,2021-07-08,Toyota Finance,Expense,Transport,Car Repayments,132.76,0,24771.5,D
858,456,2021-07-08,Stock Purchase,Expense,Personal,Investments,976.95,0,23794.55,D
859,456,2021-07-08,Stock Purchase,Expense,Personal,Investments,166.81,0,23627.74,D
849,456,2021-07-10,PayPal,Transfer,Transfer,Transfer,253.17,0,23374.57,D
850,456,2021-07-10,Suncorp,Expense,Transport,"Car Insurance, Rego & Maintenance",256.94,0,23117.63,D
870,456,2021-07-10,Anytime Fitness,Expense,Personal,Fitness & Wellbeing,339.69,0,22777.94,D
853,456,2021-07-12,Sephora,Expense,Personal,Hair & Beauty,170.69,0,22607.25,D
869,456,2021-07-12,Stock Purchase,Expense,Personal,Investments,135.29,0,22471.96,D
864,456,2021-07-13,Moshtix,Expense,Leisure & Lifestyle,Events & Gigs,339.48,0,22132.48,D
871,456,2021-07-14,Linkt,Expense,Transport,Tolls,238.35,0,21894.13,D
865,456,2021-07-16,Greencross Vets,Expense,Household,Pets,115.28,0,21778.85,D
862,456,2021-07-17,Toys R Us,Expense,Personal,Children & Family,471.57,0,21307.28,D
854,456,2021-07-19,Toys R Us,Expense,Personal,Children & Family,291.98,0,21015.3,D
861,456,2021-07-19,Bicycle Network,Expense,Transport,Cycling,170.34,0,20844.96,D
867,456,2021-07-19,Bank Transfer,Transfer,Transfer,Transfer,410.1,0,20434.86,D
872,456,2021-07-19,Car Dealership,Expense,Transport,Car Repayments,339.74,0,20095.12,D
863,456,2021-07-20,Tobacco Store,Expense,Leisure & Lifestyle,Tobacco & Vaping,164.92,0,19930.2,D
855,456,2021-07-21,Baby Bunting,Expense,Personal,Children & Family,387.9,0,19542.3,D
851,456,2021-07-23,Sports Bar,Expense,Leisure & Lifestyle,Pubs & Bars,64.81,0,19477.49,D
874,456,2021-07-25,Ticketmaster,Expense,Leisure & Lifestyle,Events & Gigs,21.82,0,19455.67,D
873,456,2021-07-27,Toyota Finance,Expense,Transport,Car Repayments,352.11,0,19103.56,D
860,456,2021-07-28,Stock Purchase,Income,Income,Investments,911.06,0,18192.5,D
868,456,2021-07-29,Domino's Online,Expense,Leisure & Lifestyle,Takeaway,127.26,0,18065.24,D
876,456,2021-08-01,Salary,Income,Income,Wages,0,8000,26065.24,C
890,456,2021-08-04,Hungry Jack's,Expense,Leisure & Lifestyle,Restaurants & Cafes,240.05,0,25825.19,D
888,456,2021-08-05,Allianz,Expense,Household,Rates & Insurance,213.35,0,25611.84,D
887,456,2021-08-06,BWS,Expense,Leisure & Lifestyle,Alcohol,70.78,0,25541.06,D
883,456,2021-08-07,Ticketek,Expense,Leisure & Lifestyle,Events & Gigs,390.64,0,25150.42,D
881,456,2021-08-09,Online Course Provider,Expense,Personal,Education,390.78,0,24759.64,D
896,456,2021-08-09,Stock Purchase,Expense,Personal,Investments,784.31,0,23975.33,D
892,456,2021-08-10,Lowe's,Expense,Household,Maintenance & Improvements,81.45,0,23893.88,D
879,456,2021-08-13,NIB,Expense,Personal,Health & Medical,331.56,0,23562.32,D
885,456,2021-08-13,Music Store,Expense,Leisure & Lifestyle,Hobbies,442.53,0,23119.79,D
889,456,2021-08-13,Sportsbet,Expense,Leisure & Lifestyle,Lottery & Gambling,214.09,0,22905.7,D
880,456,2021-08-14,Deliveroo,Expense,Leisure & Lifestyle,Takeaway,367.25,0,22538.45,D
886,456,2021-08-14,Bunnings Warehouse,Expense,Household,Maintenance & Improvements,148.86,0,22389.59,D
894,456,2021-08-15,EnergyAustralia,Expense,Household,Utilities,490.41,0,21899.18,D
877,456,2021-08-17,Expedia,Expense,Leisure & Lifestyle,Holidays & Travel,90.78,0,21808.4,D
882,456,2021-08-18,Allianz,Expense,Transport,"Car Insurance, Rego & Maintenance",413.1,0,21395.3,D
878,456,2021-08-20,Origin Energy,Expense,Household,Utilities,459.69,0,20935.61,D
891,456,2021-08-23,Bank Transfer,Transfer,Transfer,Transfer,60.13,0,20875.48,D
893,456,2021-08-25,Vape Shop,Expense,Leisure & Lifestyle,Tobacco & Vaping,13.31,0,20862.17,D
884,456,2021-08-28,Local Pub,Expense,Leisure & Lifestyle,Pubs & Bars,190.26,0,20671.91,D
895,456,2021-08-28,Liquorland,Expense,Leisure & Lifestyle,Alcohol,253.9,0,20418.01,D
897,456,2021-09-01,Salary,Income,Income,Wages,0,8000,28418.01,C
898,456,2021-09-03,Wilson Parking,Expense,Transport,Parking,45.61,0,28372.4,D
913,456,2021-09-03,Nail Salon,Expense,Personal,Hair & Beauty,385.54,0,27986.86,D
908,456,2021-09-08,H&M,Expense,Personal,Clothing & Accessories,94.5,0,27892.36,D
900,456,2021-09-09,BWS,Expense,Leisure & Lifestyle,Alcohol,210.07,0,27682.29,D
912,456,2021-09-10,Aldi,Expense,Household,Groceries,308.02,0,27374.27,D
905,456,2021-09-14,Apple Music,Expense,Leisure & Lifestyle,"Tv, Music & Streaming",337.8,0,27036.47,D
906,456,2021-09-15,BP,Expense,Transport,Fuel,478.48,0,26557.99,D
903,456,2021-09-16,Booking.com,Expense,Leisure & Lifestyle,Holidays & Travel,376.52,0,26181.47,D
904,456,2021-09-16,Liquorland,Expense,Leisure & Lifestyle,Alcohol,195.64,0,25985.83,D
899,456,2021-09-19,Toyota Finance,Expense,Transport,Car Repayments,297.6,0,25688.23,D
910,456,2021-09-20,Uber,Expense,Transport,Taxies & Share Cars,209.55,0,25478.68,D
901,456,2021-09-21,Gym Membership,Expense,Personal,Fitness & Wellbeing,44.19,0,25434.49,D
902,456,2021-09-24,NRMA,Expense,Transport,"Car Insurance, Rego & Maintenance",95.03,0,25339.46,D
907,456,2021-09-25,Childcare Center,Expense,Personal,Children & Family,335.44,0,25004.02,D
911,456,2021-09-27,Stock Purchase,Income,Income,Investments,168.81,0,24835.21,D
909,456,2021-09-28,Bunnings Warehouse,Expense,Household,Maintenance & Improvements,252.41,0,24582.8,D
914,456,2021-10-01,Salary,Income,Income,Wages,0,8000,32582.8,C
931,456,2021-10-03,Rooftop Bar,Expense,Leisure & Lifestyle,Pubs & Bars,26.21,0,32556.59,D
937,456,2021-10-04,13cabs,Expense,Transport,Taxies & Share Cars,143.19,0,32413.4,D
932,456,2021-10-05,IKEA,Expense,Household,Maintenance & Improvements,34.09,0,32379.31,D
925,456,2021-10-07,Yoga Studio,Expense,Personal,Fitness & Wellbeing,230.45,0,32148.86,D
927,456,2021-10-07,E-Toll,Expense,Transport,Tolls,299.84,0,31849.02,D
915,456,2021-10-08,YouTube Premium,Expense,Leisure & Lifestyle,"Tv, Music & Streaming",284.91,0,31564.11,D
916,456,2021-10-09,Tobacco Store,Expense,Leisure & Lifestyle,Tobacco & Vaping,432.03,0,31132.08,D
941,456,2021-10-09,Car Dealership,Expense,Transport,Car Repayments,238.75,0,30893.33,D
930,456,2021-10-10,Hair Salon,Expense,Personal,Hair & Beauty,21.47,0,30871.86,D
935,456,2021-10-10,KFC,Expense,Leisure & Lifestyle,Restaurants & Cafes,377.86,0,30494.0,D
928,456,2021-10-11,E-Toll,Expense,Transport,Tolls,232.43,0,30261.57,D
929,456,2021-10-11,Domino's Pizza,Expense,Leisure & Lifestyle,Restaurants & Cafes,474.94,0,29786.63,D
923,456,2021-10-12,Home Depot,Expense,Household,Maintenance & Improvements,339.24,0,29447.39,D
933,456,2021-10-13,Bunnings Warehouse,Expense,Household,Maintenance & Improvements,492.99,0,28954.4,D
942,456,2021-10-13,Mortgage Lender,Expense,Household,Rent & Mortgage,492.79,0,28461.61,D
922,456,2021-10-15,Zara,Expense,Personal,Clothing & Accessories,261.13,0,28200.48,D
921,456,2021-10-16,Accountant,Expense,Personal,Life Admin,413.63,0,27786.85,D
934,456,2021-10-20,Petbarn,Expense,Household,Pets,311.78,0,27475.07,D
944,456,2021-10-20,TPG,Expense,Household,Internet,35.3,0,27439.77,D
938,456,2021-10-21,QBE,Expense,Transport,"Car Insurance, Rego & Maintenance",96.87,0,27342.9,D
917,456,2021-10-22,Vape Shop,Expense,Leisure & Lifestyle,Tobacco & Vaping,333.21,0,27009.69,D
920,456,2021-10-23,Adobe Creative Cloud,Expense,Leisure & Lifestyle,"Apps, Games & Software",12.4,0,26997.29,D
918,456,2021-10-25,Rooftop Bar,Expense,Leisure & Lifestyle,Pubs & Bars,400.82,0,26596.47,D
926,456,2021-10-26,Boost Mobile,Expense,Personal,Mobile Phone,322.16,0,26274.31,D
936,456,2021-10-26,Stock Purchase,Income,Income,Investments,903.05,0,25371.26,D
919,456,2021-10-27,Adelaide Metro,Expense,Transport,Public Transport,101.65,0,25269.61,D
943,456,2021-10-27,Coles,Expense,Household,Groceries,251.33,0,25018.28,D
940,456,2021-10-28,H&M,Expense,Personal,Clothing & Accessories,118.34,0,24899.94,D
924,456,2021-10-29,GoFundMe,Expense,Personal,Gifts & Donations,454.08,0,24445.86,D
939,456,2021-10-29,Adobe Creative Cloud,Expense,Leisure & Lifestyle,"Apps, Games & Software",214.37,0,24231.49,D
945,456,2021-11-01,Salary,Income,Income,Wages,0,8000,32231.49,C
948,456,2021-11-05,Local Pub,Expense,Leisure & Lifestyle,Pubs & Bars,150.93,0,32080.56,D
951,456,2021-11-05,IKEA,Expense,Household,Maintenance & Improvements,248.53,0,31832.03,D
946,456,2021-11-06,Costco,Expense,Household,Groceries,70.07,0,31761.96,D
947,456,2021-11-06,Stan,Expense,Leisure & Lifestyle,"Tv, Music & Streaming",131.82,0,31630.14,D
949,456,2021-11-06,Adobe Creative Cloud,Expense,Leisure & Lifestyle,"Apps, Games & Software",217.08,0,31413.06,D
950,456,2021-11-20,Bank Transfer,Transfer,Transfer,Transfer,430.22,0,30982.84,D
954,456,2021-11-20,Rooftop Bar,Expense,Leisure & Lifestyle,Pubs & Bars,331.11,0,30651.73,D
952,456,2021-11-29,Spotify,Expense,Leisure & Lifestyle,"Tv, Music & Streaming",233.71,0,30418.02,D
953,456,2021-11-29,RSPCA,Expense,Household,Pets,458.24,0,29959.78,D
955,456,2021-12-01,Salary,Income,Income,Wages,0,8000,37959.78,C
961,456,2021-12-03,Vodafone,Expense,Personal,Mobile Phone,43.01,0,37916.77,D
969,456,2021-12-03,Toyota Finance,Expense,Transport,Car Repayments,490.99,0,37425.78,D
958,456,2021-12-04,Toyota Finance,Expense,Transport,Car Repayments,276.54,0,37149.24,D
967,456,2021-12-06,Priceline Pharmacy,Expense,Personal,Health & Medical,409.3,0,36739.94,D
966,456,2021-12-07,Bank Transfer,Transfer,Transfer,Transfer,179.59,0,36560.35,D
965,456,2021-12-12,Mortgage Lender,Expense,Household,Rent & Mortgage,195.56,0,36364.79,D
963,456,2021-12-14,Cycling Apparel Store,Expense,Transport,Cycling,427.8,0,35936.99,D
971,456,2021-12-14,Stock Purchase,Expense,Personal,Investments,154.0,0,35782.99,D
973,456,2021-12-15,Charity Organization,Expense,Personal,Gifts & Donations,449.36,0,35333.63,D
956,456,2021-12-17,Bunnings Warehouse,Expense,Household,Maintenance & Improvements,242.77,0,35090.86,D
964,456,2021-12-19,Bank Transfer,Transfer,Transfer,Transfer,175.86,0,34915.0,D
960,456,2021-12-22,Flight Centre,Expense,Leisure & Lifestyle,Holidays & Travel,25.24,0,34889.76,D
968,456,2021-12-22,Car Dealership,Expense,Transport,Car Repayments,177.79,0,34711.97,D
957,456,2021-12-25,Anytime Fitness,Expense,Personal,Fitness & Wellbeing,189.83,0,34522.14,D
970,456,2021-12-25,RSPCA,Expense,Household,Pets,103.42,0,34418.72,D
962,456,2021-12-28,Childcare Center,Expense,Personal,Children & Family,477.47,0,33941.25,D
972,456,2021-12-28,UberEats,Expense,Leisure & Lifestyle,Takeaway,421.07,0,33520.18,D
959,456,2021-12-29,Opal Card,Expense,Transport,Public Transport,438.16,0,33082.02,D
974,456,2022-01-01,Salary,Income,Income,Wages,0,8000,41082.02,C
990,456,2022-01-05,Nail Salon,Expense,Personal,Hair & Beauty,151.08,0,40930.94,D
983,456,2022-01-07,Vodafone,Expense,Household,Internet,264.31,0,40666.63,D
981,456,2022-01-08,Domino's Online,Expense,Leisure & Lifestyle,Takeaway,441.19,0,40225.44,D
993,456,2022-01-09,Ticketek,Expense,Leisure & Lifestyle,Events & Gigs,250.78,0,39974.66,D
979,456,2022-01-13,Real Estate Agency,Expense,Household,Rent & Mortgage,377.07,0,39597.59,D
987,456,2022-01-13,NRMA,Expense,Transport,"Car Insurance, Rego & Maintenance",22.73,0,39574.86,D
980,456,2022-01-16,Stock Purchase,Income,Income,Investments,494.54,0,39080.32,D
992,456,2022-01-17,Flight Centre,Expense,Leisure & Lifestyle,Holidays & Travel,266.52,0,38813.8,D
976,456,2022-01-19,Bank Transfer,Transfer,Transfer,Transfer,98.75,0,38715.05,D
985,456,2022-01-22,Costco,Expense,Household,Groceries,110.79,0,38604.26,D
991,456,2022-01-22,Post Office,Expense,Personal,Life Admin,451.38,0,38152.88,D
982,456,2022-01-23,Sports Bar,Expense,Leisure & Lifestyle,Pubs & Bars,66.44,0,38086.44,D
986,456,2022-01-24,Art Supply Store,Expense,Leisure & Lifestyle,Hobbies,436.43,0,37650.01,D
988,456,2022-01-24,The Iconic,Expense,Personal,Clothing & Accessories,433.5,0,37216.51,D
977,456,2022-01-26,Anytime Fitness,Expense,Personal,Fitness & Wellbeing,208.08,0,37008.43,D
989,456,2022-01-26,Cigarettes,Expense,Leisure & Lifestyle,Tobacco & Vaping,67.04,0,36941.39,D
975,456,2022-01-27,Sports Equipment Store,Expense,Leisure & Lifestyle,Hobbies,164.57,0,36776.82,D
978,456,2022-01-28,Suncorp,Expense,Household,Rates & Insurance,314.93,0,36461.89,D
984,456,2022-01-28,Lowe's,Expense,Household,Maintenance & Improvements,92.47,0,36369.42,D
994,456,2022-02-01,Salary,Income,Income,Wages,0,8000,44369.42,C
996,456,2022-02-03,McDonald's,Expense,Leisure & Lifestyle,Restaurants & Cafes,68.09,0,44301.33,D
1015,456,2022-02-05,Ticketek,Expense,Leisure & Lifestyle,Events & Gigs,121.04,0,44180.29,D
1009,456,2022-02-07,Telstra,Expense,Personal,Mobile Phone,387.55,0,43792.74,D
1011,456,2022-02-07,Cigarettes,Expense,Leisure & Lifestyle,Tobacco & Vaping,254.13,0,43538.61,D
1012,456,2022-02-07,EnergyAustralia,Expense,Household,Utilities,275.44,0,43263.17,D
999,456,2022-02-08,Gym Membership,Expense,Personal,Fitness & Wellbeing,57.49,0,43205.68,D
1004,456,2022-02-08,Apple Music,Expense,Leisure & Lifestyle,"Tv, Music & Streaming",63.61,0,43142.07,D
1005,456,2022-02-11,RACV,Expense,Transport,"Car Insurance, Rego & Maintenance",355.26,0,42786.81,D
997,456,2022-02-12,CityLink,Expense,Transport,Tolls,48.87,0,42737.94,D
1003,456,2022-02-12,Stock Purchase,Income,Income,Investments,963.32,0,41774.62,D
1019,456,2022-02-13,Printing Service,Expense,Personal,Life Admin,332.37,0,41442.25,D
998,456,2022-02-15,Baby Bunting,Expense,Personal,Children & Family,355.16,0,41087.09,D
995,456,2022-02-16,United Petroleum,Expense,Transport,Fuel,282.9,0,40804.19,D
1008,456,2022-02-16,Dan Murphy's,Expense,Leisure & Lifestyle,Alcohol,374.01,0,40430.18,D
1016,456,2022-02-16,Tobacco Store,Expense,Leisure & Lifestyle,Tobacco & Vaping,404.11,0,40026.07,D
1000,456,2022-02-17,Qantas,Expense,Leisure & Lifestyle,Holidays & Travel,299.28,0,39726.79,D
1017,456,2022-02-17,Allianz,Expense,Household,Rates & Insurance,48.98,0,39677.81,D
1013,456,2022-02-18,IGA,Expense,Household,Groceries,244.28,0,39433.53,D
1002,456,2022-02-19,City of Melbourne,Expense,Transport,Parking,165.07,0,39268.46,D
1006,456,2022-02-19,Stock Purchase,Expense,Personal,Investments,515.2,0,38753.26,D
1018,456,2022-02-20,Anytime Fitness,Expense,Personal,Fitness & Wellbeing,172.16,0,38581.1,D
1014,456,2022-02-22,Toyota Finance,Expense,Transport,Car Repayments,426.87,0,38154.23,D
1007,456,2022-02-26,Netflix,Expense,Leisure & Lifestyle,"Tv, Music & Streaming",230.38,0,37923.85,D
1010,456,2022-02-26,EnergyAustralia,Expense,Household,Utilities,401.25,0,37522.6,D
1001,456,2022-02-27,Flight Centre,Expense,Leisure & Lifestyle,Holidays & Travel,400.05,0,37122.55,D
1020,456,2022-03-01,Salary,Income,Income,Wages,0,8000,45122.55,C
1021,456,2022-03-02,Vodafone,Expense,Personal,Mobile Phone,83.68,0,45038.87,D
1030,456,2022-03-03,Online Course Provider,Expense,Personal,Education,119.75,0,44919.12,D
1037,456,2022-03-03,DiDi,Expense,Transport,Taxies & Share Cars,350.76,0,44568.36,D
1034,456,2022-03-04,7-Eleven,Expense,Transport,Fuel,272.01,0,44296.35,D
1026,456,2022-03-08,Post Office,Expense,Personal,Life Admin,229.64,0,44066.71,D
1035,456,2022-03-09,Allianz,Expense,Household,Rates & Insurance,58.66,0,44008.05,D
1029,456,2022-03-10,QBE,Expense,Transport,"Car Insurance, Rego & Maintenance",491.12,0,43516.93,D
1036,456,2022-03-11,BP,Expense,Transport,Fuel,204.79,0,43312.14,D
1023,456,2022-03-14,TPG,Expense,Household,Internet,294.68,0,43017.46,D
1032,456,2022-03-16,NRMA,Expense,Household,Rates & Insurance,202.27,0,42815.19,D
1033,456,2022-03-17,Medibank,Expense,Personal,Health & Medical,280.39,0,42534.8,D
1028,456,2022-03-18,Childcare Center,Expense,Personal,Children & Family,13.12,0,42521.68,D
1022,456,2022-03-22,Baby Bunting,Expense,Personal,Children & Family,189.87,0,42331.81,D
1025,456,2022-03-22,DiDi,Expense,Transport,Taxies & Share Cars,77.73,0,42254.08,D
1027,456,2022-03-25,Coles,Expense,Household,Groceries,139.93,0,42114.15,D
1031,456,2022-03-26,Steam,Expense,Leisure & Lifestyle,"Apps, Games & Software",348.22,0,41765.93,D
1024,456,2022-03-29,Birthday Gift,Expense,Personal,Gifts & Donations,162.09,0,41603.84,D
1038,456,2022-04-01,Salary,Income,Income,Wages,0,8000,49603.84,C
1047,456,2022-04-02,Anytime Fitness,Expense,Personal,Fitness & Wellbeing,140.62,0,49463.22,D
1056,456,2022-04-02,Online Course Provider,Expense,Personal,Education,67.81,0,49395.41,D
1068,456,2022-04-02,The Lott,Expense,Leisure & Lifestyle,Lottery & Gambling,139.68,0,49255.73,D
1049,456,2022-04-03,Subway,Expense,Leisure & Lifestyle,Restaurants & Cafes,227.89,0,49027.84,D
1053,456,2022-04-03,Stock Purchase,Income,Income,Investments,389.94,0,48637.9,D
1064,456,2022-04-05,Childcare Center,Expense,Personal,Children & Family,200.44,0,48437.46,D
1041,456,2022-04-08,CityLink,Expense,Transport,Tolls,283.7,0,48153.76,D
1067,456,2022-04-08,Car Dealership,Expense,Transport,Car Repayments,145.63,0,48008.13,D
1051,456,2022-04-09,QBE,Expense,Household,Rates & Insurance,230.49,0,47777.64,D
1048,456,2022-04-10,Stock Purchase,Income,Income,Investments,430.27,0,47347.37,D
1052,456,2022-04-12,Opal Card,Expense,Transport,Public Transport,146.89,0,47200.48,D
1055,456,2022-04-13,City of Melbourne,Expense,Transport,Parking,362.9,0,46837.58,D
1058,456,2022-04-13,Stock Purchase,Expense,Personal,Investments,590.28,0,46247.3,D
1060,456,2022-04-13,Steam,Expense,Leisure & Lifestyle,"Apps, Games & Software",167.0,0,46080.3,D
1061,456,2022-04-16,Anytime Fitness,Expense,Personal,Fitness & Wellbeing,119.27,0,45961.03,D
1042,456,2022-04-17,BWS,Expense,Leisure & Lifestyle,Alcohol,249.16,0,45711.87,D
1046,456,2022-04-19,EastLink,Expense,Transport,Tolls,249.13,0,45462.74,D
1054,456,2022-04-19,Stock Purchase,Expense,Personal,Investments,453.55,0,45009.19,D
1045,456,2022-04-21,Sydney Olympic Park,Expense,Transport,Parking,201.3,0,44807.89,D
1063,456,2022-04-22,IGA,Expense,Household,Groceries,99.3,0,44708.59,D
1066,456,2022-04-22,The Iconic,Expense,Personal,Clothing & Accessories,355.22,0,44353.37,D
1057,456,2022-04-23,Bank Transfer,Transfer,Transfer,Transfer,74.23,0,44279.14,D
1050,456,2022-04-24,Tatts,Expense,Leisure & Lifestyle,Lottery & Gambling,337.94,0,43941.2,D
1040,456,2022-04-26,Birthday Gift,Expense,Personal,Gifts & Donations,239.17,0,43702.03,D
1044,456,2022-04-27,University,Expense,Personal,Education,23.79,0,43678.24,D
1065,456,2022-04-27,Mortgage Lender,Expense,Household,Rent & Mortgage,28.17,0,43650.07,D
1059,456,2022-04-28,Mortgage Lender,Expense,Household,Rent & Mortgage,493.03,0,43157.04,D
1039,456,2022-04-29,Amaysim,Expense,Personal,Mobile Phone,191.52,0,42965.52,D
1043,456,2022-04-29,Tobacco Store,Expense,Leisure & Lifestyle,Tobacco & Vaping,79.25,0,42886.27,D
1062,456,2022-04-29,Netflix,Expense,Leisure & Lifestyle,"Tv, Music & Streaming",214.59,0,42671.68,D
1069,456,2022-05-01,Salary,Income,Income,Wages,0,8000,50671.68,C
1071,456,2022-05-03,EnergyAustralia,Expense,Household,Utilities,127.22,0,50544.46,D
1078,456,2022-05-03,Home Depot,Expense,Household,Maintenance & Improvements,71.81,0,50472.65,D
1074,456,2022-05-04,Toyota Finance,Expense,Transport,Car Repayments,129.18,0,50343.47,D
1073,456,2022-05-08,Cigars,Expense,Leisure & Lifestyle,Tobacco & Vaping,185.31,0,50158.16,D
1076,456,2022-05-08,Fitness First,Expense,Personal,Fitness & Wellbeing,25.12,0,50133.04,D
1081,456,2022-05-12,IKEA,Expense,Household,Maintenance & Improvements,190.59,0,49942.45,D
1082,456,2022-05-16,Anytime Fitness,Expense,Personal,Fitness & Wellbeing,465.47,0,49476.98,D
1083,456,2022-05-16,Chemist Warehouse,Expense,Personal,Health & Medical,216.38,0,49260.6,D
1079,456,2022-05-17,Domino's Pizza,Expense,Leisure & Lifestyle,Restaurants & Cafes,307.33,0,48953.27,D
1077,456,2022-05-18,Vodafone,Expense,Personal,Mobile Phone,453.33,0,48499.94,D
1075,456,2022-05-22,Bunnings Warehouse,Expense,Household,Maintenance & Improvements,37.72,0,48462.22,D
1080,456,2022-05-26,Stock Purchase,Income,Income,Investments,158.61,0,48303.61,D
1072,456,2022-05-28,Nail Salon,Expense,Personal,Hair & Beauty,398.37,0,47905.24,D
1070,456,2022-05-29,Mecca,Expense,Personal,Hair & Beauty,230.5,0,47674.74,D
1084,456,2022-06-01,Salary,Income,Income,Wages,0,8000,55674.74,C
1087,456,2022-06-03,AGL,Expense,Household,Utilities,114.51,0,55560.23,D
1090,456,2022-06-03,Fitness First,Expense,Personal,Fitness & Wellbeing,63.32,0,55496.91,D
1096,456,2022-06-04,Crown Casino,Expense,Leisure & Lifestyle,Lottery & Gambling,96.44,0,55400.47,D
1098,456,2022-06-04,Mortgage Lender,Expense,Household,Rent & Mortgage,177.63,0,55222.84,D
1088,456,2022-06-07,University,Expense,Personal,Education,134.88,0,55087.96,D
1091,456,2022-06-09,TPG,Expense,Household,Internet,196.91,0,54891.05,D
1089,456,2022-06-10,CityLink,Expense,Transport,Tolls,277.56,0,54613.49,D
1097,456,2022-06-10,McDonald's,Expense,Leisure & Lifestyle,Restaurants & Cafes,488.43,0,54125.06,D
1094,456,2022-06-12,Origin Energy,Expense,Household,Utilities,169.85,0,53955.21,D
1095,456,2022-06-16,RACV,Expense,Transport,"Car Insurance, Rego & Maintenance",288.57,0,53666.64,D
1085,456,2022-06-18,Coles,Expense,Household,Groceries,67.76,0,53598.88,D
1086,456,2022-06-20,Vape Shop,Expense,Leisure & Lifestyle,Tobacco & Vaping,223.65,0,53375.23,D
1093,456,2022-06-21,Amaysim,Expense,Personal,Mobile Phone,341.17,0,53034.06,D
1092,456,2022-06-23,Secure Parking,Expense,Transport,Parking,24.64,0,53009.42,D
1099,456,2022-07-01,Salary,Income,Income,Wages,0,8000,61009.42,C
1104,456,2022-07-02,Petbarn,Expense,Household,Pets,103.32,0,60906.1,D
1124,456,2022-07-03,University,Expense,Personal,Education,84.78,0,60821.32,D
1103,456,2022-07-04,Telstra,Expense,Personal,Mobile Phone,367.37,0,60453.95,D
1120,456,2022-07-04,Steam,Expense,Leisure & Lifestyle,"Apps, Games & Software",466.86,0,59987.09,D
1113,456,2022-07-07,Greencross Vets,Expense,Household,Pets,25.91,0,59961.18,D
1105,456,2022-07-09,Birthday Gift,Expense,Personal,Gifts & Donations,477.34,0,59483.84,D
1111,456,2022-07-09,Sydney Water,Expense,Household,Utilities,445.09,0,59038.75,D
1128,456,2022-07-09,Anytime Fitness,Expense,Personal,Fitness & Wellbeing,138.42,0,58900.33,D
1122,456,2022-07-10,Ticketek,Expense,Leisure & Lifestyle,Events & Gigs,232.98,0,58667.35,D
1125,456,2022-07-10,Coles,Expense,Household,Groceries,173.7,0,58493.65,D
1109,456,2022-07-11,IGA,Expense,Household,Groceries,122.62,0,58371.03,D
1115,456,2022-07-12,Bupa,Expense,Personal,Health & Medical,82.75,0,58288.28,D
1119,456,2022-07-12,Moshtix,Expense,Leisure & Lifestyle,Events & Gigs,445.99,0,57842.29,D
1108,456,2022-07-15,Moshtix,Expense,Leisure & Lifestyle,Events & Gigs,285.46,0,57556.83,D
1117,456,2022-07-15,Netflix,Expense,Leisure & Lifestyle,"Tv, Music & Streaming",118.55,0,57438.28,D
1102,456,2022-07-16,BP,Expense,Transport,Fuel,99.66,0,57338.62,D
1121,456,2022-07-16,Stock Purchase,Expense,Personal,Investments,422.76,0,56915.86,D
1123,456,2022-07-16,Post Office,Expense,Personal,Life Admin,51.74,0,56864.12,D
1114,456,2022-07-17,Bank Transfer,Transfer,Transfer,Transfer,413.68,0,56450.44,D
1129,456,2022-07-17,Shell,Expense,Transport,Fuel,450.12,0,56000.32,D
1127,456,2022-07-18,Uber,Expense,Transport,Taxies & Share Cars,452.63,0,55547.69,D
1100,456,2022-07-20,RACV,Expense,Household,Rates & Insurance,448.98,0,55098.71,D
1116,456,2022-07-21,Online Course Provider,Expense,Personal,Education,382.31,0,54716.4,D
1118,456,2022-07-24,Caltex,Expense,Transport,Fuel,271.44,0,54444.96,D
1112,456,2022-07-26,Stock Purchase,Expense,Personal,Investments,111.29,0,54333.67,D
1126,456,2022-07-26,Anytime Fitness,Expense,Personal,Fitness & Wellbeing,273.06,0,54060.61,D
1101,456,2022-07-27,Sydney Olympic Park,Expense,Transport,Parking,456.06,0,53604.55,D
1106,456,2022-07-28,Car Loan Provider,Expense,Transport,Car Repayments,127.85,0,53476.7,D
1107,456,2022-07-28,RACV,Expense,Transport,"Car Insurance, Rego & Maintenance",54.34,0,53422.36,D
1110,456,2022-07-28,Post Office,Expense,Personal,Life Admin,210.67,0,53211.69,D
1130,456,2022-08-01,Salary,Income,Income,Wages,0,8000,61211.69,C
1136,456,2022-08-04,City of Melbourne,Expense,Transport,Parking,175.98,0,61035.71,D
1139,456,2022-08-04,Lawyer,Expense,Personal,Life Admin,398.6,0,60637.11,D
1132,456,2022-08-05,Venmo,Transfer,Transfer,Transfer,126.23,0,60510.88,D
1138,456,2022-08-05,Toys R Us,Expense,Personal,Children & Family,317.35,0,60193.53,D
1140,456,2022-08-11,BP,Expense,Transport,Fuel,481.23,0,59712.3,D
1135,456,2022-08-13,Optus,Expense,Personal,Mobile Phone,116.76,0,59595.54,D
1137,456,2022-08-13,Zara,Expense,Personal,Clothing & Accessories,264.04,0,59331.5,D
1142,456,2022-08-13,Stock Purchase,Income,Income,Investments,876.39,0,58455.11,D
1141,456,2022-08-20,Online Course Provider,Expense,Personal,Education,237.16,0,58217.95,D
1131,456,2022-08-22,Rooftop Bar,Expense,Leisure & Lifestyle,Pubs & Bars,451.25,0,57766.7,D
1134,456,2022-08-27,Cigarettes,Expense,Leisure & Lifestyle,Tobacco & Vaping,328.37,0,57438.33,D
1133,456,2022-08-29,BP,Expense,Transport,Fuel,148.27,0,57290.06,D
1143,456,2022-09-01,Salary,Income,Income,Wages,0,8000,65290.06,C
1149,456,2022-09-05,TAB,Expense,Leisure & Lifestyle,Lottery & Gambling,126.31,0,65163.75,D
1144,456,2022-09-13,Chemist Warehouse,Expense,Personal,Health & Medical,14.22,0,65149.53,D
1152,456,2022-09-14,Stock Purchase,Expense,Personal,Investments,599.37,0,64550.16,D
1154,456,2022-09-14,MAC Cosmetics,Expense,Personal,Hair & Beauty,338.55,0,64211.61,D
1151,456,2022-09-17,BWS,Expense,Leisure & Lifestyle,Alcohol,143.15,0,64068.46,D
1146,456,2022-09-18,Myki,Expense,Transport,Public Transport,35.34,0,64033.12,D
1155,456,2022-09-19,Hair Salon,Expense,Personal,Hair & Beauty,251.81,0,63781.31,D
1148,456,2022-09-20,Petbarn,Expense,Household,Pets,234.77,0,63546.54,D
1150,456,2022-09-21,Vape Shop,Expense,Leisure & Lifestyle,Tobacco & Vaping,429.31,0,63117.23,D
1153,456,2022-09-23,Wilson Parking,Expense,Transport,Parking,359.62,0,62757.61,D
1145,456,2022-09-24,Hobby Store,Expense,Leisure & Lifestyle,Hobbies,13.12,0,62744.49,D
1147,456,2022-09-28,Steam,Expense,Leisure & Lifestyle,"Apps, Games & Software",255.23,0,62489.26,D
1156,456,2022-10-01,Salary,Income,Income,Wages,0,8000,70489.26,C
1168,456,2022-10-02,Charity Organization,Expense,Personal,Gifts & Donations,32.01,0,70457.25,D
1158,456,2022-10-08,EnergyAustralia,Expense,Household,Utilities,333.36,0,70123.89,D
1163,456,2022-10-08,BWS,Expense,Leisure & Lifestyle,Alcohol,143.77,0,69980.12,D
1166,456,2022-10-08,Accountant,Expense,Personal,Life Admin,330.68,0,69649.44,D
1160,456,2022-10-10,Lawyer,Expense,Personal,Life Admin,448.16,0,69201.28,D
1161,456,2022-10-10,UberEats,Expense,Leisure & Lifestyle,Takeaway,207.9,0,68993.38,D
1162,456,2022-10-10,Domino's Pizza,Expense,Leisure & Lifestyle,Restaurants & Cafes,475.57,0,68517.81,D
1170,456,2022-10-10,Bike Shop,Expense,Transport,Cycling,169.37,0,68348.44,D
1167,456,2022-10-11,Cocktail Bar,Expense,Leisure & Lifestyle,Pubs & Bars,434.29,0,67914.15,D
1174,456,2022-10-15,Cocktail Bar,Expense,Leisure & Lifestyle,Pubs & Bars,366.01,0,67548.14,D
1165,456,2022-10-17,QBE,Expense,Transport,"Car Insurance, Rego & Maintenance",278.62,0,67269.52,D
1169,456,2022-10-17,Birthday Gift,Expense,Personal,Gifts & Donations,355.02,0,66914.5,D
1173,456,2022-10-17,Stock Purchase,Income,Income,Investments,242.22,0,66672.28,D
1159,456,2022-10-19,AGL,Expense,Household,Utilities,491.03,0,66181.25,D
1157,456,2022-10-20,Bicycle Network,Expense,Transport,Cycling,203.2,0,65978.05,D
1172,456,2022-10-25,Google Play Store,Expense,Leisure & Lifestyle,"Apps, Games & Software",291.45,0,65686.6,D
1164,456,2022-10-29,Hungry Jack's,Expense,Leisure & Lifestyle,Restaurants & Cafes,104.55,0,65582.05,D
1171,456,2022-10-29,Adobe Creative Cloud,Expense,Leisure & Lifestyle,"Apps, Games & Software",97.83,0,65484.22,D
1175,456,2022-11-01,Salary,Income,Income,Wages,0,8000,73484.22,C
1185,456,2022-11-04,Cotton On,Expense,Personal,Clothing & Accessories,416.39,0,73067.83,D
1181,456,2022-11-06,PetSmart,Expense,Household,Pets,10.67,0,73057.16,D
1177,456,2022-11-09,Bunnings Warehouse,Expense,Household,Maintenance & Improvements,258.37,0,72798.79,D
1180,456,2022-11-11,IKEA,Expense,Household,Maintenance & Improvements,95.64,0,72703.15,D
1178,456,2022-11-13,Bicycle Network,Expense,Transport,Cycling,255.76,0,72447.39,D
1184,456,2022-11-14,Medibank,Expense,Personal,Health & Medical,32.62,0,72414.77,D
1183,456,2022-11-17,Steam,Expense,Leisure & Lifestyle,"Apps, Games & Software",199.03,0,72215.74,D
1176,456,2022-11-18,PetSmart,Expense,Household,Pets,74.73,0,72141.01,D
1186,456,2022-11-19,Art Supply Store,Expense,Leisure & Lifestyle,Hobbies,129.37,0,72011.64,D
1179,456,2022-11-25,Nail Salon,Expense,Personal,Hair & Beauty,430.21,0,71581.43,D
1182,456,2022-11-27,Stock Purchase,Expense,Personal,Investments,723.41,0,70858.02,D
1187,456,2022-12-01,Salary,Income,Income,Wages,0,8000,78858.02,C
1200,456,2022-12-04,Cycling Apparel Store,Expense,Transport,Cycling,466.38,0,78391.64,D
1192,456,2022-12-07,Telstra,Expense,Personal,Mobile Phone,358.3,0,78033.34,D
1197,456,2022-12-07,Toyota Finance,Expense,Transport,Car Repayments,386.02,0,77647.32,D
1199,456,2022-12-08,Anytime Fitness,Expense,Personal,Fitness & Wellbeing,22.75,0,77624.57,D
1188,456,2022-12-09,Stock Purchase,Income,Income,Investments,161.28,0,77463.29,D
1189,456,2022-12-10,Nail Salon,Expense,Personal,Hair & Beauty,266.1,0,77197.19,D
1203,456,2022-12-10,NRMA,Expense,Transport,"Car Insurance, Rego & Maintenance",30.04,0,77167.15,D
1196,456,2022-12-12,Uniqlo,Expense,Personal,Clothing & Accessories,274.49,0,76892.66,D
1195,456,2022-12-15,Sportsbet,Expense,Leisure & Lifestyle,Lottery & Gambling,166.24,0,76726.42,D
1191,456,2022-12-16,Bunnings Warehouse,Expense,Household,Maintenance & Improvements,36.06,0,76690.36,D
1198,456,2022-12-16,Sports Equipment Store,Expense,Leisure & Lifestyle,Hobbies,258.55,0,76431.81,D
1201,456,2022-12-16,Lawyer,Expense,Personal,Life Admin,115.92,0,76315.89,D
1202,456,2022-12-16,Google Play Store,Expense,Leisure & Lifestyle,"Apps, Games & Software",42.74,0,76273.15,D
1193,456,2022-12-18,CityLink,Expense,Transport,Tolls,281.09,0,75992.06,D
1190,456,2022-12-28,Secure Parking,Expense,Transport,Parking,110.33,0,75881.73,D
1194,456,2022-12-28,NRMA,Expense,Household,Rates & Insurance,419.08,0,75462.65,D
1204,456,2022-12-28,Opal Card,Expense,Transport,Public Transport,122.25,0,75340.4,D
1205,456,2023-01-01,Salary,Income,Income,Wages,0,8000,83340.4,C
1206,456,2023-01-02,PayPal,Transfer,Transfer,Transfer,305.68,0,83034.72,D
1216,456,2023-01-05,UberEats,Expense,Leisure & Lifestyle,Takeaway,102.46,0,82932.26,D
1230,456,2023-01-06,H&M,Expense,Personal,Clothing & Accessories,139.66,0,82792.6,D
1231,456,2023-01-06,Yoga Studio,Expense,Personal,Fitness & Wellbeing,269.82,0,82522.78,D
1213,456,2023-01-07,RSPCA,Expense,Household,Pets,36.99,0,82485.79,D
1218,456,2023-01-07,Greencross Vets,Expense,Household,Pets,224.67,0,82261.12,D
1209,456,2023-01-08,Subway,Expense,Leisure & Lifestyle,Restaurants & Cafes,387.55,0,81873.57,D
1229,456,2023-01-08,Priceline Pharmacy,Expense,Personal,Health & Medical,483.27,0,81390.3,D
1208,456,2023-01-11,Birthday Gift,Expense,Personal,Gifts & Donations,219.04,0,81171.26,D
1212,456,2023-01-12,DoorDash,Expense,Leisure & Lifestyle,Takeaway,240.72,0,80930.54,D
1220,456,2023-01-12,GoFundMe,Expense,Personal,Gifts & Donations,28.08,0,80902.46,D
1214,456,2023-01-14,QBE,Expense,Transport,"Car Insurance, Rego & Maintenance",27.31,0,80875.15,D
1224,456,2023-01-14,TAB,Expense,Leisure & Lifestyle,Lottery & Gambling,130.04,0,80745.11,D
1227,456,2023-01-14,UberEats,Expense,Leisure & Lifestyle,Takeaway,475.72,0,80269.39,D
1221,456,2023-01-19,The Iconic,Expense,Personal,Clothing & Accessories,226.75,0,80042.64,D
1210,456,2023-01-21,TransLink,Expense,Transport,Public Transport,208.14,0,79834.5,D
1228,456,2023-01-22,Secure Parking,Expense,Transport,Parking,86.86,0,79747.64,D
1226,456,2023-01-23,EnergyAustralia,Expense,Household,Utilities,188.05,0,79559.59,D
1222,456,2023-01-24,EnergyAustralia,Expense,Household,Utilities,322.18,0,79237.41,D
1215,456,2023-01-25,BP,Expense,Transport,Fuel,478.67,0,78758.74,D
1211,456,2023-01-26,Lawyer,Expense,Personal,Life Admin,368.37,0,78390.37,D
1225,456,2023-01-26,Petbarn,Expense,Household,Pets,355.92,0,78034.45,D
1207,456,2023-01-28,Ola,Expense,Transport,Taxies & Share Cars,26.63,0,78007.82,D
1217,456,2023-01-28,Cigarettes,Expense,Leisure & Lifestyle,Tobacco & Vaping,31.96,0,77975.86,D
1223,456,2023-01-28,Telstra,Expense,Household,Internet,99.46,0,77876.4,D
1219,456,2023-01-29,Sephora,Expense,Personal,Hair & Beauty,459.73,0,77416.67,D
1232,456,2023-02-01,Salary,Income,Income,Wages,0,8000,85416.67,C
1242,456,2023-02-04,E-Toll,Expense,Transport,Tolls,158.58,0,85258.09,D
1246,456,2023-02-05,7-Eleven,Expense,Transport,Fuel,234.32,0,85023.77,D
1240,456,2023-02-08,Telstra,Expense,Household,Internet,247.07,0,84776.7,D
1235,456,2023-02-11,CityLink,Expense,Transport,Tolls,434.51,0,84342.19,D
1244,456,2023-02-11,Bike Shop,Expense,Transport,Cycling,14.11,0,84328.08,D
1234,456,2023-02-12,Cycling Apparel Store,Expense,Transport,Cycling,136.88,0,84191.2,D
1241,456,2023-02-12,13cabs,Expense,Transport,Taxies & Share Cars,370.79,0,83820.41,D
1245,456,2023-02-14,Suncorp,Expense,Transport,"Car Insurance, Rego & Maintenance",255.93,0,83564.48,D
1238,456,2023-02-15,Medibank,Expense,Personal,Health & Medical,359.14,0,83205.34,D
1239,456,2023-02-18,Nail Salon,Expense,Personal,Hair & Beauty,135.51,0,83069.83,D
1237,456,2023-02-19,Charity Organization,Expense,Personal,Gifts & Donations,162.64,0,82907.19,D
1249,456,2023-02-19,BP,Expense,Transport,Fuel,341.05,0,82566.14,D
1248,456,2023-02-21,Petbarn,Expense,Household,Pets,355.63,0,82210.51,D
1236,456,2023-02-23,PetSmart,Expense,Household,Pets,417.31,0,81793.2,D
1233,456,2023-02-24,Myki,Expense,Transport,Public Transport,341.23,0,81451.97,D
1243,456,2023-02-27,Secure Parking,Expense,Transport,Parking,25.38,0,81426.59,D
1247,456,2023-03-01,Local Pub,Expense,Leisure & Lifestyle,Pubs & Bars,352.01,0,81074.58,D
1250,456,2023-03-01,Salary,Income,Income,Wages,0,8000,89074.58,C
1255,456,2023-03-02,Local Pub,Expense,Leisure & Lifestyle,Pubs & Bars,95.83,0,88978.75,D
1265,456,2023-03-02,Amaysim,Expense,Personal,Mobile Phone,298.98,0,88679.77,D
1260,456,2023-03-03,Subway,Expense,Leisure & Lifestyle,Restaurants & Cafes,65.87,0,88613.9,D
1270,456,2023-03-03,Greencross Vets,Expense,Household,Pets,187.07,0,88426.83,D
1252,456,2023-03-04,Hobby Store,Expense,Leisure & Lifestyle,Hobbies,466.45,0,87960.38,D
1251,456,2023-03-06,Car Loan Provider,Expense,Transport,Car Repayments,191.98,0,87768.4,D
1256,456,2023-03-06,Tutoring Service,Expense,Personal,Education,222.99,0,87545.41,D
1259,456,2023-03-06,Printing Service,Expense,Personal,Life Admin,74.2,0,87471.21,D
1271,456,2023-03-07,Petbarn,Expense,Household,Pets,418.72,0,87052.49,D
1262,456,2023-03-11,DoorDash,Expense,Leisure & Lifestyle,Takeaway,11.15,0,87041.34,D
1266,456,2023-03-12,Shell,Expense,Transport,Fuel,300.42,0,86740.92,D
1257,456,2023-03-14,Venmo,Transfer,Transfer,Transfer,249.46,0,86491.46,D
1261,456,2023-03-14,Stock Purchase,Expense,Personal,Investments,942.1,0,85549.36,D
1268,456,2023-03-14,Costco,Expense,Household,Groceries,318.32,0,85231.04,D
1263,456,2023-03-18,Venmo,Transfer,Transfer,Transfer,277.7,0,84953.34,D
1253,456,2023-03-19,YouTube Premium,Expense,Leisure & Lifestyle,"Tv, Music & Streaming",412.13,0,84541.21,D
1272,456,2023-03-19,Ticketek,Expense,Leisure & Lifestyle,Events & Gigs,420.59,0,84120.62,D
1267,456,2023-03-20,Tobacco Store,Expense,Leisure & Lifestyle,Tobacco & Vaping,429.88,0,83690.74,D
1254,456,2023-03-27,IGA,Expense,Household,Groceries,286.83,0,83403.91,D
1258,456,2023-03-28,Printing Service,Expense,Personal,Life Admin,193.13,0,83210.78,D
1264,456,2023-03-28,TAB,Expense,Leisure & Lifestyle,Lottery & Gambling,403.01,0,82807.77,D
1269,456,2023-03-29,Stock Purchase,Income,Income,Investments,843.07,0,81964.7,D
1273,456,2023-04-01,Salary,Income,Income,Wages,0,8000,89964.7,C
1280,456,2023-04-02,Secure Parking,Expense,Transport,Parking,288.14,0,89676.56,D
1288,456,2023-04-02,NRMA,Expense,Household,Rates & Insurance,389.53,0,89287.03,D
1289,456,2023-04-04,TPG,Expense,Household,Internet,254.9,0,89032.13,D
1281,456,2023-04-05,Cocktail Bar,Expense,Leisure & Lifestyle,Pubs & Bars,230.19,0,88801.94,D
1286,456,2023-04-05,Eventbrite,Expense,Leisure & Lifestyle,Events & Gigs,442.16,0,88359.78,D
1287,456,2023-04-05,PayPal,Transfer,Transfer,Transfer,491.05,0,87868.73,D
1291,456,2023-04-05,Bicycle Network,Expense,Transport,Cycling,448.36,0,87420.37,D
1294,456,2023-04-06,Ticketmaster,Expense,Leisure & Lifestyle,Events & Gigs,54.81,0,87365.56,D
1278,456,2023-04-08,Tutoring Service,Expense,Personal,Education,184.84,0,87180.72,D
1292,456,2023-04-09,Caltex,Expense,Transport,Fuel,313.32,0,86867.4,D
1283,456,2023-04-10,Airbnb,Expense,Leisure & Lifestyle,Holidays & Travel,380.08,0,86487.32,D
1275,456,2023-04-14,First Choice Liquor,Expense,Leisure & Lifestyle,Alcohol,411.98,0,86075.34,D
1282,456,2023-04-14,QBE,Expense,Transport,"Car Insurance, Rego & Maintenance",498.37,0,85576.97,D
1285,456,2023-04-14,Real Estate Agency,Expense,Household,Rent & Mortgage,96.34,0,85480.63,D
1295,456,2023-04-17,Vodafone,Expense,Personal,Mobile Phone,464.14,0,85016.49,D
1284,456,2023-04-18,Eventbrite,Expense,Leisure & Lifestyle,Events & Gigs,55.82,0,84960.67,D
1290,456,2023-04-23,Lawyer,Expense,Personal,Life Admin,427.8,0,84532.87,D
1293,456,2023-04-25,CityLink,Expense,Transport,Tolls,91.45,0,84441.42,D
1296,456,2023-04-25,Car Loan Provider,Expense,Transport,Car Repayments,424.55,0,84016.87,D
1297,456,2023-04-25,Car Loan Provider,Expense,Transport,Car Repayments,52.88,0,83963.99,D
1276,456,2023-04-27,Telstra,Expense,Personal,Mobile Phone,64.68,0,83899.31,D
1274,456,2023-04-28,Bupa,Expense,Personal,Health & Medical,388.68,0,83510.63,D
1277,456,2023-04-28,Sports Equipment Store,Expense,Leisure & Lifestyle,Hobbies,247.8,0,83262.83,D
1279,456,2023-04-28,Origin Energy,Expense,Household,Utilities,335.42,0,82927.41,D
1298,456,2023-05-01,Salary,Income,Income,Wages,0,8000,90927.41,C
1319,456,2023-05-03,Steam,Expense,Leisure & Lifestyle,"Apps, Games & Software",327.62,0,90599.79,D
1311,456,2023-05-04,Lowe's,Expense,Household,Maintenance & Improvements,114.63,0,90485.16,D
1317,456,2023-05-05,PayPal,Transfer,Transfer,Transfer,160.22,0,90324.94,D
1308,456,2023-05-06,Origin Energy,Expense,Household,Utilities,190.52,0,90134.42,D
1314,456,2023-05-07,RSPCA,Expense,Household,Pets,328.01,0,89806.41,D
1320,456,2023-05-07,Suncorp,Expense,Transport,"Car Insurance, Rego & Maintenance",182.66,0,89623.75,D
1302,456,2023-05-09,Toys R Us,Expense,Personal,Children & Family,370.16,0,89253.59,D
1318,456,2023-05-10,Myki,Expense,Transport,Public Transport,28.93,0,89224.66,D
1316,456,2023-05-11,Stock Purchase,Expense,Personal,Investments,817.62,0,88407.04,D
1312,456,2023-05-13,Telstra,Expense,Personal,Mobile Phone,128.8,0,88278.24,D
1300,456,2023-05-17,University,Expense,Personal,Education,217.29,0,88060.95,D
1306,456,2023-05-18,QBE,Expense,Transport,"Car Insurance, Rego & Maintenance",383.91,0,87677.04,D
1299,456,2023-05-19,KFC,Expense,Leisure & Lifestyle,Restaurants & Cafes,187.54,0,87489.5,D
1301,456,2023-05-19,Stock Purchase,Income,Income,Investments,697.54,0,86791.96,D
1304,456,2023-05-20,PetSmart,Expense,Household,Pets,200.33,0,86591.63,D
1315,456,2023-05-20,YouTube Premium,Expense,Leisure & Lifestyle,"Tv, Music & Streaming",112.99,0,86478.64,D
1310,456,2023-05-21,Ticketek,Expense,Leisure & Lifestyle,Events & Gigs,386.61,0,86092.03,D
1313,456,2023-05-23,Yoga Studio,Expense,Personal,Fitness & Wellbeing,171.44,0,85920.59,D
1305,456,2023-05-24,Printing Service,Expense,Personal,Life Admin,79.94,0,85840.65,D
1309,456,2023-05-24,Domino's Pizza,Expense,Leisure & Lifestyle,Restaurants & Cafes,361.63,0,85479.02,D
1303,456,2023-05-28,Cycling Apparel Store,Expense,Transport,Cycling,263.55,0,85215.47,D
1307,456,2023-05-28,Amaysim,Expense,Personal,Mobile Phone,144.35,0,85071.12,D
1321,456,2023-06-01,Salary,Income,Income,Wages,0,8000,93071.12,C
1330,456,2023-06-04,TPG,Expense,Household,Internet,104.62,0,92966.5,D
1328,456,2023-06-12,Nail Salon,Expense,Personal,Hair & Beauty,460.6,0,92505.9,D
1329,456,2023-06-16,RACV,Expense,Household,Rates & Insurance,206.84,0,92299.06,D
1326,456,2023-06-17,Telstra,Expense,Household,Internet,115.19,0,92183.87,D
1324,456,2023-06-19,Hobby Store,Expense,Leisure & Lifestyle,Hobbies,453.04,0,91730.83,D
1322,456,2023-06-21,Stock Purchase,Expense,Personal,Investments,131.56,0,91599.27,D
1323,456,2023-06-24,Ticketmaster,Expense,Leisure & Lifestyle,Events & Gigs,163.87,0,91435.4,D
1325,456,2023-06-26,Ola,Expense,Transport,Taxies & Share Cars,101.86,0,91333.54,D
1327,456,2023-06-27,Costco,Expense,Household,Groceries,487.12,0,90846.42,D
1331,456,2023-07-01,Salary,Income,Income,Wages,0,8000,98846.42,C
1333,456,2023-07-02,Gym Membership,Expense,Personal,Fitness & Wellbeing,214.49,0,98631.93,D
1352,456,2023-07-04,Petbarn,Expense,Household,Pets,446.53,0,98185.4,D
1354,456,2023-07-05,Sportsbet,Expense,Leisure & Lifestyle,Lottery & Gambling,110.04,0,98075.36,D
1351,456,2023-07-07,Opal Card,Expense,Transport,Public Transport,226.5,0,97848.86,D
1336,456,2023-07-08,Booking.com,Expense,Leisure & Lifestyle,Holidays & Travel,82.63,0,97766.23,D
1335,456,2023-07-09,Art Supply Store,Expense,Leisure & Lifestyle,Hobbies,21.81,0,97744.42,D
1339,456,2023-07-09,Liquorland,Expense,Leisure & Lifestyle,Alcohol,165.23,0,97579.19,D
1353,456,2023-07-10,Post Office,Expense,Personal,Life Admin,168.56,0,97410.63,D
1355,456,2023-07-13,Vape Shop,Expense,Leisure & Lifestyle,Tobacco & Vaping,263.16,0,97147.47,D
1349,456,2023-07-14,Telstra,Expense,Personal,Mobile Phone,343.82,0,96803.65,D
1340,456,2023-07-15,EastLink,Expense,Transport,Tolls,133.57,0,96670.08,D
1344,456,2023-07-15,Domino's Pizza,Expense,Leisure & Lifestyle,Restaurants & Cafes,324.25,0,96345.83,D
1345,456,2023-07-15,Greencross Vets,Expense,Household,Pets,88.54,0,96257.29,D
1347,456,2023-07-17,Suncorp,Expense,Transport,"Car Insurance, Rego & Maintenance",341.95,0,95915.34,D
1337,456,2023-07-18,Vape Shop,Expense,Leisure & Lifestyle,Tobacco & Vaping,357.09,0,95558.25,D
1348,456,2023-07-18,Sydney Olympic Park,Expense,Transport,Parking,437.96,0,95120.29,D
1342,456,2023-07-19,Domino's Online,Expense,Leisure & Lifestyle,Takeaway,55.0,0,95065.29,D
1343,456,2023-07-22,Mecca,Expense,Personal,Hair & Beauty,213.75,0,94851.54,D
1346,456,2023-07-22,EnergyAustralia,Expense,Household,Utilities,73.21,0,94778.33,D
1341,456,2023-07-25,AGL,Expense,Household,Utilities,38.93,0,94739.4,D
1332,456,2023-07-26,Greencross Vets,Expense,Household,Pets,141.13,0,94598.27,D
1350,456,2023-07-26,EnergyAustralia,Expense,Household,Utilities,200.5,0,94397.77,D
1334,456,2023-07-28,Bike Shop,Expense,Transport,Cycling,493.13,0,93904.64,D
1338,456,2023-07-28,Sports Bar,Expense,Leisure & Lifestyle,Pubs & Bars,358.37,0,93546.27,D
1356,456,2023-08-01,Salary,Income,Income,Wages,0,8000,101546.27,C
1374,456,2023-08-02,Woolworths,Expense,Household,Groceries,124.16,0,101422.11,D
1379,456,2023-08-04,Cotton On,Expense,Personal,Clothing & Accessories,308.2,0,101113.91,D
1359,456,2023-08-05,Yoga Studio,Expense,Personal,Fitness & Wellbeing,130.71,0,100983.2,D
1358,456,2023-08-09,Stock Purchase,Expense,Personal,Investments,186.19,0,100797.01,D
1360,456,2023-08-09,United Petroleum,Expense,Transport,Fuel,355.85,0,100441.16,D
1361,456,2023-08-09,Adobe Creative Cloud,Expense,Leisure & Lifestyle,"Apps, Games & Software",324.51,0,100116.65,D
1381,456,2023-08-09,Stock Purchase,Income,Income,Investments,583.19,0,99533.46,D
1369,456,2023-08-13,Stock Purchase,Expense,Personal,Investments,662.29,0,98871.17,D
1378,456,2023-08-14,UberEats,Expense,Leisure & Lifestyle,Takeaway,369.83,0,98501.34,D
1357,456,2023-08-15,Birthday Gift,Expense,Personal,Gifts & Donations,376.91,0,98124.43,D
1371,456,2023-08-15,Spotify,Expense,Leisure & Lifestyle,"Tv, Music & Streaming",262.27,0,97862.16,D
1376,456,2023-08-15,RACV,Expense,Household,Rates & Insurance,390.79,0,97471.37,D
1382,456,2023-08-17,Booking.com,Expense,Leisure & Lifestyle,Holidays & Travel,125.84,0,97345.53,D
1365,456,2023-08-18,Stock Purchase,Income,Income,Investments,801.92,0,96543.61,D
1368,456,2023-08-18,McDonald's,Expense,Leisure & Lifestyle,Restaurants & Cafes,151.11,0,96392.5,D
1362,456,2023-08-20,Hobby Store,Expense,Leisure & Lifestyle,Hobbies,141.77,0,96250.73,D
1363,456,2023-08-20,Priceline Pharmacy,Expense,Personal,Health & Medical,265.92,0,95984.81,D
1373,456,2023-08-20,Tatts,Expense,Leisure & Lifestyle,Lottery & Gambling,442.75,0,95542.06,D
1372,456,2023-08-25,Priceline Pharmacy,Expense,Personal,Health & Medical,329.33,0,95212.73,D
1375,456,2023-08-25,TransLink,Expense,Transport,Public Transport,465.22,0,94747.51,D
1380,456,2023-08-25,Google Play Store,Expense,Leisure & Lifestyle,"Apps, Games & Software",391.04,0,94356.47,D
1366,456,2023-08-26,Lowe's,Expense,Household,Maintenance & Improvements,76.19,0,94280.28,D
1364,456,2023-08-27,Liquorland,Expense,Leisure & Lifestyle,Alcohol,220.51,0,94059.77,D
1370,456,2023-08-28,RSPCA,Expense,Household,Pets,211.02,0,93848.75,D
1377,456,2023-08-28,Costco,Expense,Household,Groceries,447.72,0,93401.03,D
1367,456,2023-08-29,Rooftop Bar,Expense,Leisure & Lifestyle,Pubs & Bars,83.26,0,93317.77,D
1383,456,2023-09-01,Salary,Income,Income,Wages,0,8000,101317.77,C
1399,456,2023-09-04,DoorDash,Expense,Leisure & Lifestyle,Takeaway,140.2,0,101177.57,D
1384,456,2023-09-05,Sportsbet,Expense,Leisure & Lifestyle,Lottery & Gambling,232.61,0,100944.96,D
1406,456,2023-09-05,Linkt,Expense,Transport,Tolls,453.32,0,100491.64,D
1385,456,2023-09-06,Landlord,Expense,Household,Rent & Mortgage,438.78,0,100052.86,D
1400,456,2023-09-10,Priceline Pharmacy,Expense,Personal,Health & Medical,49.03,0,100003.83,D
1386,456,2023-09-12,Allianz,Expense,Household,Rates & Insurance,151.89,0,99851.94,D
1394,456,2023-09-12,Tobacco Store,Expense,Leisure & Lifestyle,Tobacco & Vaping,65.38,0,99786.56,D
1395,456,2023-09-12,Stock Purchase,Expense,Personal,Investments,676.95,0,99109.61,D
1392,456,2023-09-13,Spotify,Expense,Leisure & Lifestyle,"Tv, Music & Streaming",425.39,0,98684.22,D
1396,456,2023-09-13,Suncorp,Expense,Household,Rates & Insurance,85.73,0,98598.49,D
1397,456,2023-09-13,Vape Shop,Expense,Leisure & Lifestyle,Tobacco & Vaping,454.11,0,98144.38,D
1401,456,2023-09-13,Cocktail Bar,Expense,Leisure & Lifestyle,Pubs & Bars,145.86,0,97998.52,D
1409,456,2023-09-13,The Lott,Expense,Leisure & Lifestyle,Lottery & Gambling,390.88,0,97607.64,D
1398,456,2023-09-16,Cycling Apparel Store,Expense,Transport,Cycling,329.75,0,97277.89,D
1402,456,2023-09-16,Home Depot,Expense,Household,Maintenance & Improvements,205.25,0,97072.64,D
1410,456,2023-09-17,DiDi,Expense,Transport,Taxies & Share Cars,327.68,0,96744.96,D
1387,456,2023-09-18,Airbnb,Expense,Leisure & Lifestyle,Holidays & Travel,373.25,0,96371.71,D
1407,456,2023-09-19,DoorDash,Expense,Leisure & Lifestyle,Takeaway,121.59,0,96250.12,D
1391,456,2023-09-20,Apple App Store,Expense,Leisure & Lifestyle,"Apps, Games & Software",343.52,0,95906.6,D
1393,456,2023-09-20,Spotify,Expense,Leisure & Lifestyle,"Tv, Music & Streaming",18.31,0,95888.29,D
1388,456,2023-09-24,Vodafone,Expense,Personal,Mobile Phone,38.65,0,95849.64,D
1403,456,2023-09-25,The Iconic,Expense,Personal,Clothing & Accessories,456.6,0,95393.04,D
1405,456,2023-09-26,Lawyer,Expense,Personal,Life Admin,442.31,0,94950.73,D
1408,456,2023-09-26,PayPal,Transfer,Transfer,Transfer,303.63,0,94647.1,D
1389,456,2023-09-28,Mortgage Lender,Expense,Household,Rent & Mortgage,338.04,0,94309.06,D
1390,456,2023-09-28,PetSmart,Expense,Household,Pets,419.13,0,93889.93,D
1404,456,2023-09-29,Steam,Expense,Leisure & Lifestyle,"Apps, Games & Software",237.74,0,93652.19,D
1411,456,2023-10-01,Salary,Income,Income,Wages,0,8000,101652.19,C
1431,456,2023-10-02,Adelaide Metro,Expense,Transport,Public Transport,106.98,0,101545.21,D
1414,456,2023-10-06,IGA,Expense,Household,Groceries,404.79,0,101140.42,D
1433,456,2023-10-06,Nail Salon,Expense,Personal,Hair & Beauty,441.33,0,100699.09,D
1419,456,2023-10-08,Qantas,Expense,Leisure & Lifestyle,Holidays & Travel,401.48,0,100297.61,D
1420,456,2023-10-09,Opal Card,Expense,Transport,Public Transport,286.64,0,100010.97,D
1428,456,2023-10-13,Booking.com,Expense,Leisure & Lifestyle,Holidays & Travel,409.68,0,99601.29,D
1430,456,2023-10-14,BWS,Expense,Leisure & Lifestyle,Alcohol,98.92,0,99502.37,D
1418,456,2023-10-15,H&M,Expense,Personal,Clothing & Accessories,152.0,0,99350.37,D
1416,456,2023-10-16,IGA,Expense,Household,Groceries,431.68,0,98918.69,D
1422,456,2023-10-17,PayPal,Transfer,Transfer,Transfer,366.23,0,98552.46,D
1413,456,2023-10-18,TransLink,Expense,Transport,Public Transport,402.85,0,98149.61,D
1415,456,2023-10-18,Linkt,Expense,Transport,Tolls,50.0,0,98099.61,D
1417,456,2023-10-18,Origin Energy,Expense,Household,Utilities,128.03,0,97971.58,D
1412,456,2023-10-19,Opal Card,Expense,Transport,Public Transport,57.18,0,97914.4,D
1421,456,2023-10-20,Accountant,Expense,Personal,Life Admin,45.29,0,97869.11,D
1427,456,2023-10-21,Costco,Expense,Household,Groceries,392.6,0,97476.51,D
1432,456,2023-10-21,RACV,Expense,Transport,"Car Insurance, Rego & Maintenance",129.87,0,97346.64,D
1423,456,2023-10-23,Dan Murphy's,Expense,Leisure & Lifestyle,Alcohol,226.61,0,97120.03,D
1424,456,2023-10-23,Toyota Finance,Expense,Transport,Car Repayments,400.87,0,96719.16,D
1425,456,2023-10-23,IKEA,Expense,Household,Maintenance & Improvements,283.59,0,96435.57,D
1429,456,2023-10-23,Petbarn,Expense,Household,Pets,372.02,0,96063.55,D
1426,456,2023-10-24,7-Eleven,Expense,Transport,Fuel,359.27,0,95704.28,D
1434,456,2023-11-01,Salary,Income,Income,Wages,0,8000,103704.28,C
1438,456,2023-11-03,Cigarettes,Expense,Leisure & Lifestyle,Tobacco & Vaping,272.29,0,103431.99,D
1443,456,2023-11-07,QBE,Expense,Household,Rates & Insurance,321.83,0,103110.16,D
1435,456,2023-11-10,Landlord,Expense,Household,Rent & Mortgage,460.33,0,102649.83,D
1437,456,2023-11-14,Optus,Expense,Household,Internet,498.01,0,102151.82,D
1445,456,2023-11-15,TAB,Expense,Leisure & Lifestyle,Lottery & Gambling,107.31,0,102044.51,D
1441,456,2023-11-17,Sydney Olympic Park,Expense,Transport,Parking,75.77,0,101968.74,D
1444,456,2023-11-23,Flight Centre,Expense,Leisure & Lifestyle,Holidays & Travel,195.77,0,101772.97,D
1436,456,2023-11-28,Aldi,Expense,Household,Groceries,347.71,0,101425.26,D
1440,456,2023-11-28,Music Store,Expense,Leisure & Lifestyle,Hobbies,15.62,0,101409.64,D
1439,456,2023-11-29,IGA,Expense,Household,Groceries,147.05,0,101262.59,D
1442,456,2023-11-29,NIB,Expense,Personal,Health & Medical,206.37,0,101056.22,D
1446,456,2023-12-01,Salary,Income,Income,Wages,0,8000,109056.22,C
1451,456,2023-12-03,Coles,Expense,Household,Groceries,70.27,0,108985.95,D
1448,456,2023-12-04,Vodafone,Expense,Household,Internet,127.04,0,108858.91,D
1462,456,2023-12-05,Sports Equipment Store,Expense,Leisure & Lifestyle,Hobbies,447.52,0,108411.39,D
1465,456,2023-12-07,University,Expense,Personal,Education,360.26,0,108051.13,D
1458,456,2023-12-09,Apple Music,Expense,Leisure & Lifestyle,"Tv, Music & Streaming",239.19,0,107811.94,D
1452,456,2023-12-16,Bupa,Expense,Personal,Health & Medical,349.67,0,107462.27,D
1463,456,2023-12-17,Optus,Expense,Household,Internet,458.12,0,107004.15,D
1461,456,2023-12-19,Anytime Fitness,Expense,Personal,Fitness & Wellbeing,404.49,0,106599.66,D
1456,456,2023-12-20,First Choice Liquor,Expense,Leisure & Lifestyle,Alcohol,289.88,0,106309.78,D
1453,456,2023-12-21,Yoga Studio,Expense,Personal,Fitness & Wellbeing,61.7,0,106248.08,D
1449,456,2023-12-22,Origin Energy,Expense,Household,Utilities,87.55,0,106160.53,D
1459,456,2023-12-23,RACV,Expense,Transport,"Car Insurance, Rego & Maintenance",498.04,0,105662.49,D
1454,456,2023-12-24,Eventbrite,Expense,Leisure & Lifestyle,Events & Gigs,177.62,0,105484.87,D
1457,456,2023-12-24,QBE,Expense,Transport,"Car Insurance, Rego & Maintenance",393.76,0,105091.11,D
1460,456,2023-12-24,Cigars,Expense,Leisure & Lifestyle,Tobacco & Vaping,134.69,0,104956.42,D
1455,456,2023-12-26,Stan,Expense,Leisure & Lifestyle,"Tv, Music & Streaming",491.75,0,104464.67,D
1450,456,2023-12-28,Accountant,Expense,Personal,Life Admin,132.47,0,104332.2,D
1447,456,2023-12-29,Charity Organization,Expense,Personal,Gifts & Donations,232.26,0,104099.94,D
1464,456,2023-12-29,Gym Membership,Expense,Personal,Fitness & Wellbeing,469.19,0,103630.75,D
1466,678,2021-01-01,Salary,Income,Income,Wages,0,8000,8000,C
1475,678,2021-01-03,Bupa,Expense,Personal,Health & Medical,69.5,0,7930.5,D
1470,678,2021-01-05,Linkt,Expense,Transport,Tolls,218.92,0,7711.58,D
1472,678,2021-01-05,IKEA,Expense,Household,Maintenance & Improvements,499.22,0,7212.36,D
1482,678,2021-01-05,YouTube Premium,Expense,Leisure & Lifestyle,"Tv, Music & Streaming",317.0,0,6895.36,D
1478,678,2021-01-07,Online Course Provider,Expense,Personal,Education,477.2,0,6418.16,D
1467,678,2021-01-08,KFC,Expense,Leisure & Lifestyle,Restaurants & Cafes,202.9,0,6215.26,D
1486,678,2021-01-08,Bunnings Warehouse,Expense,Household,Maintenance & Improvements,221.08,0,5994.18,D
1481,678,2021-01-09,RACV,Expense,Household,Rates & Insurance,306.94,0,5687.24,D
1468,678,2021-01-10,Post Office,Expense,Personal,Life Admin,435.66,0,5251.58,D
1484,678,2021-01-10,Stock Purchase,Income,Income,Investments,707.35,0,4544.23,D
1487,678,2021-01-11,Tutoring Service,Expense,Personal,Education,80.6,0,4463.63,D
1473,678,2021-01-12,IGA,Expense,Household,Groceries,276.19,0,4187.44,D
1483,678,2021-01-12,Steam,Expense,Leisure & Lifestyle,"Apps, Games & Software",499.73,0,3687.71,D
1476,678,2021-01-13,Toys R Us,Expense,Personal,Children & Family,412.49,0,3275.22,D
1480,678,2021-01-17,Home Depot,Expense,Household,Maintenance & Improvements,417.72,0,2857.5,D
1474,678,2021-01-19,GoFundMe,Expense,Personal,Gifts & Donations,280.68,0,2576.82,D
1485,678,2021-01-20,Shell,Expense,Transport,Fuel,48.13,0,2528.69,D
1469,678,2021-01-21,Domino's Pizza,Expense,Leisure & Lifestyle,Restaurants & Cafes,339.72,0,2188.97,D
1479,678,2021-01-21,DoorDash,Expense,Leisure & Lifestyle,Takeaway,273.99,0,1914.98,D
1477,678,2021-01-23,Greencross Vets,Expense,Household,Pets,152.62,0,1762.36,D
1471,678,2021-01-27,Qantas,Expense,Leisure & Lifestyle,Holidays & Travel,53.76,0,1708.6,D
1488,678,2021-02-01,Salary,Income,Income,Wages,0,8000,9708.6,C
1489,678,2021-02-02,AGL,Expense,Household,Utilities,376.58,0,9332.02,D
1491,678,2021-02-03,Linkt,Expense,Transport,Tolls,336.62,0,8995.4,D
1505,678,2021-02-03,Baby Bunting,Expense,Personal,Children & Family,232.2,0,8763.2,D
1500,678,2021-02-04,Art Supply Store,Expense,Leisure & Lifestyle,Hobbies,416.71,0,8346.49,D
1504,678,2021-02-06,iiNet,Expense,Household,Internet,367.75,0,7978.74,D
1492,678,2021-02-07,IKEA,Expense,Household,Maintenance & Improvements,269.33,0,7709.41,D
1508,678,2021-02-09,Adobe Creative Cloud,Expense,Leisure & Lifestyle,"Apps, Games & Software",287.59,0,7421.82,D
1509,678,2021-02-09,Priceline Pharmacy,Expense,Personal,Health & Medical,106.44,0,7315.38,D
1497,678,2021-02-12,IGA,Expense,Household,Groceries,110.11,0,7205.27,D
1498,678,2021-02-13,Tobacco Store,Expense,Leisure & Lifestyle,Tobacco & Vaping,256.23,0,6949.04,D
1503,678,2021-02-13,Coles,Expense,Household,Groceries,409.76,0,6539.28,D
1506,678,2021-02-14,Accountant,Expense,Personal,Life Admin,19.96,0,6519.32,D
1493,678,2021-02-18,Amaysim,Expense,Personal,Mobile Phone,32.3,0,6487.02,D
1494,678,2021-02-18,Music Store,Expense,Leisure & Lifestyle,Hobbies,34.71,0,6452.31,D
1501,678,2021-02-18,Spotify,Expense,Leisure & Lifestyle,"Tv, Music & Streaming",137.88,0,6314.43,D
1502,678,2021-02-21,Sydney Water,Expense,Household,Utilities,74.51,0,6239.92,D
1496,678,2021-02-23,Myki,Expense,Transport,Public Transport,359.97,0,5879.95,D
1495,678,2021-02-24,Toyota Finance,Expense,Transport,Car Repayments,459.17,0,5420.78,D
1490,678,2021-02-26,AGL,Expense,Household,Utilities,184.45,0,5236.33,D
1507,678,2021-02-26,QBE,Expense,Transport,"Car Insurance, Rego & Maintenance",102.85,0,5133.48,D
1499,678,2021-02-28,Venmo,Transfer,Transfer,Transfer,72.42,0,5061.06,D
1510,678,2021-02-28,Bike Shop,Expense,Transport,Cycling,145.4,0,4915.66,D
1511,678,2021-03-01,Salary,Income,Income,Wages,0,8000,12915.66,C
1530,678,2021-03-05,Domino's Pizza,Expense,Leisure & Lifestyle,Restaurants & Cafes,132.61,0,12783.05,D
1528,678,2021-03-06,Accountant,Expense,Personal,Life Admin,275.02,0,12508.03,D
1531,678,2021-03-06,QBE,Expense,Household,Rates & Insurance,474.01,0,12034.02,D
1534,678,2021-03-07,Origin Energy,Expense,Household,Utilities,137.75,0,11896.27,D
1524,678,2021-03-09,Priceline Pharmacy,Expense,Personal,Health & Medical,430.98,0,11465.29,D
1536,678,2021-03-10,Secure Parking,Expense,Transport,Parking,129.65,0,11335.64,D
1512,678,2021-03-11,Aldi,Expense,Household,Groceries,183.74,0,11151.9,D
1522,678,2021-03-11,Birthday Gift,Expense,Personal,Gifts & Donations,415.99,0,10735.91,D
1521,678,2021-03-13,AGL,Expense,Household,Utilities,456.13,0,10279.78,D
1533,678,2021-03-13,Cigarettes,Expense,Leisure & Lifestyle,Tobacco & Vaping,105.73,0,10174.05,D
1516,678,2021-03-16,TPG,Expense,Household,Internet,171.3,0,10002.75,D
1517,678,2021-03-17,Stock Purchase,Expense,Personal,Investments,964.97,0,9037.78,D
1520,678,2021-03-17,Netflix,Expense,Leisure & Lifestyle,"Tv, Music & Streaming",344.99,0,8692.79,D
1535,678,2021-03-18,Baby Bunting,Expense,Personal,Children & Family,100.0,0,8592.79,D
1515,678,2021-03-21,Sports Bar,Expense,Leisure & Lifestyle,Pubs & Bars,179.36,0,8413.43,D
1525,678,2021-03-22,Opal Card,Expense,Transport,Public Transport,350.57,0,8062.86,D
1532,678,2021-03-23,First Choice Liquor,Expense,Leisure & Lifestyle,Alcohol,100.2,0,7962.66,D
1523,678,2021-03-24,Uber,Expense,Transport,Taxies & Share Cars,48.91,0,7913.75,D
1529,678,2021-03-24,Spotify,Expense,Leisure & Lifestyle,"Tv, Music & Streaming",207.77,0,7705.98,D
1513,678,2021-03-25,Music Store,Expense,Leisure & Lifestyle,Hobbies,226.85,0,7479.13,D
1514,678,2021-03-26,Ticketmaster,Expense,Leisure & Lifestyle,Events & Gigs,53.09,0,7426.04,D
1518,678,2021-03-26,The Lott,Expense,Leisure & Lifestyle,Lottery & Gambling,386.52,0,7039.52,D
1526,678,2021-03-26,Adobe Creative Cloud,Expense,Leisure & Lifestyle,"Apps, Games & Software",480.81,0,6558.71,D
1527,678,2021-03-26,Bupa,Expense,Personal,Health & Medical,322.67,0,6236.04,D
1519,678,2021-03-27,Zara,Expense,Personal,Clothing & Accessories,343.16,0,5892.88,D
1537,678,2021-04-01,Salary,Income,Income,Wages,0,8000,13892.88,C
1547,678,2021-04-02,Adelaide Metro,Expense,Transport,Public Transport,42.23,0,13850.65,D
1540,678,2021-04-03,E-Toll,Expense,Transport,Tolls,243.87,0,13606.78,D
1556,678,2021-04-04,Landlord,Expense,Household,Rent & Mortgage,386.32,0,13220.46,D
1557,678,2021-04-05,Mortgage Lender,Expense,Household,Rent & Mortgage,306.83,0,12913.63,D
1541,678,2021-04-09,Flight Centre,Expense,Leisure & Lifestyle,Holidays & Travel,221.89,0,12691.74,D
1544,678,2021-04-09,Petbarn,Expense,Household,Pets,241.38,0,12450.36,D
1553,678,2021-04-10,Stock Purchase,Income,Income,Investments,816.53,0,11633.83,D
1551,678,2021-04-14,Myki,Expense,Transport,Public Transport,219.17,0,11414.66,D
1552,678,2021-04-14,Tobacco Store,Expense,Leisure & Lifestyle,Tobacco & Vaping,242.52,0,11172.14,D
1554,678,2021-04-15,Sydney Olympic Park,Expense,Transport,Parking,229.02,0,10943.12,D
1542,678,2021-04-16,Real Estate Agency,Expense,Household,Rent & Mortgage,15.98,0,10927.14,D
1539,678,2021-04-17,Bicycle Network,Expense,Transport,Cycling,313.88,0,10613.26,D
1550,678,2021-04-18,IKEA,Expense,Household,Maintenance & Improvements,257.92,0,10355.34,D
1546,678,2021-04-19,QBE,Expense,Transport,"Car Insurance, Rego & Maintenance",202.01,0,10153.33,D
1555,678,2021-04-20,Liquorland,Expense,Leisure & Lifestyle,Alcohol,360.79,0,9792.54,D
1538,678,2021-04-21,QBE,Expense,Household,Rates & Insurance,238.28,0,9554.26,D
1543,678,2021-04-21,McDonald's,Expense,Leisure & Lifestyle,Restaurants & Cafes,140.0,0,9414.26,D
1548,678,2021-04-23,Cigars,Expense,Leisure & Lifestyle,Tobacco & Vaping,311.8,0,9102.46,D
1545,678,2021-04-26,Adelaide Metro,Expense,Transport,Public Transport,491.82,0,8610.64,D
1549,678,2021-04-26,Toyota Finance,Expense,Transport,Car Repayments,36.46,0,8574.18,D
1558,678,2021-05-01,Salary,Income,Income,Wages,0,8000,16574.18,C
1561,678,2021-05-03,Adobe Creative Cloud,Expense,Leisure & Lifestyle,"Apps, Games & Software",230.64,0,16343.54,D
1568,678,2021-05-03,The Lott,Expense,Leisure & Lifestyle,Lottery & Gambling,53.78,0,16289.76,D
1573,678,2021-05-07,Uber,Expense,Transport,Taxies & Share Cars,417.49,0,15872.27,D
1562,678,2021-05-08,DoorDash,Expense,Leisure & Lifestyle,Takeaway,177.4,0,15694.87,D
1565,678,2021-05-08,BP,Expense,Transport,Fuel,72.39,0,15622.48,D
1564,678,2021-05-12,Steam,Expense,Leisure & Lifestyle,"Apps, Games & Software",200.82,0,15421.66,D
1567,678,2021-05-17,DiDi,Expense,Transport,Taxies & Share Cars,11.35,0,15410.31,D
1572,678,2021-05-19,Allianz,Expense,Transport,"Car Insurance, Rego & Maintenance",190.39,0,15219.92,D
1566,678,2021-05-20,Dan Murphy's,Expense,Leisure & Lifestyle,Alcohol,77.95,0,15141.97,D
1559,678,2021-05-21,Cocktail Bar,Expense,Leisure & Lifestyle,Pubs & Bars,468.09,0,14673.88,D
1571,678,2021-05-21,Car Dealership,Expense,Transport,Car Repayments,319.83,0,14354.05,D
1560,678,2021-05-26,Liquorland,Expense,Leisure & Lifestyle,Alcohol,462.76,0,13891.29,D
1569,678,2021-05-26,Lowe's,Expense,Household,Maintenance & Improvements,434.74,0,13456.55,D
1563,678,2021-05-27,Sports Equipment Store,Expense,Leisure & Lifestyle,Hobbies,387.13,0,13069.42,D
1570,678,2021-05-29,Tobacco Store,Expense,Leisure & Lifestyle,Tobacco & Vaping,349.39,0,12720.03,D
1574,678,2021-06-01,Salary,Income,Income,Wages,0,8000,20720.03,C
1583,678,2021-06-02,The Lott,Expense,Leisure & Lifestyle,Lottery & Gambling,282.75,0,20437.28,D
1595,678,2021-06-02,Gym Membership,Expense,Personal,Fitness & Wellbeing,194.13,0,20243.15,D
1578,678,2021-06-03,Tutoring Service,Expense,Personal,Education,102.33,0,20140.82,D
1582,678,2021-06-03,EnergyAustralia,Expense,Household,Utilities,219.68,0,19921.14,D
1588,678,2021-06-03,Hobby Store,Expense,Leisure & Lifestyle,Hobbies,213.54,0,19707.6,D
1577,678,2021-06-04,Stan,Expense,Leisure & Lifestyle,"Tv, Music & Streaming",366.83,0,19340.77,D
1585,678,2021-06-04,Childcare Center,Expense,Personal,Children & Family,293.76,0,19047.01,D
1591,678,2021-06-05,Deliveroo,Expense,Leisure & Lifestyle,Takeaway,56.95,0,18990.06,D
1592,678,2021-06-08,PayPal,Transfer,Transfer,Transfer,406.77,0,18583.29,D
1593,678,2021-06-11,Subway,Expense,Leisure & Lifestyle,Restaurants & Cafes,59.62,0,18523.67,D
1575,678,2021-06-13,Hobby Store,Expense,Leisure & Lifestyle,Hobbies,60.15,0,18463.52,D
1580,678,2021-06-21,Stock Purchase,Income,Income,Investments,557.55,0,17905.97,D
1589,678,2021-06-22,Baby Bunting,Expense,Personal,Children & Family,256.41,0,17649.56,D
1576,678,2021-06-23,Stock Purchase,Expense,Personal,Investments,354.52,0,17295.04,D
1594,678,2021-06-23,Lowe's,Expense,Household,Maintenance & Improvements,433.84,0,16861.2,D
1584,678,2021-06-24,Mecca,Expense,Personal,Hair & Beauty,309.8,0,16551.4,D
1590,678,2021-06-26,Anytime Fitness,Expense,Personal,Fitness & Wellbeing,487.53,0,16063.87,D
1579,678,2021-06-27,GoFundMe,Expense,Personal,Gifts & Donations,281.7,0,15782.17,D
1586,678,2021-06-27,IKEA,Expense,Household,Maintenance & Improvements,477.43,0,15304.74,D
1581,678,2021-06-29,Landlord,Expense,Household,Rent & Mortgage,157.63,0,15147.11,D
1587,678,2021-06-29,E-Toll,Expense,Transport,Tolls,256.98,0,14890.13,D
1596,678,2021-07-01,Salary,Income,Income,Wages,0,8000,22890.13,C
1598,678,2021-07-02,Stock Purchase,Expense,Personal,Investments,526.58,0,22363.55,D
1626,678,2021-07-02,Greencross Vets,Expense,Household,Pets,211.85,0,22151.7,D
1617,678,2021-07-04,Mecca,Expense,Personal,Hair & Beauty,29.4,0,22122.3,D
1597,678,2021-07-05,PayPal,Transfer,Transfer,Transfer,297.93,0,21824.37,D
1622,678,2021-07-09,Suncorp,Expense,Transport,"Car Insurance, Rego & Maintenance",260.28,0,21564.09,D
1610,678,2021-07-10,Ticketek,Expense,Leisure & Lifestyle,Events & Gigs,336.24,0,21227.85,D
1611,678,2021-07-10,IGA,Expense,Household,Groceries,273.21,0,20954.64,D
1602,678,2021-07-11,RSPCA,Expense,Household,Pets,153.28,0,20801.36,D
1624,678,2021-07-11,Qantas,Expense,Leisure & Lifestyle,Holidays & Travel,100.25,0,20701.11,D
1609,678,2021-07-12,The Iconic,Expense,Personal,Clothing & Accessories,61.2,0,20639.91,D
1620,678,2021-07-12,Cigarettes,Expense,Leisure & Lifestyle,Tobacco & Vaping,462.82,0,20177.09,D
1600,678,2021-07-13,Myki,Expense,Transport,Public Transport,68.17,0,20108.92,D
1605,678,2021-07-13,Sports Bar,Expense,Leisure & Lifestyle,Pubs & Bars,29.6,0,20079.32,D
1612,678,2021-07-13,City of Melbourne,Expense,Transport,Parking,283.39,0,19795.93,D
1618,678,2021-07-14,Mortgage Lender,Expense,Household,Rent & Mortgage,45.13,0,19750.8,D
1599,678,2021-07-15,Baby Bunting,Expense,Personal,Children & Family,217.51,0,19533.29,D
1607,678,2021-07-15,Stock Purchase,Income,Income,Investments,582.56,0,18950.73,D
1613,678,2021-07-18,E-Toll,Expense,Transport,Tolls,423.95,0,18526.78,D
1615,678,2021-07-18,The Lott,Expense,Leisure & Lifestyle,Lottery & Gambling,122.52,0,18404.26,D
1625,678,2021-07-18,QBE,Expense,Transport,"Car Insurance, Rego & Maintenance",277.64,0,18126.62,D
1601,678,2021-07-20,Stock Purchase,Income,Income,Investments,172.78,0,17953.84,D
1603,678,2021-07-23,Optus,Expense,Personal,Mobile Phone,88.29,0,17865.55,D
1608,678,2021-07-24,Sports Equipment Store,Expense,Leisure & Lifestyle,Hobbies,458.68,0,17406.87,D
1621,678,2021-07-25,QBE,Expense,Transport,"Car Insurance, Rego & Maintenance",151.48,0,17255.39,D
1623,678,2021-07-25,Adelaide Metro,Expense,Transport,Public Transport,40.6,0,17214.79,D
1606,678,2021-07-26,Mortgage Lender,Expense,Household,Rent & Mortgage,452.85,0,16761.94,D
1616,678,2021-07-26,Flight Centre,Expense,Leisure & Lifestyle,Holidays & Travel,237.15,0,16524.79,D
1619,678,2021-07-27,Printing Service,Expense,Personal,Life Admin,261.05,0,16263.74,D
1604,678,2021-07-28,Adelaide Metro,Expense,Transport,Public Transport,138.97,0,16124.77,D
1614,678,2021-07-29,Printing Service,Expense,Personal,Life Admin,43.13,0,16081.64,D
1627,678,2021-08-01,Salary,Income,Income,Wages,0,8000,24081.64,C
1628,678,2021-08-02,Accountant,Expense,Personal,Life Admin,26.24,0,24055.4,D
1630,678,2021-08-06,Rooftop Bar,Expense,Leisure & Lifestyle,Pubs & Bars,66.94,0,23988.46,D
1631,678,2021-08-06,E-Toll,Expense,Transport,Tolls,248.82,0,23739.64,D
1649,678,2021-08-06,Telstra,Expense,Household,Internet,292.98,0,23446.66,D
1646,678,2021-08-07,QBE,Expense,Household,Rates & Insurance,89.82,0,23356.84,D
1636,678,2021-08-08,Wilson Parking,Expense,Transport,Parking,373.81,0,22983.03,D
1642,678,2021-08-08,Toyota Finance,Expense,Transport,Car Repayments,378.71,0,22604.32,D
1651,678,2021-08-08,DiDi,Expense,Transport,Taxies & Share Cars,213.76,0,22390.56,D
1635,678,2021-08-09,Sportsbet,Expense,Leisure & Lifestyle,Lottery & Gambling,240.46,0,22150.1,D
1634,678,2021-08-10,Baby Bunting,Expense,Personal,Children & Family,372.26,0,21777.84,D
1643,678,2021-08-12,Vodafone,Expense,Personal,Mobile Phone,395.55,0,21382.29,D
1650,678,2021-08-13,First Choice Liquor,Expense,Leisure & Lifestyle,Alcohol,291.27,0,21091.02,D
1632,678,2021-08-14,Music Store,Expense,Leisure & Lifestyle,Hobbies,77.25,0,21013.77,D
1641,678,2021-08-14,Hair Salon,Expense,Personal,Hair & Beauty,168.23,0,20845.54,D
1647,678,2021-08-14,Secure Parking,Expense,Transport,Parking,323.09,0,20522.45,D
1639,678,2021-08-17,Home Depot,Expense,Household,Maintenance & Improvements,244.12,0,20278.33,D
1637,678,2021-08-18,Art Supply Store,Expense,Leisure & Lifestyle,Hobbies,284.51,0,19993.82,D
1638,678,2021-08-18,PayPal,Transfer,Transfer,Transfer,146.7,0,19847.12,D
1633,678,2021-08-20,City of Melbourne,Expense,Transport,Parking,109.65,0,19737.47,D
1644,678,2021-08-22,Charity Organization,Expense,Personal,Gifts & Donations,387.36,0,19350.11,D
1652,678,2021-08-24,Origin Energy,Expense,Household,Utilities,290.38,0,19059.73,D
1640,678,2021-08-25,Tobacco Store,Expense,Leisure & Lifestyle,Tobacco & Vaping,168.91,0,18890.82,D
1648,678,2021-08-25,Flight Centre,Expense,Leisure & Lifestyle,Holidays & Travel,182.83,0,18707.99,D
1645,678,2021-08-27,BP,Expense,Transport,Fuel,43.12,0,18664.87,D
1629,678,2021-08-28,Stock Purchase,Income,Income,Investments,993.52,0,17671.35,D
1653,678,2021-09-01,Salary,Income,Income,Wages,0,8000,25671.35,C
1661,678,2021-09-02,RSPCA,Expense,Household,Pets,200.64,0,25470.71,D
1667,678,2021-09-03,Spotify,Expense,Leisure & Lifestyle,"Tv, Music & Streaming",427.63,0,25043.08,D
1660,678,2021-09-08,Bupa,Expense,Personal,Health & Medical,50.42,0,24992.66,D
1655,678,2021-09-11,Shell,Expense,Transport,Fuel,265.05,0,24727.61,D
1665,678,2021-09-11,Hair Salon,Expense,Personal,Hair & Beauty,343.73,0,24383.88,D
1658,678,2021-09-14,RACV,Expense,Transport,"Car Insurance, Rego & Maintenance",358.46,0,24025.42,D
1654,678,2021-09-16,Tatts,Expense,Leisure & Lifestyle,Lottery & Gambling,119.5,0,23905.92,D
1656,678,2021-09-17,Optus,Expense,Household,Internet,172.24,0,23733.68,D
1659,678,2021-09-17,Bank Transfer,Transfer,Transfer,Transfer,376.98,0,23356.7,D
1666,678,2021-09-18,Stan,Expense,Leisure & Lifestyle,"Tv, Music & Streaming",467.46,0,22889.24,D
1662,678,2021-09-20,Tutoring Service,Expense,Personal,Education,385.13,0,22504.11,D
1664,678,2021-09-25,Car Loan Provider,Expense,Transport,Car Repayments,354.12,0,22149.99,D
1663,678,2021-09-28,Tobacco Store,Expense,Leisure & Lifestyle,Tobacco & Vaping,130.87,0,22019.12,D
1657,678,2021-09-29,Real Estate Agency,Expense,Household,Rent & Mortgage,384.31,0,21634.81,D
1668,678,2021-10-01,Salary,Income,Income,Wages,0,8000,29634.81,C
1676,678,2021-10-02,Coles,Expense,Household,Groceries,481.41,0,29153.4,D
1685,678,2021-10-02,Music Store,Expense,Leisure & Lifestyle,Hobbies,280.17,0,28873.23,D
1671,678,2021-10-03,University,Expense,Personal,Education,454.19,0,28419.04,D
1678,678,2021-10-04,Sydney Olympic Park,Expense,Transport,Parking,241.54,0,28177.5,D
1673,678,2021-10-08,Subway,Expense,Leisure & Lifestyle,Restaurants & Cafes,198.74,0,27978.76,D
1687,678,2021-10-10,Priceline Pharmacy,Expense,Personal,Health & Medical,89.06,0,27889.7,D
1683,678,2021-10-12,Liquorland,Expense,Leisure & Lifestyle,Alcohol,366.98,0,27522.72,D
1677,678,2021-10-14,Aldi,Expense,Household,Groceries,475.96,0,27046.76,D
1681,678,2021-10-14,BP,Expense,Transport,Fuel,342.12,0,26704.64,D
1688,678,2021-10-14,RACV,Expense,Transport,"Car Insurance, Rego & Maintenance",149.93,0,26554.71,D
1682,678,2021-10-15,YouTube Premium,Expense,Leisure & Lifestyle,"Tv, Music & Streaming",159.79,0,26394.92,D
1679,678,2021-10-16,Priceline Pharmacy,Expense,Personal,Health & Medical,120.15,0,26274.77,D
1672,678,2021-10-17,Venmo,Transfer,Transfer,Transfer,52.28,0,26222.49,D
1689,678,2021-10-18,Stock Purchase,Income,Income,Investments,198.12,0,26024.37,D
1686,678,2021-10-19,Costco,Expense,Household,Groceries,110.99,0,25913.38,D
1674,678,2021-10-21,Toyota Finance,Expense,Transport,Car Repayments,105.19,0,25808.19,D
1680,678,2021-10-21,Aldi,Expense,Household,Groceries,284.04,0,25524.15,D
1684,678,2021-10-21,GoFundMe,Expense,Personal,Gifts & Donations,318.82,0,25205.33,D
1670,678,2021-10-23,Adelaide Metro,Expense,Transport,Public Transport,213.22,0,24992.11,D
1675,678,2021-10-27,Sports Bar,Expense,Leisure & Lifestyle,Pubs & Bars,335.73,0,24656.38,D
1669,678,2021-10-29,Local Pub,Expense,Leisure & Lifestyle,Pubs & Bars,151.3,0,24505.08,D
1690,678,2021-11-01,Salary,Income,Income,Wages,0,8000,32505.08,C
1697,678,2021-11-02,Ticketmaster,Expense,Leisure & Lifestyle,Events & Gigs,481.56,0,32023.52,D
1693,678,2021-11-07,NRMA,Expense,Transport,"Car Insurance, Rego & Maintenance",370.29,0,31653.23,D
1694,678,2021-11-09,Cotton On,Expense,Personal,Clothing & Accessories,382.36,0,31270.87,D
1692,678,2021-11-12,Stock Purchase,Income,Income,Investments,327.88,0,30942.99,D
1700,678,2021-11-13,Childcare Center,Expense,Personal,Children & Family,211.14,0,30731.85,D
1696,678,2021-11-15,iiNet,Expense,Household,Internet,108.79,0,30623.06,D
1698,678,2021-11-28,University,Expense,Personal,Education,72.96,0,30550.1,D
1691,678,2021-11-29,Art Supply Store,Expense,Leisure & Lifestyle,Hobbies,491.4,0,30058.7,D
1695,678,2021-11-29,Telstra,Expense,Personal,Mobile Phone,215.88,0,29842.82,D
1699,678,2021-11-29,Art Supply Store,Expense,Leisure & Lifestyle,Hobbies,80.31,0,29762.51,D
1701,678,2021-12-01,Salary,Income,Income,Wages,0,8000,37762.51,C
1709,678,2021-12-05,Menulog,Expense,Leisure & Lifestyle,Takeaway,12.78,0,37749.73,D
1706,678,2021-12-08,Bicycle Network,Expense,Transport,Cycling,52.57,0,37697.16,D
1707,678,2021-12-15,Landlord,Expense,Household,Rent & Mortgage,287.73,0,37409.43,D
1710,678,2021-12-16,Music Store,Expense,Leisure & Lifestyle,Hobbies,78.27,0,37331.16,D
1703,678,2021-12-18,Spotify,Expense,Leisure & Lifestyle,"Tv, Music & Streaming",129.71,0,37201.45,D
1711,678,2021-12-18,Domino's Pizza,Expense,Leisure & Lifestyle,Restaurants & Cafes,242.44,0,36959.01,D
1708,678,2021-12-20,KFC,Expense,Leisure & Lifestyle,Restaurants & Cafes,177.2,0,36781.81,D
1705,678,2021-12-24,Post Office,Expense,Personal,Life Admin,60.6,0,36721.21,D
1704,678,2021-12-26,7-Eleven,Expense,Transport,Fuel,270.08,0,36451.13,D
1702,678,2021-12-28,Vodafone,Expense,Household,Internet,470.03,0,35981.1,D
1712,678,2022-01-01,Salary,Income,Income,Wages,0,8000,43981.1,C
1713,678,2022-01-02,Netflix,Expense,Leisure & Lifestyle,"Tv, Music & Streaming",321.25,0,43659.85,D
1730,678,2022-01-02,Toyota Finance,Expense,Transport,Car Repayments,123.55,0,43536.3,D
1737,678,2022-01-02,Online Course Provider,Expense,Personal,Education,324.55,0,43211.75,D
1735,678,2022-01-03,Car Loan Provider,Expense,Transport,Car Repayments,398.33,0,42813.42,D
1717,678,2022-01-05,City of Melbourne,Expense,Transport,Parking,297.96,0,42515.46,D
1732,678,2022-01-05,TransLink,Expense,Transport,Public Transport,449.98,0,42065.48,D
1716,678,2022-01-06,Stock Purchase,Income,Income,Investments,212.62,0,41852.86,D
1726,678,2022-01-06,Toyota Finance,Expense,Transport,Car Repayments,309.13,0,41543.73,D
1729,678,2022-01-06,First Choice Liquor,Expense,Leisure & Lifestyle,Alcohol,333.52,0,41210.21,D
1734,678,2022-01-06,Sephora,Expense,Personal,Hair & Beauty,435.37,0,40774.84,D
1740,678,2022-01-07,EnergyAustralia,Expense,Household,Utilities,196.24,0,40578.6,D
1723,678,2022-01-10,Bunnings Warehouse,Expense,Household,Maintenance & Improvements,61.25,0,40517.35,D
1715,678,2022-01-11,Fitness First,Expense,Personal,Fitness & Wellbeing,115.23,0,40402.12,D
1741,678,2022-01-12,Nail Salon,Expense,Personal,Hair & Beauty,13.87,0,40388.25,D
1720,678,2022-01-13,Myki,Expense,Transport,Public Transport,212.8,0,40175.45,D
1736,678,2022-01-13,Telstra,Expense,Personal,Mobile Phone,177.95,0,39997.5,D
1724,678,2022-01-14,Uniqlo,Expense,Personal,Clothing & Accessories,499.46,0,39498.04,D
1719,678,2022-01-15,DiDi,Expense,Transport,Taxies & Share Cars,48.7,0,39449.34,D
1718,678,2022-01-16,Vodafone,Expense,Personal,Mobile Phone,36.96,0,39412.38,D
1721,678,2022-01-16,Cigarettes,Expense,Leisure & Lifestyle,Tobacco & Vaping,57.66,0,39354.72,D
1722,678,2022-01-16,Caltex,Expense,Transport,Fuel,492.95,0,38861.77,D
1739,678,2022-01-18,Bicycle Network,Expense,Transport,Cycling,451.87,0,38409.9,D
1714,678,2022-01-20,Linkt,Expense,Transport,Tolls,488.53,0,37921.37,D
1725,678,2022-01-21,Ticketmaster,Expense,Leisure & Lifestyle,Events & Gigs,13.88,0,37907.49,D
1727,678,2022-01-23,Car Loan Provider,Expense,Transport,Car Repayments,210.23,0,37697.26,D
1728,678,2022-01-25,Hair Salon,Expense,Personal,Hair & Beauty,175.04,0,37522.22,D
1733,678,2022-01-25,IKEA,Expense,Household,Maintenance & Improvements,141.52,0,37380.7,D
1731,678,2022-01-26,Stock Purchase,Income,Income,Investments,315.55,0,37065.15,D
1738,678,2022-01-28,Nail Salon,Expense,Personal,Hair & Beauty,225.93,0,36839.22,D
1742,678,2022-02-01,Salary,Income,Income,Wages,0,8000,44839.22,C
1752,678,2022-02-02,Sports Equipment Store,Expense,Leisure & Lifestyle,Hobbies,334.34,0,44504.88,D
1748,678,2022-02-07,Stock Purchase,Expense,Personal,Investments,442.38,0,44062.5,D
1750,678,2022-02-10,Opal Card,Expense,Transport,Public Transport,498.32,0,43564.18,D
1746,678,2022-02-14,E-Toll,Expense,Transport,Tolls,239.13,0,43325.05,D
1754,678,2022-02-16,Venmo,Transfer,Transfer,Transfer,398.61,0,42926.44,D
1744,678,2022-02-20,Sydney Olympic Park,Expense,Transport,Parking,320.08,0,42606.36,D
1751,678,2022-02-20,Telstra,Expense,Household,Internet,189.94,0,42416.42,D
1743,678,2022-02-22,Domino's Pizza,Expense,Leisure & Lifestyle,Restaurants & Cafes,325.28,0,42091.14,D
1745,678,2022-02-22,Netflix,Expense,Leisure & Lifestyle,"Tv, Music & Streaming",405.57,0,41685.57,D
1753,678,2022-02-24,Music Store,Expense,Leisure & Lifestyle,Hobbies,364.33,0,41321.24,D
1747,678,2022-02-27,Birthday Gift,Expense,Personal,Gifts & Donations,382.67,0,40938.57,D
1749,678,2022-03-01,Booking.com,Expense,Leisure & Lifestyle,Holidays & Travel,465.21,0,40473.36,D
1755,678,2022-03-01,Salary,Income,Income,Wages,0,8000,48473.36,C
1759,678,2022-03-03,Stock Purchase,Income,Income,Investments,390.76,0,48082.6,D
1762,678,2022-03-04,Cotton On,Expense,Personal,Clothing & Accessories,325.23,0,47757.37,D
1757,678,2022-03-05,PetSmart,Expense,Household,Pets,398.32,0,47359.05,D
1756,678,2022-03-06,Toyota Finance,Expense,Transport,Car Repayments,361.29,0,46997.76,D
1760,678,2022-03-06,The Lott,Expense,Leisure & Lifestyle,Lottery & Gambling,413.17,0,46584.59,D
1758,678,2022-03-07,Linkt,Expense,Transport,Tolls,279.44,0,46305.15,D
1764,678,2022-03-07,NRMA,Expense,Transport,"Car Insurance, Rego & Maintenance",448.87,0,45856.28,D
1763,678,2022-03-10,Bank Transfer,Transfer,Transfer,Transfer,299.02,0,45557.26,D
1767,678,2022-03-11,Telstra,Expense,Personal,Mobile Phone,368.07,0,45189.19,D
1761,678,2022-03-19,Toys R Us,Expense,Personal,Children & Family,215.81,0,44973.38,D
1766,678,2022-03-22,13cabs,Expense,Transport,Taxies & Share Cars,477.19,0,44496.19,D
1765,678,2022-03-23,The Iconic,Expense,Personal,Clothing & Accessories,192.05,0,44304.14,D
1768,678,2022-04-01,Salary,Income,Income,Wages,0,8000,52304.14,C
1769,678,2022-04-02,Baby Bunting,Expense,Personal,Children & Family,217.79,0,52086.35,D
1774,678,2022-04-03,Secure Parking,Expense,Transport,Parking,451.37,0,51634.98,D
1784,678,2022-04-03,E-Toll,Expense,Transport,Tolls,436.06,0,51198.92,D
1773,678,2022-04-04,Suncorp,Expense,Household,Rates & Insurance,275.97,0,50922.95,D
1778,678,2022-04-04,GoFundMe,Expense,Personal,Gifts & Donations,384.95,0,50538.0,D
1782,678,2022-04-06,7-Eleven,Expense,Transport,Fuel,136.16,0,50401.84,D
1787,678,2022-04-08,QBE,Expense,Transport,"Car Insurance, Rego & Maintenance",326.85,0,50074.99,D
1790,678,2022-04-08,Origin Energy,Expense,Household,Utilities,137.72,0,49937.27,D
1795,678,2022-04-09,Priceline Pharmacy,Expense,Personal,Health & Medical,233.83,0,49703.44,D
1781,678,2022-04-13,Liquorland,Expense,Leisure & Lifestyle,Alcohol,260.51,0,49442.93,D
1785,678,2022-04-14,Art Supply Store,Expense,Leisure & Lifestyle,Hobbies,393.43,0,49049.5,D
1788,678,2022-04-14,Printing Service,Expense,Personal,Life Admin,476.79,0,48572.71,D
1792,678,2022-04-15,Baby Bunting,Expense,Personal,Children & Family,232.53,0,48340.18,D
1794,678,2022-04-16,iiNet,Expense,Household,Internet,64.31,0,48275.87,D
1791,678,2022-04-17,NRMA,Expense,Household,Rates & Insurance,31.86,0,48244.01,D
1797,678,2022-04-19,Landlord,Expense,Household,Rent & Mortgage,224.84,0,48019.17,D
1772,678,2022-04-20,Steam,Expense,Leisure & Lifestyle,"Apps, Games & Software",374.5,0,47644.67,D
1783,678,2022-04-20,NIB,Expense,Personal,Health & Medical,350.05,0,47294.62,D
1776,678,2022-04-21,Landlord,Expense,Household,Rent & Mortgage,231.23,0,47063.39,D
1780,678,2022-04-21,Vape Shop,Expense,Leisure & Lifestyle,Tobacco & Vaping,213.74,0,46849.65,D
1779,678,2022-04-22,BWS,Expense,Leisure & Lifestyle,Alcohol,82.58,0,46767.07,D
1777,678,2022-04-23,Fitness First,Expense,Personal,Fitness & Wellbeing,54.68,0,46712.39,D
1786,678,2022-04-23,Bike Shop,Expense,Transport,Cycling,186.1,0,46526.29,D
1771,678,2022-04-24,Aldi,Expense,Household,Groceries,38.79,0,46487.5,D
1793,678,2022-04-25,Subway,Expense,Leisure & Lifestyle,Restaurants & Cafes,284.32,0,46203.18,D
1789,678,2022-04-27,EastLink,Expense,Transport,Tolls,353.43,0,45849.75,D
1770,678,2022-04-28,GoCatch,Expense,Transport,Taxies & Share Cars,280.05,0,45569.7,D
1796,678,2022-04-28,Rooftop Bar,Expense,Leisure & Lifestyle,Pubs & Bars,249.54,0,45320.16,D
1775,678,2022-04-29,Toyota Finance,Expense,Transport,Car Repayments,324.26,0,44995.9,D
1798,678,2022-05-01,Salary,Income,Income,Wages,0,8000,52995.9,C
1819,678,2022-05-02,Optus,Expense,Personal,Mobile Phone,33.67,0,52962.23,D
1825,678,2022-05-03,Post Office,Expense,Personal,Life Admin,55.82,0,52906.41,D
1806,678,2022-05-06,Apple App Store,Expense,Leisure & Lifestyle,"Apps, Games & Software",51.61,0,52854.8,D
1826,678,2022-05-06,YouTube Premium,Expense,Leisure & Lifestyle,"Tv, Music & Streaming",424.52,0,52430.28,D
1824,678,2022-05-07,University,Expense,Personal,Education,113.77,0,52316.51,D
1799,678,2022-05-10,Stock Purchase,Expense,Personal,Investments,834.52,0,51481.99,D
1804,678,2022-05-10,Airbnb,Expense,Leisure & Lifestyle,Holidays & Travel,177.5,0,51304.49,D
1811,678,2022-05-10,Bunnings Warehouse,Expense,Household,Maintenance & Improvements,384.18,0,50920.31,D
1809,678,2022-05-12,Stan,Expense,Leisure & Lifestyle,"Tv, Music & Streaming",29.17,0,50891.14,D
1802,678,2022-05-13,NRMA,Expense,Household,Rates & Insurance,94.78,0,50796.36,D
1808,678,2022-05-14,Yoga Studio,Expense,Personal,Fitness & Wellbeing,143.9,0,50652.46,D
1818,678,2022-05-14,Tutoring Service,Expense,Personal,Education,391.5,0,50260.96,D
1801,678,2022-05-18,Car Loan Provider,Expense,Transport,Car Repayments,303.35,0,49957.61,D
1807,678,2022-05-19,Allianz,Expense,Household,Rates & Insurance,305.56,0,49652.05,D
1815,678,2022-05-19,Opal Card,Expense,Transport,Public Transport,183.22,0,49468.83,D
1812,678,2022-05-20,RACV,Expense,Transport,"Car Insurance, Rego & Maintenance",146.73,0,49322.1,D
1822,678,2022-05-20,CityLink,Expense,Transport,Tolls,306.29,0,49015.81,D
1823,678,2022-05-23,Opal Card,Expense,Transport,Public Transport,498.31,0,48517.5,D
1803,678,2022-05-24,TAB,Expense,Leisure & Lifestyle,Lottery & Gambling,492.71,0,48024.79,D
1816,678,2022-05-24,University,Expense,Personal,Education,390.75,0,47634.04,D
1817,678,2022-05-24,Stock Purchase,Income,Income,Investments,501.6,0,47132.44,D
1821,678,2022-05-25,Anytime Fitness,Expense,Personal,Fitness & Wellbeing,29.13,0,47103.31,D
1805,678,2022-05-26,EnergyAustralia,Expense,Household,Utilities,442.59,0,46660.72,D
1800,678,2022-05-27,Medibank,Expense,Personal,Health & Medical,195.37,0,46465.35,D
1810,678,2022-05-27,Medibank,Expense,Personal,Health & Medical,26.93,0,46438.42,D
1813,678,2022-05-27,KFC,Expense,Leisure & Lifestyle,Restaurants & Cafes,10.49,0,46427.93,D
1814,678,2022-05-28,The Iconic,Expense,Personal,Clothing & Accessories,105.81,0,46322.12,D
1820,678,2022-05-29,GoFundMe,Expense,Personal,Gifts & Donations,484.46,0,45837.66,D
1827,678,2022-06-01,Salary,Income,Income,Wages,0,8000,53837.66,C
1838,678,2022-06-02,QBE,Expense,Household,Rates & Insurance,274.82,0,53562.84,D
1830,678,2022-06-03,Bunnings Warehouse,Expense,Household,Maintenance & Improvements,240.68,0,53322.16,D
1835,678,2022-06-03,Ticketmaster,Expense,Leisure & Lifestyle,Events & Gigs,380.18,0,52941.98,D
1829,678,2022-06-04,Dan Murphy's,Expense,Leisure & Lifestyle,Alcohol,100.36,0,52841.62,D
1847,678,2022-06-05,The Iconic,Expense,Personal,Clothing & Accessories,237.33,0,52604.29,D
1843,678,2022-06-06,Subway,Expense,Leisure & Lifestyle,Restaurants & Cafes,392.18,0,52212.11,D
1831,678,2022-06-10,University,Expense,Personal,Education,13.65,0,52198.46,D
1842,678,2022-06-10,Booking.com,Expense,Leisure & Lifestyle,Holidays & Travel,499.17,0,51699.29,D
1850,678,2022-06-10,Real Estate Agency,Expense,Household,Rent & Mortgage,114.96,0,51584.33,D
1851,678,2022-06-11,Booking.com,Expense,Leisure & Lifestyle,Holidays & Travel,57.82,0,51526.51,D
1841,678,2022-06-13,Home Depot,Expense,Household,Maintenance & Improvements,132.56,0,51393.95,D
1849,678,2022-06-13,RSPCA,Expense,Household,Pets,337.34,0,51056.61,D
1844,678,2022-06-14,McDonald's,Expense,Leisure & Lifestyle,Restaurants & Cafes,294.11,0,50762.5,D
1852,678,2022-06-16,Linkt,Expense,Transport,Tolls,416.23,0,50346.27,D
1828,678,2022-06-18,Subway,Expense,Leisure & Lifestyle,Restaurants & Cafes,340.58,0,50005.69,D
1840,678,2022-06-18,TPG,Expense,Household,Internet,245.33,0,49760.36,D
1848,678,2022-06-19,TransLink,Expense,Transport,Public Transport,40.04,0,49720.32,D
1855,678,2022-06-21,IKEA,Expense,Household,Maintenance & Improvements,40.88,0,49679.44,D
1845,678,2022-06-22,IKEA,Expense,Household,Maintenance & Improvements,360.31,0,49319.13,D
1853,678,2022-06-22,Art Supply Store,Expense,Leisure & Lifestyle,Hobbies,490.64,0,48828.49,D
1832,678,2022-06-23,Sydney Water,Expense,Household,Utilities,472.88,0,48355.61,D
1833,678,2022-06-23,EastLink,Expense,Transport,Tolls,166.79,0,48188.82,D
1839,678,2022-06-24,Apple App Store,Expense,Leisure & Lifestyle,"Apps, Games & Software",210.61,0,47978.21,D
1846,678,2022-06-25,Opal Card,Expense,Transport,Public Transport,482.42,0,47495.79,D
1834,678,2022-06-29,Cotton On,Expense,Personal,Clothing & Accessories,74.03,0,47421.76,D
1836,678,2022-06-29,Childcare Center,Expense,Personal,Children & Family,92.37,0,47329.39,D
1837,678,2022-06-29,Hair Salon,Expense,Personal,Hair & Beauty,270.3,0,47059.09,D
1854,678,2022-06-29,Gym Membership,Expense,Personal,Fitness & Wellbeing,194.87,0,46864.22,D
1856,678,2022-07-01,Salary,Income,Income,Wages,0,8000,54864.22,C
1869,678,2022-07-03,NRMA,Expense,Transport,"Car Insurance, Rego & Maintenance",326.19,0,54538.03,D
1867,678,2022-07-04,Hair Salon,Expense,Personal,Hair & Beauty,165.34,0,54372.69,D
1858,678,2022-07-05,Yoga Studio,Expense,Personal,Fitness & Wellbeing,216.62,0,54156.07,D
1866,678,2022-07-05,Mortgage Lender,Expense,Household,Rent & Mortgage,488.98,0,53667.09,D
1865,678,2022-07-06,Rooftop Bar,Expense,Leisure & Lifestyle,Pubs & Bars,56.92,0,53610.17,D
1871,678,2022-07-11,Mortgage Lender,Expense,Household,Rent & Mortgage,135.07,0,53475.1,D
1863,678,2022-07-13,Steam,Expense,Leisure & Lifestyle,"Apps, Games & Software",499.69,0,52975.41,D
1861,678,2022-07-19,The Lott,Expense,Leisure & Lifestyle,Lottery & Gambling,87.44,0,52887.97,D
1864,678,2022-07-21,Spotify,Expense,Leisure & Lifestyle,"Tv, Music & Streaming",493.7,0,52394.27,D
1857,678,2022-07-23,Secure Parking,Expense,Transport,Parking,449.13,0,51945.14,D
1859,678,2022-07-23,RACV,Expense,Household,Rates & Insurance,259.49,0,51685.65,D
1868,678,2022-07-23,Gym Membership,Expense,Personal,Fitness & Wellbeing,108.61,0,51577.04,D
1870,678,2022-07-24,DoorDash,Expense,Leisure & Lifestyle,Takeaway,301.05,0,51275.99,D
1860,678,2022-07-27,Car Loan Provider,Expense,Transport,Car Repayments,40.55,0,51235.44,D
1862,678,2022-07-29,Dan Murphy's,Expense,Leisure & Lifestyle,Alcohol,298.97,0,50936.47,D
1872,678,2022-08-01,Salary,Income,Income,Wages,0,8000,58936.47,C
1898,678,2022-08-02,Coles,Expense,Household,Groceries,227.56,0,58708.91,D
1899,678,2022-08-02,Adelaide Metro,Expense,Transport,Public Transport,398.34,0,58310.57,D
1900,678,2022-08-02,Shell,Expense,Transport,Fuel,135.81,0,58174.76,D
1897,678,2022-08-03,Stock Purchase,Expense,Personal,Investments,133.52,0,58041.24,D
1889,678,2022-08-04,RSPCA,Expense,Household,Pets,383.29,0,57657.95,D
1880,678,2022-08-05,RACV,Expense,Household,Rates & Insurance,303.97,0,57353.98,D
1873,678,2022-08-07,Toyota Finance,Expense,Transport,Car Repayments,228.19,0,57125.79,D
1874,678,2022-08-08,Suncorp,Expense,Household,Rates & Insurance,359.25,0,56766.54,D
1882,678,2022-08-09,PayPal,Transfer,Transfer,Transfer,133.07,0,56633.47,D
1888,678,2022-08-10,Cotton On,Expense,Personal,Clothing & Accessories,329.33,0,56304.14,D
1892,678,2022-08-10,Liquorland,Expense,Leisure & Lifestyle,Alcohol,458.85,0,55845.29,D
1876,678,2022-08-11,Lowe's,Expense,Household,Maintenance & Improvements,188.67,0,55656.62,D
1881,678,2022-08-12,MAC Cosmetics,Expense,Personal,Hair & Beauty,111.83,0,55544.79,D
1878,678,2022-08-13,Sephora,Expense,Personal,Hair & Beauty,161.42,0,55383.37,D
1883,678,2022-08-13,Childcare Center,Expense,Personal,Children & Family,218.44,0,55164.93,D
1879,678,2022-08-15,Cotton On,Expense,Personal,Clothing & Accessories,103.57,0,55061.36,D
1894,678,2022-08-16,NIB,Expense,Personal,Health & Medical,433.63,0,54627.73,D
1896,678,2022-08-17,Bunnings Warehouse,Expense,Household,Maintenance & Improvements,415.57,0,54212.16,D
1887,678,2022-08-18,Post Office,Expense,Personal,Life Admin,497.42,0,53714.74,D
1875,678,2022-08-20,Shell,Expense,Transport,Fuel,252.1,0,53462.64,D
1890,678,2022-08-20,Ticketek,Expense,Leisure & Lifestyle,Events & Gigs,423.99,0,53038.65,D
1884,678,2022-08-21,Birthday Gift,Expense,Personal,Gifts & Donations,306.2,0,52732.45,D
1886,678,2022-08-21,Adelaide Metro,Expense,Transport,Public Transport,344.76,0,52387.69,D
1877,678,2022-08-24,Optus,Expense,Household,Internet,313.27,0,52074.42,D
1893,678,2022-08-24,Bike Shop,Expense,Transport,Cycling,27.07,0,52047.35,D
1895,678,2022-08-24,Costco,Expense,Household,Groceries,376.36,0,51670.99,D
1885,678,2022-08-28,GoCatch,Expense,Transport,Taxies & Share Cars,90.73,0,51580.26,D
1891,678,2022-08-29,Stock Purchase,Income,Income,Investments,205.8,0,51374.46,D
1901,678,2022-09-01,Salary,Income,Income,Wages,0,8000,59374.46,C
1905,678,2022-09-02,Vodafone,Expense,Personal,Mobile Phone,155.46,0,59219.0,D
1918,678,2022-09-02,Suncorp,Expense,Household,Rates & Insurance,248.83,0,58970.17,D
1904,678,2022-09-04,First Choice Liquor,Expense,Leisure & Lifestyle,Alcohol,46.49,0,58923.68,D
1909,678,2022-09-04,Sports Bar,Expense,Leisure & Lifestyle,Pubs & Bars,307.45,0,58616.23,D
1921,678,2022-09-04,Spotify,Expense,Leisure & Lifestyle,"Tv, Music & Streaming",67.23,0,58549.0,D
1903,678,2022-09-09,Landlord,Expense,Household,Rent & Mortgage,76.97,0,58472.03,D
1914,678,2022-09-12,Local Pub,Expense,Leisure & Lifestyle,Pubs & Bars,413.15,0,58058.88,D
1915,678,2022-09-12,QBE,Expense,Transport,"Car Insurance, Rego & Maintenance",363.49,0,57695.39,D
1920,678,2022-09-14,Telstra,Expense,Personal,Mobile Phone,404.14,0,57291.25,D
1907,678,2022-09-15,DiDi,Expense,Transport,Taxies & Share Cars,464.72,0,56826.53,D
1912,678,2022-09-18,Hungry Jack's,Expense,Leisure & Lifestyle,Restaurants & Cafes,163.27,0,56663.26,D
1911,678,2022-09-19,Vape Shop,Expense,Leisure & Lifestyle,Tobacco & Vaping,211.54,0,56451.72,D
1919,678,2022-09-19,Mecca,Expense,Personal,Hair & Beauty,339.44,0,56112.28,D
1922,678,2022-09-19,RACV,Expense,Household,Rates & Insurance,232.46,0,55879.82,D
1902,678,2022-09-21,Boost Mobile,Expense,Personal,Mobile Phone,67.19,0,55812.63,D
1916,678,2022-09-21,Wilson Parking,Expense,Transport,Parking,344.19,0,55468.44,D
1906,678,2022-09-22,NIB,Expense,Personal,Health & Medical,379.11,0,55089.33,D
1908,678,2022-09-22,Optus,Expense,Personal,Mobile Phone,236.8,0,54852.53,D
1917,678,2022-09-22,Secure Parking,Expense,Transport,Parking,29.33,0,54823.2,D
1913,678,2022-09-27,Bicycle Network,Expense,Transport,Cycling,63.77,0,54759.43,D
1910,678,2022-09-28,Childcare Center,Expense,Personal,Children & Family,321.91,0,54437.52,D
1923,678,2022-10-01,Salary,Income,Income,Wages,0,8000,62437.52,C
1926,678,2022-10-05,Ticketek,Expense,Leisure & Lifestyle,Events & Gigs,351.24,0,62086.28,D
1925,678,2022-10-06,Mortgage Lender,Expense,Household,Rent & Mortgage,302.35,0,61783.93,D
1929,678,2022-10-10,DoorDash,Expense,Leisure & Lifestyle,Takeaway,43.58,0,61740.35,D
1933,678,2022-10-10,Stock Purchase,Expense,Personal,Investments,786.71,0,60953.64,D
1928,678,2022-10-12,Car Dealership,Expense,Transport,Car Repayments,399.16,0,60554.48,D
1924,678,2022-10-15,Yoga Studio,Expense,Personal,Fitness & Wellbeing,413.68,0,60140.8,D
1939,678,2022-10-15,Online Course Provider,Expense,Personal,Education,488.35,0,59652.45,D
1934,678,2022-10-16,Stan,Expense,Leisure & Lifestyle,"Tv, Music & Streaming",26.85,0,59625.6,D
1938,678,2022-10-17,Bunnings Warehouse,Expense,Household,Maintenance & Improvements,306.33,0,59319.27,D
1940,678,2022-10-17,Online Course Provider,Expense,Personal,Education,419.63,0,58899.64,D
1932,678,2022-10-20,Venmo,Transfer,Transfer,Transfer,337.95,0,58561.69,D
1935,678,2022-10-21,Anytime Fitness,Expense,Personal,Fitness & Wellbeing,325.59,0,58236.1,D
1927,678,2022-10-22,Stock Purchase,Expense,Personal,Investments,787.81,0,57448.29,D
1931,678,2022-10-24,BWS,Expense,Leisure & Lifestyle,Alcohol,109.86,0,57338.43,D
1936,678,2022-10-25,Origin Energy,Expense,Household,Utilities,340.4,0,56998.03,D
1937,678,2022-10-25,Aldi,Expense,Household,Groceries,497.07,0,56500.96,D
1930,678,2022-10-26,RSPCA,Expense,Household,Pets,240.19,0,56260.77,D
1941,678,2022-11-01,Salary,Income,Income,Wages,0,8000,64260.77,C
1956,678,2022-11-02,Sydney Water,Expense,Household,Utilities,285.83,0,63974.94,D
1947,678,2022-11-04,Costco,Expense,Household,Groceries,396.61,0,63578.33,D
1949,678,2022-11-05,Stock Purchase,Expense,Personal,Investments,637.95,0,62940.38,D
1957,678,2022-11-05,Accountant,Expense,Personal,Life Admin,177.59,0,62762.79,D
1954,678,2022-11-07,Fitness First,Expense,Personal,Fitness & Wellbeing,109.01,0,62653.78,D
1952,678,2022-11-08,Apple App Store,Expense,Leisure & Lifestyle,"Apps, Games & Software",204.35,0,62449.43,D
1960,678,2022-11-08,Costco,Expense,Household,Groceries,268.18,0,62181.25,D
1948,678,2022-11-09,Priceline Pharmacy,Expense,Personal,Health & Medical,62.98,0,62118.27,D
1953,678,2022-11-09,Bicycle Network,Expense,Transport,Cycling,317.55,0,61800.72,D
1955,678,2022-11-11,QBE,Expense,Transport,"Car Insurance, Rego & Maintenance",82.0,0,61718.72,D
1958,678,2022-11-12,Lowe's,Expense,Household,Maintenance & Improvements,93.02,0,61625.7,D
1961,678,2022-11-12,Medibank,Expense,Personal,Health & Medical,261.87,0,61363.83,D
1959,678,2022-11-13,Costco,Expense,Household,Groceries,373.13,0,60990.7,D
1943,678,2022-11-15,Tatts,Expense,Leisure & Lifestyle,Lottery & Gambling,28.45,0,60962.25,D
1942,678,2022-11-17,KFC,Expense,Leisure & Lifestyle,Restaurants & Cafes,156.22,0,60806.03,D
1951,678,2022-11-17,Online Course Provider,Expense,Personal,Education,84.88,0,60721.15,D
1944,678,2022-11-19,McDonald's,Expense,Leisure & Lifestyle,Restaurants & Cafes,495.98,0,60225.17,D
1945,678,2022-11-21,QBE,Expense,Household,Rates & Insurance,348.28,0,59876.89,D
1946,678,2022-11-21,Deliveroo,Expense,Leisure & Lifestyle,Takeaway,360.09,0,59516.8,D
1950,678,2022-11-29,Opal Card,Expense,Transport,Public Transport,443.8,0,59073.0,D
1962,678,2022-12-01,Salary,Income,Income,Wages,0,8000,67073.0,C
1977,678,2022-12-02,AGL,Expense,Household,Utilities,347.07,0,66725.93,D
1982,678,2022-12-04,Stock Purchase,Expense,Personal,Investments,343.87,0,66382.06,D
1975,678,2022-12-06,Childcare Center,Expense,Personal,Children & Family,412.7,0,65969.36,D
1964,678,2022-12-08,Bupa,Expense,Personal,Health & Medical,445.96,0,65523.4,D
1970,678,2022-12-08,QBE,Expense,Household,Rates & Insurance,26.7,0,65496.7,D
1989,678,2022-12-09,QBE,Expense,Household,Rates & Insurance,319.71,0,65176.99,D
1990,678,2022-12-10,Sports Equipment Store,Expense,Leisure & Lifestyle,Hobbies,471.14,0,64705.85,D
1973,678,2022-12-11,Yoga Studio,Expense,Personal,Fitness & Wellbeing,55.37,0,64650.48,D
1978,678,2022-12-12,Nail Salon,Expense,Personal,Hair & Beauty,339.82,0,64310.66,D
1966,678,2022-12-13,13cabs,Expense,Transport,Taxies & Share Cars,47.24,0,64263.42,D
1971,678,2022-12-14,Car Loan Provider,Expense,Transport,Car Repayments,450.61,0,63812.81,D
1980,678,2022-12-15,Art Supply Store,Expense,Leisure & Lifestyle,Hobbies,317.46,0,63495.35,D
1984,678,2022-12-15,Stock Purchase,Income,Income,Investments,618.63,0,62876.72,D
1979,678,2022-12-16,Baby Bunting,Expense,Personal,Children & Family,278.83,0,62597.89,D
1969,678,2022-12-20,Myki,Expense,Transport,Public Transport,316.31,0,62281.58,D
1983,678,2022-12-20,Fitness First,Expense,Personal,Fitness & Wellbeing,230.1,0,62051.48,D
1991,678,2022-12-21,Linkt,Expense,Transport,Tolls,21.34,0,62030.14,D
1965,678,2022-12-22,Liquorland,Expense,Leisure & Lifestyle,Alcohol,389.47,0,61640.67,D
1967,678,2022-12-23,RACV,Expense,Household,Rates & Insurance,168.33,0,61472.34,D
1963,678,2022-12-24,Bike Shop,Expense,Transport,Cycling,474.07,0,60998.27,D
1976,678,2022-12-24,Expedia,Expense,Leisure & Lifestyle,Holidays & Travel,149.9,0,60848.37,D
1988,678,2022-12-24,Airbnb,Expense,Leisure & Lifestyle,Holidays & Travel,480.35,0,60368.02,D
1985,678,2022-12-25,BWS,Expense,Leisure & Lifestyle,Alcohol,349.44,0,60018.58,D
1986,678,2022-12-25,Flight Centre,Expense,Leisure & Lifestyle,Holidays & Travel,147.0,0,59871.58,D
1974,678,2022-12-26,Adobe Creative Cloud,Expense,Leisure & Lifestyle,"Apps, Games & Software",265.03,0,59606.55,D
1981,678,2022-12-26,Real Estate Agency,Expense,Household,Rent & Mortgage,444.37,0,59162.18,D
1968,678,2022-12-28,Stock Purchase,Expense,Personal,Investments,500.18,0,58662.0,D
1972,678,2022-12-29,Ticketmaster,Expense,Leisure & Lifestyle,Events & Gigs,238.5,0,58423.5,D
1987,678,2022-12-29,Caltex,Expense,Transport,Fuel,306.62,0,58116.88,D
1992,678,2023-01-01,Salary,Income,Income,Wages,0,8000,66116.88,C
1998,678,2023-01-04,Ola,Expense,Transport,Taxies & Share Cars,269.36,0,65847.52,D
2016,678,2023-01-04,Cocktail Bar,Expense,Leisure & Lifestyle,Pubs & Bars,112.3,0,65735.22,D
1993,678,2023-01-05,Gym Membership,Expense,Personal,Fitness & Wellbeing,147.27,0,65587.95,D
2018,678,2023-01-05,Origin Energy,Expense,Household,Utilities,173.82,0,65414.13,D
2005,678,2023-01-06,Cigarettes,Expense,Leisure & Lifestyle,Tobacco & Vaping,143.43,0,65270.7,D
2020,678,2023-01-06,Music Store,Expense,Leisure & Lifestyle,Hobbies,121.41,0,65149.29,D
1994,678,2023-01-07,Myki,Expense,Transport,Public Transport,332.62,0,64816.67,D
2004,678,2023-01-10,Google Play Store,Expense,Leisure & Lifestyle,"Apps, Games & Software",122.18,0,64694.49,D
1999,678,2023-01-11,GoCatch,Expense,Transport,Taxies & Share Cars,49.97,0,64644.52,D
2014,678,2023-01-11,Steam,Expense,Leisure & Lifestyle,"Apps, Games & Software",372.96,0,64271.56,D
2000,678,2023-01-12,Cigarettes,Expense,Leisure & Lifestyle,Tobacco & Vaping,46.7,0,64224.86,D
2008,678,2023-01-12,Greencross Vets,Expense,Household,Pets,262.07,0,63962.79,D
2013,678,2023-01-12,Booking.com,Expense,Leisure & Lifestyle,Holidays & Travel,292.95,0,63669.84,D
2017,678,2023-01-16,Boost Mobile,Expense,Personal,Mobile Phone,418.17,0,63251.67,D
2012,678,2023-01-18,Local Pub,Expense,Leisure & Lifestyle,Pubs & Bars,91.57,0,63160.1,D
2003,678,2023-01-19,GoCatch,Expense,Transport,Taxies & Share Cars,98.7,0,63061.4,D
2006,678,2023-01-19,Stock Purchase,Expense,Personal,Investments,510.56,0,62550.84,D
1995,678,2023-01-20,Boost Mobile,Expense,Personal,Mobile Phone,471.01,0,62079.83,D
2010,678,2023-01-20,Expedia,Expense,Leisure & Lifestyle,Holidays & Travel,207.98,0,61871.85,D
2011,678,2023-01-22,Costco,Expense,Household,Groceries,273.9,0,61597.95,D
1996,678,2023-01-23,Ola,Expense,Transport,Taxies & Share Cars,264.49,0,61333.46,D
2002,678,2023-01-23,Deliveroo,Expense,Leisure & Lifestyle,Takeaway,484.91,0,60848.55,D
2001,678,2023-01-24,KFC,Expense,Leisure & Lifestyle,Restaurants & Cafes,410.71,0,60437.84,D
2009,678,2023-01-25,Rooftop Bar,Expense,Leisure & Lifestyle,Pubs & Bars,464.31,0,59973.53,D
2019,678,2023-01-25,H&M,Expense,Personal,Clothing & Accessories,400.89,0,59572.64,D
2007,678,2023-01-26,Cigarettes,Expense,Leisure & Lifestyle,Tobacco & Vaping,244.57,0,59328.07,D
1997,678,2023-01-27,Toys R Us,Expense,Personal,Children & Family,346.89,0,58981.18,D
2015,678,2023-01-28,Caltex,Expense,Transport,Fuel,238.14,0,58743.04,D
2021,678,2023-02-01,Salary,Income,Income,Wages,0,8000,66743.04,C
2027,678,2023-02-04,NRMA,Expense,Transport,"Car Insurance, Rego & Maintenance",49.07,0,66693.97,D
2025,678,2023-02-06,City of Melbourne,Expense,Transport,Parking,126.72,0,66567.25,D
2036,678,2023-02-07,Origin Energy,Expense,Household,Utilities,200.69,0,66366.56,D
2035,678,2023-02-08,Aldi,Expense,Household,Groceries,357.27,0,66009.29,D
2028,678,2023-02-09,Baby Bunting,Expense,Personal,Children & Family,362.21,0,65647.08,D
2038,678,2023-02-09,PayPal,Transfer,Transfer,Transfer,248.84,0,65398.24,D
2039,678,2023-02-09,GoFundMe,Expense,Personal,Gifts & Donations,337.71,0,65060.53,D
2032,678,2023-02-11,Vodafone,Expense,Household,Internet,31.93,0,65028.6,D
2042,678,2023-02-13,Sports Equipment Store,Expense,Leisure & Lifestyle,Hobbies,66.97,0,64961.63,D
2023,678,2023-02-17,Flight Centre,Expense,Leisure & Lifestyle,Holidays & Travel,353.51,0,64608.12,D
2022,678,2023-02-18,Post Office,Expense,Personal,Life Admin,37.24,0,64570.88,D
2026,678,2023-02-19,Tutoring Service,Expense,Personal,Education,313.35,0,64257.53,D
2040,678,2023-02-19,Dan Murphy's,Expense,Leisure & Lifestyle,Alcohol,255.31,0,64002.22,D
2033,678,2023-02-20,Vape Shop,Expense,Leisure & Lifestyle,Tobacco & Vaping,167.16,0,63835.06,D
2041,678,2023-02-20,Airbnb,Expense,Leisure & Lifestyle,Holidays & Travel,97.32,0,63737.74,D
2029,678,2023-02-21,Costco,Expense,Household,Groceries,304.73,0,63433.01,D
2037,678,2023-02-22,KFC,Expense,Leisure & Lifestyle,Restaurants & Cafes,221.61,0,63211.4,D
2024,678,2023-02-23,Stock Purchase,Expense,Personal,Investments,327.38,0,62884.02,D
2030,678,2023-02-24,The Lott,Expense,Leisure & Lifestyle,Lottery & Gambling,287.71,0,62596.31,D
2034,678,2023-02-27,Spotify,Expense,Leisure & Lifestyle,"Tv, Music & Streaming",360.97,0,62235.34,D
2031,678,2023-03-01,IKEA,Expense,Household,Maintenance & Improvements,382.12,0,61853.22,D
2043,678,2023-03-01,Salary,Income,Income,Wages,0,8000,69853.22,C
2044,678,2023-03-02,Mecca,Expense,Personal,Hair & Beauty,378.28,0,69474.94,D
2048,678,2023-03-07,Moshtix,Expense,Leisure & Lifestyle,Events & Gigs,370.89,0,69104.05,D
2054,678,2023-03-09,Cocktail Bar,Expense,Leisure & Lifestyle,Pubs & Bars,51.79,0,69052.26,D
2045,678,2023-03-10,McDonald's,Expense,Leisure & Lifestyle,Restaurants & Cafes,352.96,0,68699.3,D
2047,678,2023-03-10,IGA,Expense,Household,Groceries,106.25,0,68593.05,D
2057,678,2023-03-11,Home Depot,Expense,Household,Maintenance & Improvements,201.97,0,68391.08,D
2046,678,2023-03-13,EastLink,Expense,Transport,Tolls,484.33,0,67906.75,D
2055,678,2023-03-14,Stan,Expense,Leisure & Lifestyle,"Tv, Music & Streaming",401.84,0,67504.91,D
2051,678,2023-03-15,Zara,Expense,Personal,Clothing & Accessories,233.49,0,67271.42,D
2056,678,2023-03-16,Sportsbet,Expense,Leisure & Lifestyle,Lottery & Gambling,48.18,0,67223.24,D
2052,678,2023-03-19,City of Melbourne,Expense,Transport,Parking,48.48,0,67174.76,D
2049,678,2023-03-24,Rooftop Bar,Expense,Leisure & Lifestyle,Pubs & Bars,229.95,0,66944.81,D
2050,678,2023-03-26,Netflix,Expense,Leisure & Lifestyle,"Tv, Music & Streaming",448.39,0,66496.42,D
2053,678,2023-03-27,Vape Shop,Expense,Leisure & Lifestyle,Tobacco & Vaping,204.07,0,66292.35,D
2058,678,2023-04-01,Salary,Income,Income,Wages,0,8000,74292.35,C
2073,678,2023-04-04,Adobe Creative Cloud,Expense,Leisure & Lifestyle,"Apps, Games & Software",415.63,0,73876.72,D
2061,678,2023-04-06,DoorDash,Expense,Leisure & Lifestyle,Takeaway,346.3,0,73530.42,D
2062,678,2023-04-12,Tutoring Service,Expense,Personal,Education,52.37,0,73478.05,D
2070,678,2023-04-16,Uniqlo,Expense,Personal,Clothing & Accessories,53.72,0,73424.33,D
2064,678,2023-04-17,Lawyer,Expense,Personal,Life Admin,423.54,0,73000.79,D
2060,678,2023-04-19,Toyota Finance,Expense,Transport,Car Repayments,98.19,0,72902.6,D
2066,678,2023-04-19,Liquorland,Expense,Leisure & Lifestyle,Alcohol,174.33,0,72728.27,D
2069,678,2023-04-19,IKEA,Expense,Household,Maintenance & Improvements,260.92,0,72467.35,D
2074,678,2023-04-21,Sephora,Expense,Personal,Hair & Beauty,309.87,0,72157.48,D
2071,678,2023-04-22,City of Melbourne,Expense,Transport,Parking,421.62,0,71735.86,D
2072,678,2023-04-22,Stock Purchase,Expense,Personal,Investments,786.15,0,70949.71,D
2065,678,2023-04-23,Toyota Finance,Expense,Transport,Car Repayments,466.88,0,70482.83,D
2059,678,2023-04-25,Eventbrite,Expense,Leisure & Lifestyle,Events & Gigs,124.52,0,70358.31,D
2068,678,2023-04-25,Boost Mobile,Expense,Personal,Mobile Phone,380.22,0,69978.09,D
2067,678,2023-04-27,Stock Purchase,Expense,Personal,Investments,938.32,0,69039.77,D
2063,678,2023-04-29,Yoga Studio,Expense,Personal,Fitness & Wellbeing,28.22,0,69011.55,D
2075,678,2023-05-01,Salary,Income,Income,Wages,0,8000,77011.55,C
2082,678,2023-05-02,Netflix,Expense,Leisure & Lifestyle,"Tv, Music & Streaming",77.76,0,76933.79,D
2094,678,2023-05-03,Sportsbet,Expense,Leisure & Lifestyle,Lottery & Gambling,345.24,0,76588.55,D
2081,678,2023-05-05,Charity Organization,Expense,Personal,Gifts & Donations,141.76,0,76446.79,D
2092,678,2023-05-06,Art Supply Store,Expense,Leisure & Lifestyle,Hobbies,332.24,0,76114.55,D
2084,678,2023-05-07,NRMA,Expense,Household,Rates & Insurance,134.29,0,75980.26,D
2080,678,2023-05-09,Ticketek,Expense,Leisure & Lifestyle,Events & Gigs,333.83,0,75646.43,D
2096,678,2023-05-10,KFC,Expense,Leisure & Lifestyle,Restaurants & Cafes,383.16,0,75263.27,D
2083,678,2023-05-11,Cigars,Expense,Leisure & Lifestyle,Tobacco & Vaping,327.79,0,74935.48,D
2099,678,2023-05-11,Fitness First,Expense,Personal,Fitness & Wellbeing,439.19,0,74496.29,D
2090,678,2023-05-13,Cocktail Bar,Expense,Leisure & Lifestyle,Pubs & Bars,310.61,0,74185.68,D
2087,678,2023-05-17,E-Toll,Expense,Transport,Tolls,35.07,0,74150.61,D
2095,678,2023-05-17,Music Store,Expense,Leisure & Lifestyle,Hobbies,76.17,0,74074.44,D
2077,678,2023-05-19,Suncorp,Expense,Transport,"Car Insurance, Rego & Maintenance",207.44,0,73867.0,D
2098,678,2023-05-19,TransLink,Expense,Transport,Public Transport,36.85,0,73830.15,D
2086,678,2023-05-21,Charity Organization,Expense,Personal,Gifts & Donations,234.59,0,73595.56,D
2093,678,2023-05-22,McDonald's,Expense,Leisure & Lifestyle,Restaurants & Cafes,317.66,0,73277.9,D
2079,678,2023-05-23,Art Supply Store,Expense,Leisure & Lifestyle,Hobbies,442.46,0,72835.44,D
2085,678,2023-05-24,NIB,Expense,Personal,Health & Medical,476.44,0,72359.0,D
2089,678,2023-05-26,Domino's Pizza,Expense,Leisure & Lifestyle,Restaurants & Cafes,270.95,0,72088.05,D
2097,678,2023-05-26,Spotify,Expense,Leisure & Lifestyle,"Tv, Music & Streaming",16.73,0,72071.32,D
2078,678,2023-05-27,Sportsbet,Expense,Leisure & Lifestyle,Lottery & Gambling,445.01,0,71626.31,D
2091,678,2023-05-27,Car Loan Provider,Expense,Transport,Car Repayments,489.34,0,71136.97,D
2088,678,2023-05-28,Tatts,Expense,Leisure & Lifestyle,Lottery & Gambling,235.52,0,70901.45,D
2076,678,2023-05-29,Linkt,Expense,Transport,Tolls,414.46,0,70486.99,D
2100,678,2023-06-01,Salary,Income,Income,Wages,0,8000,78486.99,C
2102,678,2023-06-02,Landlord,Expense,Household,Rent & Mortgage,301.07,0,78185.92,D
2122,678,2023-06-02,Expedia,Expense,Leisure & Lifestyle,Holidays & Travel,492.3,0,77693.62,D
2117,678,2023-06-03,Priceline Pharmacy,Expense,Personal,Health & Medical,454.42,0,77239.2,D
2106,678,2023-06-05,Music Store,Expense,Leisure & Lifestyle,Hobbies,116.94,0,77122.26,D
2107,678,2023-06-05,H&M,Expense,Personal,Clothing & Accessories,52.89,0,77069.37,D
2108,678,2023-06-05,Flight Centre,Expense,Leisure & Lifestyle,Holidays & Travel,190.4,0,76878.97,D
2109,678,2023-06-06,Accountant,Expense,Personal,Life Admin,347.22,0,76531.75,D
2121,678,2023-06-06,Zara,Expense,Personal,Clothing & Accessories,145.39,0,76386.36,D
2104,678,2023-06-07,Petbarn,Expense,Household,Pets,400.19,0,75986.17,D
2115,678,2023-06-07,Apple Music,Expense,Leisure & Lifestyle,"Tv, Music & Streaming",228.3,0,75757.87,D
2118,678,2023-06-07,H&M,Expense,Personal,Clothing & Accessories,173.44,0,75584.43,D
2112,678,2023-06-10,CityLink,Expense,Transport,Tolls,325.27,0,75259.16,D
2111,678,2023-06-11,Stock Purchase,Income,Income,Investments,201.87,0,75057.29,D
2123,678,2023-06-12,TAB,Expense,Leisure & Lifestyle,Lottery & Gambling,343.16,0,74714.13,D
2124,678,2023-06-13,Fitness First,Expense,Personal,Fitness & Wellbeing,16.69,0,74697.44,D
2120,678,2023-06-14,University,Expense,Personal,Education,426.8,0,74270.64,D
2119,678,2023-06-16,Birthday Gift,Expense,Personal,Gifts & Donations,201.17,0,74069.47,D
2116,678,2023-06-17,Origin Energy,Expense,Household,Utilities,346.51,0,73722.96,D
2103,678,2023-06-18,BWS,Expense,Leisure & Lifestyle,Alcohol,435.36,0,73287.6,D
2114,678,2023-06-22,Sportsbet,Expense,Leisure & Lifestyle,Lottery & Gambling,420.33,0,72867.27,D
2113,678,2023-06-25,Birthday Gift,Expense,Personal,Gifts & Donations,299.16,0,72568.11,D
2105,678,2023-06-27,Linkt,Expense,Transport,Tolls,311.44,0,72256.67,D
2101,678,2023-06-28,Bunnings Warehouse,Expense,Household,Maintenance & Improvements,199.62,0,72057.05,D
2110,678,2023-06-29,Lowe's,Expense,Household,Maintenance & Improvements,309.07,0,71747.98,D
2125,678,2023-07-01,Salary,Income,Income,Wages,0,8000,79747.98,C
2128,678,2023-07-02,QBE,Expense,Household,Rates & Insurance,122.32,0,79625.66,D
2132,678,2023-07-03,13cabs,Expense,Transport,Taxies & Share Cars,45.4,0,79580.26,D
2149,678,2023-07-04,Chemist Warehouse,Expense,Personal,Health & Medical,41.75,0,79538.51,D
2130,678,2023-07-05,Local Pub,Expense,Leisure & Lifestyle,Pubs & Bars,45.8,0,79492.71,D
2139,678,2023-07-05,Childcare Center,Expense,Personal,Children & Family,385.6,0,79107.11,D
2146,678,2023-07-05,BWS,Expense,Leisure & Lifestyle,Alcohol,126.19,0,78980.92,D
2141,678,2023-07-06,Cycling Apparel Store,Expense,Transport,Cycling,83.81,0,78897.11,D
2150,678,2023-07-07,Secure Parking,Expense,Transport,Parking,97.07,0,78800.04,D
2152,678,2023-07-11,7-Eleven,Expense,Transport,Fuel,14.36,0,78785.68,D
2140,678,2023-07-12,Local Pub,Expense,Leisure & Lifestyle,Pubs & Bars,115.8,0,78669.88,D
2145,678,2023-07-12,Yoga Studio,Expense,Personal,Fitness & Wellbeing,48.75,0,78621.13,D
2126,678,2023-07-13,Hobby Store,Expense,Leisure & Lifestyle,Hobbies,398.77,0,78222.36,D
2136,678,2023-07-13,BWS,Expense,Leisure & Lifestyle,Alcohol,47.27,0,78175.09,D
2137,678,2023-07-16,KFC,Expense,Leisure & Lifestyle,Restaurants & Cafes,70.7,0,78104.39,D
2147,678,2023-07-16,Hobby Store,Expense,Leisure & Lifestyle,Hobbies,381.57,0,77722.82,D
2148,678,2023-07-16,UberEats,Expense,Leisure & Lifestyle,Takeaway,117.5,0,77605.32,D
2142,678,2023-07-17,Flight Centre,Expense,Leisure & Lifestyle,Holidays & Travel,402.0,0,77203.32,D
2153,678,2023-07-17,Boost Mobile,Expense,Personal,Mobile Phone,318.62,0,76884.7,D
2134,678,2023-07-18,Tutoring Service,Expense,Personal,Education,162.59,0,76722.11,D
2144,678,2023-07-18,QBE,Expense,Transport,"Car Insurance, Rego & Maintenance",313.86,0,76408.25,D
2131,678,2023-07-19,Aldi,Expense,Household,Groceries,216.52,0,76191.73,D
2135,678,2023-07-19,BP,Expense,Transport,Fuel,289.51,0,75902.22,D
2151,678,2023-07-20,YouTube Premium,Expense,Leisure & Lifestyle,"Tv, Music & Streaming",246.8,0,75655.42,D
2127,678,2023-07-21,Google Play Store,Expense,Leisure & Lifestyle,"Apps, Games & Software",347.61,0,75307.81,D
2133,678,2023-07-22,BP,Expense,Transport,Fuel,193.18,0,75114.63,D
2138,678,2023-07-22,Domino's Pizza,Expense,Leisure & Lifestyle,Restaurants & Cafes,328.19,0,74786.44,D
2143,678,2023-07-26,Ola,Expense,Transport,Taxies & Share Cars,242.47,0,74543.97,D
2129,678,2023-07-28,Tobacco Store,Expense,Leisure & Lifestyle,Tobacco & Vaping,188.16,0,74355.81,D
2154,678,2023-08-01,Salary,Income,Income,Wages,0,8000,82355.81,C
2164,678,2023-08-02,Stock Purchase,Income,Income,Investments,216.82,0,82138.99,D
2160,678,2023-08-04,Hobby Store,Expense,Leisure & Lifestyle,Hobbies,218.24,0,81920.75,D
2172,678,2023-08-04,BWS,Expense,Leisure & Lifestyle,Alcohol,126.52,0,81794.23,D
2176,678,2023-08-05,Spotify,Expense,Leisure & Lifestyle,"Tv, Music & Streaming",259.62,0,81534.61,D
2165,678,2023-08-06,Birthday Gift,Expense,Personal,Gifts & Donations,422.11,0,81112.5,D
2157,678,2023-08-07,Accountant,Expense,Personal,Life Admin,470.3,0,80642.2,D
2159,678,2023-08-08,Cocktail Bar,Expense,Leisure & Lifestyle,Pubs & Bars,311.2,0,80331.0,D
2162,678,2023-08-10,Childcare Center,Expense,Personal,Children & Family,418.59,0,79912.41,D
2178,678,2023-08-11,IKEA,Expense,Household,Maintenance & Improvements,263.09,0,79649.32,D
2179,678,2023-08-11,Suncorp,Expense,Household,Rates & Insurance,413.81,0,79235.51,D
2161,678,2023-08-13,Online Course Provider,Expense,Personal,Education,20.64,0,79214.87,D
2168,678,2023-08-13,Cycling Apparel Store,Expense,Transport,Cycling,13.28,0,79201.59,D
2173,678,2023-08-13,Sportsbet,Expense,Leisure & Lifestyle,Lottery & Gambling,164.34,0,79037.25,D
2175,678,2023-08-14,Landlord,Expense,Household,Rent & Mortgage,294.52,0,78742.73,D
2167,678,2023-08-17,Stock Purchase,Expense,Personal,Investments,971.33,0,77771.4,D
2177,678,2023-08-19,Netflix,Expense,Leisure & Lifestyle,"Tv, Music & Streaming",483.58,0,77287.82,D
2170,678,2023-08-20,Birthday Gift,Expense,Personal,Gifts & Donations,230.12,0,77057.7,D
2163,678,2023-08-23,BWS,Expense,Leisure & Lifestyle,Alcohol,17.83,0,77039.87,D
2174,678,2023-08-24,Baby Bunting,Expense,Personal,Children & Family,459.62,0,76580.25,D
2171,678,2023-08-25,Deliveroo,Expense,Leisure & Lifestyle,Takeaway,487.41,0,76092.84,D
2156,678,2023-08-26,Lowe's,Expense,Household,Maintenance & Improvements,166.15,0,75926.69,D
2158,678,2023-08-26,Stock Purchase,Expense,Personal,Investments,665.72,0,75260.97,D
2169,678,2023-08-26,Stock Purchase,Income,Income,Investments,307.38,0,74953.59,D
2155,678,2023-08-28,Telstra,Expense,Personal,Mobile Phone,372.75,0,74580.84,D
2166,678,2023-08-29,BP,Expense,Transport,Fuel,498.57,0,74082.27,D
2180,678,2023-09-01,Salary,Income,Income,Wages,0,8000,82082.27,C
2181,678,2023-09-02,Optus,Expense,Household,Internet,11.3,0,82070.97,D
2186,678,2023-09-02,Optus,Expense,Personal,Mobile Phone,340.77,0,81730.2,D
2187,678,2023-09-02,Real Estate Agency,Expense,Household,Rent & Mortgage,198.11,0,81532.09,D
2191,678,2023-09-02,Bike Shop,Expense,Transport,Cycling,128.38,0,81403.71,D
2195,678,2023-09-03,GoCatch,Expense,Transport,Taxies & Share Cars,489.61,0,80914.1,D
2199,678,2023-09-03,Cycling Apparel Store,Expense,Transport,Cycling,144.61,0,80769.49,D
2206,678,2023-09-04,EastLink,Expense,Transport,Tolls,311.36,0,80458.13,D
2198,678,2023-09-05,Childcare Center,Expense,Personal,Children & Family,266.43,0,80191.7,D
2208,678,2023-09-08,Costco,Expense,Household,Groceries,53.29,0,80138.41,D
2194,678,2023-09-09,Petbarn,Expense,Household,Pets,411.4,0,79727.01,D
2205,678,2023-09-09,Eventbrite,Expense,Leisure & Lifestyle,Events & Gigs,208.92,0,79518.09,D
2190,678,2023-09-10,Rooftop Bar,Expense,Leisure & Lifestyle,Pubs & Bars,357.86,0,79160.23,D
2189,678,2023-09-13,Birthday Gift,Expense,Personal,Gifts & Donations,97.33,0,79062.9,D
2196,678,2023-09-13,Cigarettes,Expense,Leisure & Lifestyle,Tobacco & Vaping,246.74,0,78816.16,D
2182,678,2023-09-14,Bank Transfer,Transfer,Transfer,Transfer,381.29,0,78434.87,D
2197,678,2023-09-18,Boost Mobile,Expense,Personal,Mobile Phone,485.99,0,77948.88,D
2207,678,2023-09-18,Stock Purchase,Expense,Personal,Investments,617.31,0,77331.57,D
2183,678,2023-09-19,First Choice Liquor,Expense,Leisure & Lifestyle,Alcohol,164.2,0,77167.37,D
2202,678,2023-09-19,Bank Transfer,Transfer,Transfer,Transfer,75.02,0,77092.35,D
2204,678,2023-09-20,13cabs,Expense,Transport,Taxies & Share Cars,298.8,0,76793.55,D
2192,678,2023-09-21,Crown Casino,Expense,Leisure & Lifestyle,Lottery & Gambling,279.87,0,76513.68,D
2200,678,2023-09-21,Bicycle Network,Expense,Transport,Cycling,303.85,0,76209.83,D
2184,678,2023-09-25,Linkt,Expense,Transport,Tolls,64.73,0,76145.1,D
2193,678,2023-09-25,7-Eleven,Expense,Transport,Fuel,89.26,0,76055.84,D
2203,678,2023-09-25,Apple App Store,Expense,Leisure & Lifestyle,"Apps, Games & Software",340.25,0,75715.59,D
2188,678,2023-09-28,Sydney Water,Expense,Household,Utilities,370.87,0,75344.72,D
2201,678,2023-09-28,Caltex,Expense,Transport,Fuel,366.59,0,74978.13,D
2185,678,2023-09-29,Eventbrite,Expense,Leisure & Lifestyle,Events & Gigs,414.42,0,74563.71,D
2209,678,2023-10-01,Salary,Income,Income,Wages,0,8000,82563.71,C
2210,678,2023-10-09,Adobe Creative Cloud,Expense,Leisure & Lifestyle,"Apps, Games & Software",270.51,0,82293.2,D
2212,678,2023-10-10,City of Melbourne,Expense,Transport,Parking,380.11,0,81913.09,D
2214,678,2023-10-10,Mecca,Expense,Personal,Hair & Beauty,399.64,0,81513.45,D
2213,678,2023-10-12,MAC Cosmetics,Expense,Personal,Hair & Beauty,335.92,0,81177.53,D
2218,678,2023-10-17,Origin Energy,Expense,Household,Utilities,253.79,0,80923.74,D
2211,678,2023-10-21,Apple App Store,Expense,Leisure & Lifestyle,"Apps, Games & Software",250.89,0,80672.85,D
2217,678,2023-10-27,McDonald's,Expense,Leisure & Lifestyle,Restaurants & Cafes,13.4,0,80659.45,D
2216,678,2023-10-28,Gym Membership,Expense,Personal,Fitness & Wellbeing,38.21,0,80621.24,D
2215,678,2023-10-29,University,Expense,Personal,Education,196.06,0,80425.18,D
2219,678,2023-11-01,Salary,Income,Income,Wages,0,8000,88425.18,C
2221,678,2023-11-02,Priceline Pharmacy,Expense,Personal,Health & Medical,259.63,0,88165.55,D
2231,678,2023-11-02,Bank Transfer,Transfer,Transfer,Transfer,283.12,0,87882.43,D
2238,678,2023-11-03,Hobby Store,Expense,Leisure & Lifestyle,Hobbies,52.57,0,87829.86,D
2230,678,2023-11-04,Petbarn,Expense,Household,Pets,233.84,0,87596.02,D
2237,678,2023-11-04,Charity Organization,Expense,Personal,Gifts & Donations,329.01,0,87267.01,D
2222,678,2023-11-05,Mortgage Lender,Expense,Household,Rent & Mortgage,198.83,0,87068.18,D
2225,678,2023-11-05,Cigars,Expense,Leisure & Lifestyle,Tobacco & Vaping,376.15,0,86692.03,D
2240,678,2023-11-09,The Iconic,Expense,Personal,Clothing & Accessories,149.18,0,86542.85,D
2235,678,2023-11-10,Uniqlo,Expense,Personal,Clothing & Accessories,321.04,0,86221.81,D
2234,678,2023-11-12,H&M,Expense,Personal,Clothing & Accessories,147.92,0,86073.89,D
2224,678,2023-11-14,PetSmart,Expense,Household,Pets,211.65,0,85862.24,D
2227,678,2023-11-15,Venmo,Transfer,Transfer,Transfer,428.38,0,85433.86,D
2228,678,2023-11-17,Tutoring Service,Expense,Personal,Education,155.78,0,85278.08,D
2223,678,2023-11-19,Vape Shop,Expense,Leisure & Lifestyle,Tobacco & Vaping,420.9,0,84857.18,D
2229,678,2023-11-20,Adobe Creative Cloud,Expense,Leisure & Lifestyle,"Apps, Games & Software",452.59,0,84404.59,D
2233,678,2023-11-20,Landlord,Expense,Household,Rent & Mortgage,299.67,0,84104.92,D
2220,678,2023-11-22,Suncorp,Expense,Transport,"Car Insurance, Rego & Maintenance",481.79,0,83623.13,D
2241,678,2023-11-24,Domino's Pizza,Expense,Leisure & Lifestyle,Restaurants & Cafes,39.43,0,83583.7,D
2232,678,2023-11-25,Hungry Jack's,Expense,Leisure & Lifestyle,Restaurants & Cafes,383.56,0,83200.14,D
2236,678,2023-11-26,RACV,Expense,Household,Rates & Insurance,99.65,0,83100.49,D
2226,678,2023-11-29,City of Melbourne,Expense,Transport,Parking,172.19,0,82928.3,D
2239,678,2023-11-29,Hair Salon,Expense,Personal,Hair & Beauty,490.15,0,82438.15,D
2242,678,2023-11-29,Woolworths,Expense,Household,Groceries,62.82,0,82375.33,D
2243,678,2023-12-01,Salary,Income,Income,Wages,0,8000,90375.33,C
2258,678,2023-12-04,Netflix,Expense,Leisure & Lifestyle,"Tv, Music & Streaming",22.49,0,90352.84,D
2244,678,2023-12-06,Subway,Expense,Leisure & Lifestyle,Restaurants & Cafes,131.77,0,90221.07,D
2251,678,2023-12-06,Subway,Expense,Leisure & Lifestyle,Restaurants & Cafes,376.57,0,89844.5,D
2249,678,2023-12-08,Baby Bunting,Expense,Personal,Children & Family,108.56,0,89735.94,D
2254,678,2023-12-08,Stock Purchase,Expense,Personal,Investments,934.03,0,88801.91,D
2248,678,2023-12-11,AGL,Expense,Household,Utilities,196.08,0,88605.83,D
2256,678,2023-12-14,DiDi,Expense,Transport,Taxies & Share Cars,451.23,0,88154.6,D
2259,678,2023-12-15,Tutoring Service,Expense,Personal,Education,428.83,0,87725.77,D
2252,678,2023-12-16,BWS,Expense,Leisure & Lifestyle,Alcohol,106.37,0,87619.4,D
2253,678,2023-12-19,CityLink,Expense,Transport,Tolls,47.91,0,87571.49,D
2246,678,2023-12-22,First Choice Liquor,Expense,Leisure & Lifestyle,Alcohol,399.03,0,87172.46,D
2245,678,2023-12-26,CityLink,Expense,Transport,Tolls,334.78,0,86837.68,D
2247,678,2023-12-27,Woolworths,Expense,Household,Groceries,26.9,0,86810.78,D
2250,678,2023-12-27,MAC Cosmetics,Expense,Personal,Hair & Beauty,435.39,0,86375.39,D
2255,678,2023-12-29,Rooftop Bar,Expense,Leisure & Lifestyle,Pubs & Bars,253.76,0,86121.63,D
2257,678,2023-12-29,Accountant,Expense,Personal,Life Admin,33.7,0,86087.93,D
2260,678,2023-12-29,Telstra,Expense,Household,Internet,145.61,0,85942.32,D
2261,369,2021-01-01,Salary,Income,Income,Wages,0,8000,8000,C
2267,369,2021-01-04,Rooftop Bar,Expense,Leisure & Lifestyle,Pubs & Bars,22.27,0,7977.73,D
2265,369,2021-01-05,Toys R Us,Expense,Personal,Children & Family,313.04,0,7664.69,D
2271,369,2021-01-05,Music Store,Expense,Leisure & Lifestyle,Hobbies,23.97,0,7640.72,D
2262,369,2021-01-10,Tobacco Store,Expense,Leisure & Lifestyle,Tobacco & Vaping,313.15,0,7327.57,D
2268,369,2021-01-14,Chemist Warehouse,Expense,Personal,Health & Medical,471.48,0,6856.09,D
2263,369,2021-01-15,Ticketmaster,Expense,Leisure & Lifestyle,Events & Gigs,320.96,0,6535.13,D
2272,369,2021-01-16,QBE,Expense,Transport,"Car Insurance, Rego & Maintenance",422.34,0,6112.79,D
2266,369,2021-01-20,Art Supply Store,Expense,Leisure & Lifestyle,Hobbies,459.26,0,5653.53,D
2264,369,2021-01-22,Zara,Expense,Personal,Clothing & Accessories,352.3,0,5301.23,D
2269,369,2021-01-29,DiDi,Expense,Transport,Taxies & Share Cars,405.35,0,4895.88,D
2270,369,2021-01-29,Printing Service,Expense,Personal,Life Admin,33.19,0,4862.69,D
2273,369,2021-02-01,Salary,Income,Income,Wages,0,8000,12862.69,C
2293,369,2021-02-03,Childcare Center,Expense,Personal,Children & Family,319.7,0,12542.99,D
2278,369,2021-02-04,7-Eleven,Expense,Transport,Fuel,242.05,0,12300.94,D
2289,369,2021-02-04,University,Expense,Personal,Education,233.24,0,12067.7,D
2291,369,2021-02-04,Home Depot,Expense,Household,Maintenance & Improvements,211.2,0,11856.5,D
2292,369,2021-02-04,Apple App Store,Expense,Leisure & Lifestyle,"Apps, Games & Software",276.73,0,11579.77,D
2287,369,2021-02-07,AGL,Expense,Household,Utilities,451.23,0,11128.54,D
2282,369,2021-02-08,Stock Purchase,Expense,Personal,Investments,870.16,0,10258.38,D
2279,369,2021-02-13,Petbarn,Expense,Household,Pets,241.89,0,10016.49,D
2286,369,2021-02-15,Venmo,Transfer,Transfer,Transfer,361.22,0,9655.27,D
2283,369,2021-02-16,Stock Purchase,Income,Income,Investments,740.88,0,8914.39,D
2275,369,2021-02-19,Toys R Us,Expense,Personal,Children & Family,191.36,0,8723.03,D
2276,369,2021-02-20,University,Expense,Personal,Education,314.15,0,8408.88,D
2281,369,2021-02-21,Liquorland,Expense,Leisure & Lifestyle,Alcohol,266.73,0,8142.15,D
2285,369,2021-02-21,Lawyer,Expense,Personal,Life Admin,193.37,0,7948.78,D
2288,369,2021-02-21,GoCatch,Expense,Transport,Taxies & Share Cars,470.28,0,7478.5,D
2277,369,2021-02-22,Rooftop Bar,Expense,Leisure & Lifestyle,Pubs & Bars,445.49,0,7033.01,D
2290,369,2021-02-23,EastLink,Expense,Transport,Tolls,421.42,0,6611.59,D
2274,369,2021-02-25,YouTube Premium,Expense,Leisure & Lifestyle,"Tv, Music & Streaming",425.55,0,6186.04,D
2284,369,2021-02-25,McDonald's,Expense,Leisure & Lifestyle,Restaurants & Cafes,43.62,0,6142.42,D
2280,369,2021-02-28,Optus,Expense,Household,Internet,369.75,0,5772.67,D
2294,369,2021-03-01,Salary,Income,Income,Wages,0,8000,13772.67,C
2300,369,2021-03-03,Car Loan Provider,Expense,Transport,Car Repayments,88.14,0,13684.53,D
2302,369,2021-03-05,UberEats,Expense,Leisure & Lifestyle,Takeaway,293.5,0,13391.03,D
2297,369,2021-03-09,Stock Purchase,Income,Income,Investments,485.31,0,12905.72,D
2295,369,2021-03-11,Car Dealership,Expense,Transport,Car Repayments,76.62,0,12829.1,D
2298,369,2021-03-12,Childcare Center,Expense,Personal,Children & Family,311.01,0,12518.09,D
2299,369,2021-03-13,Anytime Fitness,Expense,Personal,Fitness & Wellbeing,186.41,0,12331.68,D
2308,369,2021-03-13,McDonald's,Expense,Leisure & Lifestyle,Restaurants & Cafes,62.97,0,12268.71,D
2307,369,2021-03-16,Stock Purchase,Income,Income,Investments,863.99,0,11404.72,D
2303,369,2021-03-18,Vodafone,Expense,Personal,Mobile Phone,56.38,0,11348.34,D
2296,369,2021-03-21,UberEats,Expense,Leisure & Lifestyle,Takeaway,265.86,0,11082.48,D
2305,369,2021-03-21,H&M,Expense,Personal,Clothing & Accessories,387.21,0,10695.27,D
2306,369,2021-03-21,GoFundMe,Expense,Personal,Gifts & Donations,233.19,0,10462.08,D
2309,369,2021-03-22,Ticketmaster,Expense,Leisure & Lifestyle,Events & Gigs,251.06,0,10211.02,D
2304,369,2021-03-25,Optus,Expense,Household,Internet,169.3,0,10041.72,D
2310,369,2021-03-25,PayPal,Transfer,Transfer,Transfer,162.64,0,9879.08,D
2301,369,2021-03-28,Optus,Expense,Personal,Mobile Phone,249.55,0,9629.53,D
2311,369,2021-04-01,Salary,Income,Income,Wages,0,8000,17629.53,C
2329,369,2021-04-02,KFC,Expense,Leisure & Lifestyle,Restaurants & Cafes,470.92,0,17158.61,D
2334,369,2021-04-02,Ola,Expense,Transport,Taxies & Share Cars,48.84,0,17109.77,D
2316,369,2021-04-03,Stock Purchase,Expense,Personal,Investments,422.99,0,16686.78,D
2322,369,2021-04-03,Ola,Expense,Transport,Taxies & Share Cars,379.96,0,16306.82,D
2324,369,2021-04-03,Suncorp,Expense,Household,Rates & Insurance,80.5,0,16226.32,D
2330,369,2021-04-03,Opal Card,Expense,Transport,Public Transport,165.47,0,16060.85,D
2321,369,2021-04-04,KFC,Expense,Leisure & Lifestyle,Restaurants & Cafes,205.05,0,15855.8,D
2335,369,2021-04-04,Nail Salon,Expense,Personal,Hair & Beauty,26.21,0,15829.59,D
2332,369,2021-04-06,Woolworths,Expense,Household,Groceries,45.2,0,15784.39,D
2320,369,2021-04-10,Music Store,Expense,Leisure & Lifestyle,Hobbies,95.84,0,15688.55,D
2333,369,2021-04-10,Birthday Gift,Expense,Personal,Gifts & Donations,418.25,0,15270.3,D
2312,369,2021-04-13,Toys R Us,Expense,Personal,Children & Family,456.51,0,14813.79,D
2313,369,2021-04-15,Menulog,Expense,Leisure & Lifestyle,Takeaway,225.77,0,14588.02,D
2337,369,2021-04-17,TAB,Expense,Leisure & Lifestyle,Lottery & Gambling,387.21,0,14200.81,D
2327,369,2021-04-19,Booking.com,Expense,Leisure & Lifestyle,Holidays & Travel,408.16,0,13792.65,D
2314,369,2021-04-21,Stock Purchase,Expense,Personal,Investments,774.7,0,13017.95,D
2328,369,2021-04-21,Chemist Warehouse,Expense,Personal,Health & Medical,158.17,0,12859.78,D
2319,369,2021-04-22,GoFundMe,Expense,Personal,Gifts & Donations,240.08,0,12619.7,D
2317,369,2021-04-24,Stock Purchase,Expense,Personal,Investments,782.17,0,11837.53,D
2340,369,2021-04-24,Tutoring Service,Expense,Personal,Education,325.7,0,11511.83,D
2338,369,2021-04-25,Aldi,Expense,Household,Groceries,58.77,0,11453.06,D
2339,369,2021-04-25,Linkt,Expense,Transport,Tolls,425.85,0,11027.21,D
2331,369,2021-04-26,Stock Purchase,Income,Income,Investments,215.67,0,10811.54,D
2318,369,2021-04-27,Printing Service,Expense,Personal,Life Admin,175.3,0,10636.24,D
2325,369,2021-04-27,Stock Purchase,Expense,Personal,Investments,864.51,0,9771.73,D
2336,369,2021-04-27,Telstra,Expense,Household,Internet,402.46,0,9369.27,D
2323,369,2021-04-28,Lawyer,Expense,Personal,Life Admin,427.72,0,8941.55,D
2326,369,2021-04-28,iiNet,Expense,Household,Internet,375.01,0,8566.54,D
2315,369,2021-04-29,GoFundMe,Expense,Personal,Gifts & Donations,92.17,0,8474.37,D
2341,369,2021-05-01,Salary,Income,Income,Wages,0,8000,16474.37,C
2350,369,2021-05-05,Tatts,Expense,Leisure & Lifestyle,Lottery & Gambling,258.53,0,16215.84,D
2343,369,2021-05-07,Subway,Expense,Leisure & Lifestyle,Restaurants & Cafes,370.23,0,15845.61,D
2346,369,2021-05-07,Childcare Center,Expense,Personal,Children & Family,313.86,0,15531.75,D
2349,369,2021-05-08,Caltex,Expense,Transport,Fuel,447.71,0,15084.04,D
2351,369,2021-05-09,Costco,Expense,Household,Groceries,370.83,0,14713.21,D
2347,369,2021-05-10,Bank Transfer,Transfer,Transfer,Transfer,229.62,0,14483.59,D
2353,369,2021-05-20,Linkt,Expense,Transport,Tolls,272.82,0,14210.77,D
2348,369,2021-05-22,Eventbrite,Expense,Leisure & Lifestyle,Events & Gigs,82.38,0,14128.39,D
2345,369,2021-05-24,Ola,Expense,Transport,Taxies & Share Cars,495.3,0,13633.09,D
2352,369,2021-05-25,NRMA,Expense,Household,Rates & Insurance,395.86,0,13237.23,D
2342,369,2021-05-28,BWS,Expense,Leisure & Lifestyle,Alcohol,485.82,0,12751.41,D
2344,369,2021-05-29,Sydney Water,Expense,Household,Utilities,472.56,0,12278.85,D
2354,369,2021-06-01,Salary,Income,Income,Wages,0,8000,20278.85,C
2373,369,2021-06-02,Car Dealership,Expense,Transport,Car Repayments,162.03,0,20116.82,D
2372,369,2021-06-03,Cigarettes,Expense,Leisure & Lifestyle,Tobacco & Vaping,169.7,0,19947.12,D
2380,369,2021-06-03,Rooftop Bar,Expense,Leisure & Lifestyle,Pubs & Bars,167.14,0,19779.98,D
2378,369,2021-06-04,Google Play Store,Expense,Leisure & Lifestyle,"Apps, Games & Software",180.54,0,19599.44,D
2370,369,2021-06-08,Stock Purchase,Income,Income,Investments,399.04,0,19200.4,D
2375,369,2021-06-08,Childcare Center,Expense,Personal,Children & Family,454.14,0,18746.26,D
2357,369,2021-06-09,Childcare Center,Expense,Personal,Children & Family,57.82,0,18688.44,D
2371,369,2021-06-09,IGA,Expense,Household,Groceries,12.43,0,18676.01,D
2360,369,2021-06-12,YouTube Premium,Expense,Leisure & Lifestyle,"Tv, Music & Streaming",207.02,0,18468.99,D
2362,369,2021-06-12,Netflix,Expense,Leisure & Lifestyle,"Tv, Music & Streaming",65.61,0,18403.38,D
2366,369,2021-06-12,Yoga Studio,Expense,Personal,Fitness & Wellbeing,70.35,0,18333.03,D
2364,369,2021-06-13,Qantas,Expense,Leisure & Lifestyle,Holidays & Travel,164.38,0,18168.65,D
2379,369,2021-06-14,Venmo,Transfer,Transfer,Transfer,444.02,0,17724.63,D
2359,369,2021-06-15,Expedia,Expense,Leisure & Lifestyle,Holidays & Travel,352.09,0,17372.54,D
2363,369,2021-06-15,7-Eleven,Expense,Transport,Fuel,478.97,0,16893.57,D
2355,369,2021-06-16,Cigarettes,Expense,Leisure & Lifestyle,Tobacco & Vaping,198.59,0,16694.98,D
2361,369,2021-06-19,Gym Membership,Expense,Personal,Fitness & Wellbeing,366.07,0,16328.91,D
2358,369,2021-06-20,Amaysim,Expense,Personal,Mobile Phone,426.81,0,15902.1,D
2369,369,2021-06-22,RACV,Expense,Household,Rates & Insurance,127.74,0,15774.36,D
2356,369,2021-06-25,PayPal,Transfer,Transfer,Transfer,435.16,0,15339.2,D
2376,369,2021-06-26,BWS,Expense,Leisure & Lifestyle,Alcohol,410.32,0,14928.88,D
2365,369,2021-06-27,Stock Purchase,Income,Income,Investments,991.41,0,13937.47,D
2368,369,2021-06-28,Lowe's,Expense,Household,Maintenance & Improvements,238.45,0,13699.02,D
2377,369,2021-06-28,EnergyAustralia,Expense,Household,Utilities,494.35,0,13204.67,D
2367,369,2021-06-29,Mortgage Lender,Expense,Household,Rent & Mortgage,300.15,0,12904.52,D
2374,369,2021-06-29,Hobby Store,Expense,Leisure & Lifestyle,Hobbies,214.06,0,12690.46,D
2381,369,2021-07-01,Salary,Income,Income,Wages,0,8000,20690.46,C
2386,369,2021-07-02,Childcare Center,Expense,Personal,Children & Family,103.65,0,20586.81,D
2387,369,2021-07-03,Ola,Expense,Transport,Taxies & Share Cars,291.8,0,20295.01,D
2388,369,2021-07-03,Hungry Jack's,Expense,Leisure & Lifestyle,Restaurants & Cafes,409.49,0,19885.52,D
2389,369,2021-07-03,University,Expense,Personal,Education,497.31,0,19388.21,D
2394,369,2021-07-03,RACV,Expense,Transport,"Car Insurance, Rego & Maintenance",175.5,0,19212.71,D
2385,369,2021-07-06,Zara,Expense,Personal,Clothing & Accessories,109.87,0,19102.84,D
2391,369,2021-07-09,Coles,Expense,Household,Groceries,90.65,0,19012.19,D
2395,369,2021-07-09,Myki,Expense,Transport,Public Transport,360.2,0,18651.99,D
2397,369,2021-07-10,Netflix,Expense,Leisure & Lifestyle,"Tv, Music & Streaming",116.19,0,18535.8,D
2396,369,2021-07-11,Home Depot,Expense,Household,Maintenance & Improvements,16.53,0,18519.27,D
2384,369,2021-07-16,Car Dealership,Expense,Transport,Car Repayments,242.01,0,18277.26,D
2390,369,2021-07-19,Apple Music,Expense,Leisure & Lifestyle,"Tv, Music & Streaming",281.82,0,17995.44,D
2392,369,2021-07-23,Stock Purchase,Income,Income,Investments,843.58,0,17151.86,D
2382,369,2021-07-24,Stock Purchase,Income,Income,Investments,550.83,0,16601.03,D
2383,369,2021-07-27,Landlord,Expense,Household,Rent & Mortgage,357.03,0,16244.0,D
2393,369,2021-07-27,Hungry Jack's,Expense,Leisure & Lifestyle,Restaurants & Cafes,251.46,0,15992.54,D
2398,369,2021-08-01,Salary,Income,Income,Wages,0,8000,23992.54,C
2404,369,2021-08-04,Mortgage Lender,Expense,Household,Rent & Mortgage,126.09,0,23866.45,D
2414,369,2021-08-04,BWS,Expense,Leisure & Lifestyle,Alcohol,479.56,0,23386.89,D
2399,369,2021-08-05,Venmo,Transfer,Transfer,Transfer,312.56,0,23074.33,D
2406,369,2021-08-05,Bicycle Network,Expense,Transport,Cycling,352.19,0,22722.14,D
2413,369,2021-08-05,Accountant,Expense,Personal,Life Admin,327.42,0,22394.72,D
2411,369,2021-08-06,Bupa,Expense,Personal,Health & Medical,178.37,0,22216.35,D
2418,369,2021-08-07,Vape Shop,Expense,Leisure & Lifestyle,Tobacco & Vaping,419.21,0,21797.14,D
2410,369,2021-08-10,Boost Mobile,Expense,Personal,Mobile Phone,33.19,0,21763.95,D
2417,369,2021-08-14,Car Dealership,Expense,Transport,Car Repayments,124.93,0,21639.02,D
2400,369,2021-08-16,Yoga Studio,Expense,Personal,Fitness & Wellbeing,14.01,0,21625.01,D
2401,369,2021-08-16,Anytime Fitness,Expense,Personal,Fitness & Wellbeing,383.78,0,21241.23,D
2407,369,2021-08-16,Accountant,Expense,Personal,Life Admin,20.65,0,21220.58,D
2416,369,2021-08-16,Deliveroo,Expense,Leisure & Lifestyle,Takeaway,359.85,0,20860.73,D
2402,369,2021-08-18,Secure Parking,Expense,Transport,Parking,240.33,0,20620.4,D
2408,369,2021-08-18,Mortgage Lender,Expense,Household,Rent & Mortgage,483.41,0,20136.99,D
2409,369,2021-08-19,Rooftop Bar,Expense,Leisure & Lifestyle,Pubs & Bars,462.5,0,19674.49,D
2412,369,2021-08-20,Sports Bar,Expense,Leisure & Lifestyle,Pubs & Bars,322.51,0,19351.98,D
2405,369,2021-08-22,H&M,Expense,Personal,Clothing & Accessories,480.93,0,18871.05,D
2403,369,2021-08-24,Stock Purchase,Income,Income,Investments,557.29,0,18313.76,D
2415,369,2021-08-25,Woolworths,Expense,Household,Groceries,165.7,0,18148.06,D
2419,369,2021-09-01,Salary,Income,Income,Wages,0,8000,26148.06,C
2425,369,2021-09-07,Lawyer,Expense,Personal,Life Admin,443.17,0,25704.89,D
2435,369,2021-09-07,Anytime Fitness,Expense,Personal,Fitness & Wellbeing,329.91,0,25374.98,D
2432,369,2021-09-09,Birthday Gift,Expense,Personal,Gifts & Donations,183.83,0,25191.15,D
2422,369,2021-09-10,PetSmart,Expense,Household,Pets,187.56,0,25003.59,D
2439,369,2021-09-10,Tutoring Service,Expense,Personal,Education,402.1,0,24601.49,D
2421,369,2021-09-11,DiDi,Expense,Transport,Taxies & Share Cars,43.92,0,24557.57,D
2424,369,2021-09-12,Subway,Expense,Leisure & Lifestyle,Restaurants & Cafes,91.42,0,24466.15,D
2433,369,2021-09-12,NRMA,Expense,Transport,"Car Insurance, Rego & Maintenance",310.25,0,24155.9,D
2440,369,2021-09-12,KFC,Expense,Leisure & Lifestyle,Restaurants & Cafes,94.39,0,24061.51,D
2442,369,2021-09-12,Costco,Expense,Household,Groceries,24.37,0,24037.14,D
2444,369,2021-09-12,BWS,Expense,Leisure & Lifestyle,Alcohol,473.41,0,23563.73,D
2436,369,2021-09-13,Cotton On,Expense,Personal,Clothing & Accessories,401.88,0,23161.85,D
2430,369,2021-09-15,DoorDash,Expense,Leisure & Lifestyle,Takeaway,33.88,0,23127.97,D
2431,369,2021-09-18,TAB,Expense,Leisure & Lifestyle,Lottery & Gambling,422.91,0,22705.06,D
2434,369,2021-09-18,Post Office,Expense,Personal,Life Admin,175.46,0,22529.6,D
2443,369,2021-09-18,Optus,Expense,Personal,Mobile Phone,80.88,0,22448.72,D
2428,369,2021-09-19,Lowe's,Expense,Household,Maintenance & Improvements,96.92,0,22351.8,D
2437,369,2021-09-20,Hobby Store,Expense,Leisure & Lifestyle,Hobbies,252.79,0,22099.01,D
2438,369,2021-09-21,Dan Murphy's,Expense,Leisure & Lifestyle,Alcohol,359.91,0,21739.1,D
2441,369,2021-09-21,First Choice Liquor,Expense,Leisure & Lifestyle,Alcohol,93.41,0,21645.69,D
2426,369,2021-09-25,Mortgage Lender,Expense,Household,Rent & Mortgage,25.21,0,21620.48,D
2429,369,2021-09-25,Hobby Store,Expense,Leisure & Lifestyle,Hobbies,268.21,0,21352.27,D
2427,369,2021-09-28,Medibank,Expense,Personal,Health & Medical,262.33,0,21089.94,D
2420,369,2021-09-29,NIB,Expense,Personal,Health & Medical,188.8,0,20901.14,D
2423,369,2021-09-29,Sportsbet,Expense,Leisure & Lifestyle,Lottery & Gambling,353.16,0,20547.98,D
2445,369,2021-09-29,Baby Bunting,Expense,Personal,Children & Family,227.62,0,20320.36,D
2446,369,2021-10-01,Salary,Income,Income,Wages,0,8000,28320.36,C
2452,369,2021-10-03,Flight Centre,Expense,Leisure & Lifestyle,Holidays & Travel,397.71,0,27922.65,D
2459,369,2021-10-05,Bicycle Network,Expense,Transport,Cycling,154.47,0,27768.18,D
2454,369,2021-10-06,Car Dealership,Expense,Transport,Car Repayments,475.34,0,27292.84,D
2465,369,2021-10-06,EnergyAustralia,Expense,Household,Utilities,323.18,0,26969.66,D
2460,369,2021-10-07,Netflix,Expense,Leisure & Lifestyle,"Tv, Music & Streaming",484.77,0,26484.89,D
2464,369,2021-10-08,RACV,Expense,Household,Rates & Insurance,203.3,0,26281.59,D
2463,369,2021-10-10,United Petroleum,Expense,Transport,Fuel,139.89,0,26141.7,D
2451,369,2021-10-14,RACV,Expense,Household,Rates & Insurance,415.89,0,25725.81,D
2455,369,2021-10-16,Domino's Online,Expense,Leisure & Lifestyle,Takeaway,430.81,0,25295.0,D
2447,369,2021-10-17,Venmo,Transfer,Transfer,Transfer,482.37,0,24812.63,D
2456,369,2021-10-17,Stock Purchase,Income,Income,Investments,562.92,0,24249.71,D
2458,369,2021-10-18,Telstra,Expense,Personal,Mobile Phone,486.43,0,23763.28,D
2448,369,2021-10-19,Rooftop Bar,Expense,Leisure & Lifestyle,Pubs & Bars,50.24,0,23713.04,D
2461,369,2021-10-22,Art Supply Store,Expense,Leisure & Lifestyle,Hobbies,240.58,0,23472.46,D
2466,369,2021-10-22,Stock Purchase,Income,Income,Investments,628.1,0,22844.36,D
2449,369,2021-10-23,Shell,Expense,Transport,Fuel,74.97,0,22769.39,D
2457,369,2021-10-23,Allianz,Expense,Household,Rates & Insurance,270.01,0,22499.38,D
2453,369,2021-10-26,Greencross Vets,Expense,Household,Pets,315.46,0,22183.92,D
2450,369,2021-10-27,Vape Shop,Expense,Leisure & Lifestyle,Tobacco & Vaping,118.92,0,22065.0,D
2462,369,2021-10-27,Real Estate Agency,Expense,Household,Rent & Mortgage,132.94,0,21932.06,D
2467,369,2021-11-01,Salary,Income,Income,Wages,0,8000,29932.06,C
2475,369,2021-11-03,Netflix,Expense,Leisure & Lifestyle,"Tv, Music & Streaming",138.76,0,29793.3,D
2471,369,2021-11-04,Deliveroo,Expense,Leisure & Lifestyle,Takeaway,354.37,0,29438.93,D
2481,369,2021-11-04,Hair Salon,Expense,Personal,Hair & Beauty,205.36,0,29233.57,D
2482,369,2021-11-04,Baby Bunting,Expense,Personal,Children & Family,42.61,0,29190.96,D
2472,369,2021-11-06,Venmo,Transfer,Transfer,Transfer,95.84,0,29095.12,D
2476,369,2021-11-06,Hobby Store,Expense,Leisure & Lifestyle,Hobbies,158.38,0,28936.74,D
2470,369,2021-11-08,Mecca,Expense,Personal,Hair & Beauty,68.17,0,28868.57,D
2474,369,2021-11-09,Cigars,Expense,Leisure & Lifestyle,Tobacco & Vaping,427.2,0,28441.37,D
2473,369,2021-11-13,Dan Murphy's,Expense,Leisure & Lifestyle,Alcohol,352.52,0,28088.85,D
2484,369,2021-11-13,Apple App Store,Expense,Leisure & Lifestyle,"Apps, Games & Software",306.47,0,27782.38,D
2469,369,2021-11-14,Anytime Fitness,Expense,Personal,Fitness & Wellbeing,380.9,0,27401.48,D
2477,369,2021-11-15,Real Estate Agency,Expense,Household,Rent & Mortgage,419.53,0,26981.95,D
2468,369,2021-11-16,Telstra,Expense,Personal,Mobile Phone,92.92,0,26889.03,D
2479,369,2021-11-18,Uber,Expense,Transport,Taxies & Share Cars,31.52,0,26857.51,D
2478,369,2021-11-19,RSPCA,Expense,Household,Pets,377.51,0,26480.0,D
2480,369,2021-11-23,NIB,Expense,Personal,Health & Medical,52.76,0,26427.24,D
2483,369,2021-11-26,Woolworths,Expense,Household,Groceries,111.62,0,26315.62,D
2485,369,2021-12-01,Salary,Income,Income,Wages,0,8000,34315.62,C
2495,369,2021-12-02,Airbnb,Expense,Leisure & Lifestyle,Holidays & Travel,182.2,0,34133.42,D
2508,369,2021-12-02,Sports Bar,Expense,Leisure & Lifestyle,Pubs & Bars,377.91,0,33755.51,D
2490,369,2021-12-03,Crown Casino,Expense,Leisure & Lifestyle,Lottery & Gambling,191.74,0,33563.77,D
2496,369,2021-12-06,TransLink,Expense,Transport,Public Transport,57.37,0,33506.4,D
2510,369,2021-12-06,Adelaide Metro,Expense,Transport,Public Transport,473.3,0,33033.1,D
2492,369,2021-12-09,Stock Purchase,Expense,Personal,Investments,322.65,0,32710.45,D
2509,369,2021-12-10,Bicycle Network,Expense,Transport,Cycling,178.38,0,32532.07,D
2493,369,2021-12-11,Lowe's,Expense,Household,Maintenance & Improvements,215.15,0,32316.92,D
2506,369,2021-12-12,Suncorp,Expense,Household,Rates & Insurance,148.0,0,32168.92,D
2505,369,2021-12-13,Nail Salon,Expense,Personal,Hair & Beauty,166.91,0,32002.01,D
2511,369,2021-12-13,Bank Transfer,Transfer,Transfer,Transfer,290.82,0,31711.19,D
2498,369,2021-12-15,DoorDash,Expense,Leisure & Lifestyle,Takeaway,83.23,0,31627.96,D
2488,369,2021-12-16,Stock Purchase,Expense,Personal,Investments,677.62,0,30950.34,D
2491,369,2021-12-16,Boost Mobile,Expense,Personal,Mobile Phone,79.72,0,30870.62,D
2501,369,2021-12-17,Caltex,Expense,Transport,Fuel,391.82,0,30478.8,D
2500,369,2021-12-18,IKEA,Expense,Household,Maintenance & Improvements,313.15,0,30165.65,D
2504,369,2021-12-18,Online Course Provider,Expense,Personal,Education,385.25,0,29780.4,D
2502,369,2021-12-20,Venmo,Transfer,Transfer,Transfer,144.13,0,29636.27,D
2486,369,2021-12-22,Toys R Us,Expense,Personal,Children & Family,494.02,0,29142.25,D
2489,369,2021-12-24,Eventbrite,Expense,Leisure & Lifestyle,Events & Gigs,45.99,0,29096.26,D
2487,369,2021-12-25,Bupa,Expense,Personal,Health & Medical,216.89,0,28879.37,D
2494,369,2021-12-26,Netflix,Expense,Leisure & Lifestyle,"Tv, Music & Streaming",142.05,0,28737.32,D
2497,369,2021-12-27,Tutoring Service,Expense,Personal,Education,302.51,0,28434.81,D
2503,369,2021-12-28,Sportsbet,Expense,Leisure & Lifestyle,Lottery & Gambling,237.96,0,28196.85,D
2499,369,2021-12-29,Baby Bunting,Expense,Personal,Children & Family,129.99,0,28066.86,D
2507,369,2021-12-29,Post Office,Expense,Personal,Life Admin,114.73,0,27952.13,D
2512,369,2022-01-01,Salary,Income,Income,Wages,0,8000,35952.13,C
2520,369,2022-01-02,Sydney Water,Expense,Household,Utilities,56.6,0,35895.53,D
2523,369,2022-01-02,Adelaide Metro,Expense,Transport,Public Transport,290.27,0,35605.26,D
2532,369,2022-01-03,Sportsbet,Expense,Leisure & Lifestyle,Lottery & Gambling,417.49,0,35187.77,D
2518,369,2022-01-04,Origin Energy,Expense,Household,Utilities,159.95,0,35027.82,D
2528,369,2022-01-06,Ticketmaster,Expense,Leisure & Lifestyle,Events & Gigs,394.34,0,34633.48,D
2522,369,2022-01-07,iiNet,Expense,Household,Internet,173.97,0,34459.51,D
2513,369,2022-01-08,Stock Purchase,Income,Income,Investments,711.66,0,33747.85,D
2515,369,2022-01-09,YouTube Premium,Expense,Leisure & Lifestyle,"Tv, Music & Streaming",469.91,0,33277.94,D
2517,369,2022-01-11,Childcare Center,Expense,Personal,Children & Family,123.38,0,33154.56,D
2514,369,2022-01-16,TAB,Expense,Leisure & Lifestyle,Lottery & Gambling,39.54,0,33115.02,D
2521,369,2022-01-16,Cotton On,Expense,Personal,Clothing & Accessories,138.09,0,32976.93,D
2519,369,2022-01-17,NIB,Expense,Personal,Health & Medical,84.62,0,32892.31,D
2516,369,2022-01-19,First Choice Liquor,Expense,Leisure & Lifestyle,Alcohol,33.69,0,32858.62,D
2526,369,2022-01-22,United Petroleum,Expense,Transport,Fuel,491.06,0,32367.56,D
2533,369,2022-01-22,Online Course Provider,Expense,Personal,Education,292.83,0,32074.73,D
2524,369,2022-01-24,Medibank,Expense,Personal,Health & Medical,299.3,0,31775.43,D
2527,369,2022-01-25,Uber,Expense,Transport,Taxies & Share Cars,280.41,0,31495.02,D
2530,369,2022-01-25,Bike Shop,Expense,Transport,Cycling,87.83,0,31407.19,D
2531,369,2022-01-28,Apple Music,Expense,Leisure & Lifestyle,"Tv, Music & Streaming",466.41,0,30940.78,D
2525,369,2022-01-29,Crown Casino,Expense,Leisure & Lifestyle,Lottery & Gambling,488.32,0,30452.46,D
2529,369,2022-01-29,H&M,Expense,Personal,Clothing & Accessories,129.25,0,30323.21,D
2534,369,2022-02-01,Salary,Income,Income,Wages,0,8000,38323.21,C
2545,369,2022-02-02,Uber,Expense,Transport,Taxies & Share Cars,151.41,0,38171.8,D
2535,369,2022-02-05,Ticketmaster,Expense,Leisure & Lifestyle,Events & Gigs,19.54,0,38152.26,D
2536,369,2022-02-05,Art Supply Store,Expense,Leisure & Lifestyle,Hobbies,152.05,0,38000.21,D
2537,369,2022-02-05,AGL,Expense,Household,Utilities,127.85,0,37872.36,D
2542,369,2022-02-06,Yoga Studio,Expense,Personal,Fitness & Wellbeing,330.06,0,37542.3,D
2555,369,2022-02-06,Priceline Pharmacy,Expense,Personal,Health & Medical,456.88,0,37085.42,D
2539,369,2022-02-07,University,Expense,Personal,Education,113.84,0,36971.58,D
2541,369,2022-02-07,Allianz,Expense,Household,Rates & Insurance,281.33,0,36690.25,D
2547,369,2022-02-09,PetSmart,Expense,Household,Pets,134.25,0,36556.0,D
2544,369,2022-02-11,TPG,Expense,Household,Internet,59.82,0,36496.18,D
2552,369,2022-02-12,Lowe's,Expense,Household,Maintenance & Improvements,68.4,0,36427.78,D
2538,369,2022-02-13,NRMA,Expense,Household,Rates & Insurance,90.02,0,36337.76,D
2540,369,2022-02-15,BP,Expense,Transport,Fuel,30.84,0,36306.92,D
2548,369,2022-02-15,Sephora,Expense,Personal,Hair & Beauty,83.0,0,36223.92,D
2554,369,2022-02-17,Gym Membership,Expense,Personal,Fitness & Wellbeing,111.01,0,36112.91,D
2543,369,2022-02-19,Cigars,Expense,Leisure & Lifestyle,Tobacco & Vaping,450.25,0,35662.66,D
2550,369,2022-02-20,Deliveroo,Expense,Leisure & Lifestyle,Takeaway,263.19,0,35399.47,D
2549,369,2022-02-22,Stock Purchase,Expense,Personal,Investments,710.05,0,34689.42,D
2551,369,2022-02-22,Tutoring Service,Expense,Personal,Education,50.69,0,34638.73,D
2546,369,2022-02-24,Telstra,Expense,Household,Internet,279.28,0,34359.45,D
2553,369,2022-02-25,IGA,Expense,Household,Groceries,482.02,0,33877.43,D
2556,369,2022-02-27,Home Depot,Expense,Household,Maintenance & Improvements,401.95,0,33475.48,D
2557,369,2022-03-01,Salary,Income,Income,Wages,0,8000,41475.48,C
2573,369,2022-03-02,NRMA,Expense,Transport,"Car Insurance, Rego & Maintenance",30.48,0,41445.0,D
2569,369,2022-03-03,Venmo,Transfer,Transfer,Transfer,38.78,0,41406.22,D
2562,369,2022-03-04,Toyota Finance,Expense,Transport,Car Repayments,483.18,0,40923.04,D
2568,369,2022-03-08,CityLink,Expense,Transport,Tolls,415.19,0,40507.85,D
2574,369,2022-03-10,EnergyAustralia,Expense,Household,Utilities,355.37,0,40152.48,D
2560,369,2022-03-11,Spotify,Expense,Leisure & Lifestyle,"Tv, Music & Streaming",29.13,0,40123.35,D
2561,369,2022-03-11,Steam,Expense,Leisure & Lifestyle,"Apps, Games & Software",32.57,0,40090.78,D
2565,369,2022-03-13,Venmo,Transfer,Transfer,Transfer,405.06,0,39685.72,D
2581,369,2022-03-13,Stock Purchase,Expense,Personal,Investments,899.88,0,38785.84,D
2575,369,2022-03-17,Ticketek,Expense,Leisure & Lifestyle,Events & Gigs,326.24,0,38459.6,D
2577,369,2022-03-17,Cycling Apparel Store,Expense,Transport,Cycling,392.81,0,38066.79,D
2558,369,2022-03-18,Bunnings Warehouse,Expense,Household,Maintenance & Improvements,271.94,0,37794.85,D
2571,369,2022-03-20,H&M,Expense,Personal,Clothing & Accessories,287.19,0,37507.66,D
2570,369,2022-03-21,YouTube Premium,Expense,Leisure & Lifestyle,"Tv, Music & Streaming",195.55,0,37312.11,D
2572,369,2022-03-21,Sportsbet,Expense,Leisure & Lifestyle,Lottery & Gambling,469.24,0,36842.87,D
2559,369,2022-03-22,Ticketek,Expense,Leisure & Lifestyle,Events & Gigs,341.63,0,36501.24,D
2563,369,2022-03-22,Linkt,Expense,Transport,Tolls,347.77,0,36153.47,D
2564,369,2022-03-22,GoCatch,Expense,Transport,Taxies & Share Cars,441.85,0,35711.62,D
2579,369,2022-03-22,Amaysim,Expense,Personal,Mobile Phone,240.15,0,35471.47,D
2578,369,2022-03-23,Car Loan Provider,Expense,Transport,Car Repayments,168.64,0,35302.83,D
2566,369,2022-03-24,Apple App Store,Expense,Leisure & Lifestyle,"Apps, Games & Software",76.33,0,35226.5,D
2567,369,2022-03-25,PayPal,Transfer,Transfer,Transfer,102.37,0,35124.13,D
2576,369,2022-03-26,Baby Bunting,Expense,Personal,Children & Family,141.77,0,34982.36,D
2580,369,2022-03-27,Apple Music,Expense,Leisure & Lifestyle,"Tv, Music & Streaming",400.09,0,34582.27,D
2582,369,2022-04-01,Salary,Income,Income,Wages,0,8000,42582.27,C
2593,369,2022-04-02,Tobacco Store,Expense,Leisure & Lifestyle,Tobacco & Vaping,397.28,0,42184.99,D
2597,369,2022-04-02,Medibank,Expense,Personal,Health & Medical,401.41,0,41783.58,D
2584,369,2022-04-03,Allianz,Expense,Household,Rates & Insurance,137.04,0,41646.54,D
2596,369,2022-04-04,Landlord,Expense,Household,Rent & Mortgage,119.07,0,41527.47,D
2598,369,2022-04-07,Local Pub,Expense,Leisure & Lifestyle,Pubs & Bars,482.63,0,41044.84,D
2600,369,2022-04-07,7-Eleven,Expense,Transport,Fuel,248.75,0,40796.09,D
2594,369,2022-04-10,Origin Energy,Expense,Household,Utilities,290.22,0,40505.87,D
2592,369,2022-04-11,Nail Salon,Expense,Personal,Hair & Beauty,229.72,0,40276.15,D
2595,369,2022-04-11,Stock Purchase,Expense,Personal,Investments,725.63,0,39550.52,D
2589,369,2022-04-12,Tutoring Service,Expense,Personal,Education,390.63,0,39159.89,D
2587,369,2022-04-14,QBE,Expense,Household,Rates & Insurance,68.03,0,39091.86,D
2586,369,2022-04-16,Moshtix,Expense,Leisure & Lifestyle,Events & Gigs,65.17,0,39026.69,D
2590,369,2022-04-18,Printing Service,Expense,Personal,Life Admin,66.7,0,38959.99,D
2601,369,2022-04-21,Cigarettes,Expense,Leisure & Lifestyle,Tobacco & Vaping,78.13,0,38881.86,D
2585,369,2022-04-24,Printing Service,Expense,Personal,Life Admin,163.46,0,38718.4,D
2599,369,2022-04-24,Accountant,Expense,Personal,Life Admin,127.45,0,38590.95,D
2591,369,2022-04-27,NIB,Expense,Personal,Health & Medical,49.92,0,38541.03,D
2583,369,2022-04-29,Stan,Expense,Leisure & Lifestyle,"Tv, Music & Streaming",81.0,0,38460.03,D
2588,369,2022-04-29,Stock Purchase,Income,Income,Investments,412.6,0,38047.43,D
2602,369,2022-05-01,Salary,Income,Income,Wages,0,8000,46047.43,C
2609,369,2022-05-02,Printing Service,Expense,Personal,Life Admin,112.57,0,45934.86,D
2607,369,2022-05-05,Myki,Expense,Transport,Public Transport,54.26,0,45880.6,D
2610,369,2022-05-08,H&M,Expense,Personal,Clothing & Accessories,188.72,0,45691.88,D
2611,369,2022-05-08,Stan,Expense,Leisure & Lifestyle,"Tv, Music & Streaming",403.11,0,45288.77,D
2606,369,2022-05-09,Vape Shop,Expense,Leisure & Lifestyle,Tobacco & Vaping,157.36,0,45131.41,D
2615,369,2022-05-13,Sydney Water,Expense,Household,Utilities,261.69,0,44869.72,D
2608,369,2022-05-14,Bicycle Network,Expense,Transport,Cycling,414.67,0,44455.05,D
2605,369,2022-05-16,Woolworths,Expense,Household,Groceries,348.32,0,44106.73,D
2614,369,2022-05-17,Amaysim,Expense,Personal,Mobile Phone,425.17,0,43681.56,D
2604,369,2022-05-19,Tutoring Service,Expense,Personal,Education,280.69,0,43400.87,D
2612,369,2022-05-21,Rooftop Bar,Expense,Leisure & Lifestyle,Pubs & Bars,18.92,0,43381.95,D
2613,369,2022-05-23,Zara,Expense,Personal,Clothing & Accessories,222.76,0,43159.19,D
2603,369,2022-05-24,Cycling Apparel Store,Expense,Transport,Cycling,13.54,0,43145.65,D
2616,369,2022-06-01,Salary,Income,Income,Wages,0,8000,51145.65,C
2631,369,2022-06-05,BP,Expense,Transport,Fuel,293.33,0,50852.32,D
2646,369,2022-06-05,E-Toll,Expense,Transport,Tolls,82.6,0,50769.72,D
2619,369,2022-06-06,Local Pub,Expense,Leisure & Lifestyle,Pubs & Bars,218.41,0,50551.31,D
2637,369,2022-06-06,Hungry Jack's,Expense,Leisure & Lifestyle,Restaurants & Cafes,163.84,0,50387.47,D
2617,369,2022-06-07,Tutoring Service,Expense,Personal,Education,356.38,0,50031.09,D
2623,369,2022-06-07,Cycling Apparel Store,Expense,Transport,Cycling,281.59,0,49749.5,D
2628,369,2022-06-07,Stock Purchase,Income,Income,Investments,717.72,0,49031.78,D
2625,369,2022-06-08,Steam,Expense,Leisure & Lifestyle,"Apps, Games & Software",268.2,0,48763.58,D
2645,369,2022-06-08,Suncorp,Expense,Transport,"Car Insurance, Rego & Maintenance",443.05,0,48320.53,D
2634,369,2022-06-09,Nail Salon,Expense,Personal,Hair & Beauty,433.02,0,47887.51,D
2632,369,2022-06-10,Amaysim,Expense,Personal,Mobile Phone,375.12,0,47512.39,D
2635,369,2022-06-11,Accountant,Expense,Personal,Life Admin,300.36,0,47212.03,D
2644,369,2022-06-12,Mecca,Expense,Personal,Hair & Beauty,34.68,0,47177.35,D
2620,369,2022-06-13,Accountant,Expense,Personal,Life Admin,257.81,0,46919.54,D
2643,369,2022-06-13,Linkt,Expense,Transport,Tolls,89.09,0,46830.45,D
2629,369,2022-06-14,AGL,Expense,Household,Utilities,351.28,0,46479.17,D
2622,369,2022-06-15,Mortgage Lender,Expense,Household,Rent & Mortgage,310.35,0,46168.82,D
2626,369,2022-06-15,Booking.com,Expense,Leisure & Lifestyle,Holidays & Travel,492.12,0,45676.7,D
2627,369,2022-06-16,NRMA,Expense,Household,Rates & Insurance,136.92,0,45539.78,D
2633,369,2022-06-18,Ticketek,Expense,Leisure & Lifestyle,Events & Gigs,114.05,0,45425.73,D
2638,369,2022-06-19,NRMA,Expense,Household,Rates & Insurance,174.39,0,45251.34,D
2639,369,2022-06-19,Gym Membership,Expense,Personal,Fitness & Wellbeing,469.74,0,44781.6,D
2636,369,2022-06-20,Booking.com,Expense,Leisure & Lifestyle,Holidays & Travel,87.0,0,44694.6,D
2642,369,2022-06-20,Landlord,Expense,Household,Rent & Mortgage,316.54,0,44378.06,D
2630,369,2022-06-22,Mecca,Expense,Personal,Hair & Beauty,82.89,0,44295.17,D
2641,369,2022-06-22,Airbnb,Expense,Leisure & Lifestyle,Holidays & Travel,437.45,0,43857.72,D
2621,369,2022-06-25,Art Supply Store,Expense,Leisure & Lifestyle,Hobbies,415.5,0,43442.22,D
2624,369,2022-06-26,Lawyer,Expense,Personal,Life Admin,386.06,0,43056.16,D
2640,369,2022-06-27,IGA,Expense,Household,Groceries,486.99,0,42569.17,D
2618,369,2022-06-29,Stock Purchase,Income,Income,Investments,925.72,0,41643.45,D
2647,369,2022-07-01,Salary,Income,Income,Wages,0,8000,49643.45,C
2652,369,2022-07-04,NRMA,Expense,Transport,"Car Insurance, Rego & Maintenance",84.0,0,49559.45,D
2654,369,2022-07-04,Wilson Parking,Expense,Transport,Parking,466.0,0,49093.45,D
2651,369,2022-07-07,Cotton On,Expense,Personal,Clothing & Accessories,360.6,0,48732.85,D
2653,369,2022-07-09,Toys R Us,Expense,Personal,Children & Family,269.13,0,48463.72,D
2657,369,2022-07-15,Rooftop Bar,Expense,Leisure & Lifestyle,Pubs & Bars,15.99,0,48447.73,D
2648,369,2022-07-17,MAC Cosmetics,Expense,Personal,Hair & Beauty,479.96,0,47967.77,D
2656,369,2022-07-17,Telstra,Expense,Personal,Mobile Phone,110.39,0,47857.38,D
2655,369,2022-07-18,Dan Murphy's,Expense,Leisure & Lifestyle,Alcohol,423.12,0,47434.26,D
2649,369,2022-07-20,Greencross Vets,Expense,Household,Pets,281.34,0,47152.92,D
2650,369,2022-07-27,Gym Membership,Expense,Personal,Fitness & Wellbeing,16.06,0,47136.86,D
2658,369,2022-08-01,Salary,Income,Income,Wages,0,8000,55136.86,C
2659,369,2022-08-02,Domino's Online,Expense,Leisure & Lifestyle,Takeaway,457.17,0,54679.69,D
2668,369,2022-08-02,Car Dealership,Expense,Transport,Car Repayments,296.08,0,54383.61,D
2672,369,2022-08-02,Qantas,Expense,Leisure & Lifestyle,Holidays & Travel,382.31,0,54001.3,D
2669,369,2022-08-07,Apple Music,Expense,Leisure & Lifestyle,"Tv, Music & Streaming",153.1,0,53848.2,D
2663,369,2022-08-08,Amaysim,Expense,Personal,Mobile Phone,248.43,0,53599.77,D
2667,369,2022-08-09,Stock Purchase,Income,Income,Investments,732.22,0,52867.55,D
2674,369,2022-08-14,Priceline Pharmacy,Expense,Personal,Health & Medical,67.72,0,52799.83,D
2666,369,2022-08-15,Gym Membership,Expense,Personal,Fitness & Wellbeing,167.71,0,52632.12,D
2676,369,2022-08-15,Petbarn,Expense,Household,Pets,207.85,0,52424.27,D
2662,369,2022-08-17,Allianz,Expense,Household,Rates & Insurance,61.25,0,52363.02,D
2664,369,2022-08-17,AGL,Expense,Household,Utilities,412.44,0,51950.58,D
2665,369,2022-08-18,BP,Expense,Transport,Fuel,369.34,0,51581.24,D
2670,369,2022-08-18,NIB,Expense,Personal,Health & Medical,167.18,0,51414.06,D
2677,369,2022-08-19,Hobby Store,Expense,Leisure & Lifestyle,Hobbies,220.81,0,51193.25,D
2671,369,2022-08-21,Allianz,Expense,Transport,"Car Insurance, Rego & Maintenance",175.35,0,51017.9,D
2673,369,2022-08-26,NRMA,Expense,Household,Rates & Insurance,461.3,0,50556.6,D
2661,369,2022-08-27,Local Pub,Expense,Leisure & Lifestyle,Pubs & Bars,354.26,0,50202.34,D
2675,369,2022-08-27,Stock Purchase,Income,Income,Investments,827.76,0,49374.58,D
2660,369,2022-08-29,Amaysim,Expense,Personal,Mobile Phone,419.99,0,48954.59,D
2678,369,2022-09-01,Salary,Income,Income,Wages,0,8000,56954.59,C
2696,369,2022-09-05,Anytime Fitness,Expense,Personal,Fitness & Wellbeing,337.16,0,56617.43,D
2693,369,2022-09-06,Stock Purchase,Income,Income,Investments,156.15,0,56461.28,D
2692,369,2022-09-09,Toyota Finance,Expense,Transport,Car Repayments,49.51,0,56411.77,D
2695,369,2022-09-09,Anytime Fitness,Expense,Personal,Fitness & Wellbeing,145.61,0,56266.16,D
2687,369,2022-09-10,Telstra,Expense,Household,Internet,200.03,0,56066.13,D
2697,369,2022-09-13,Printing Service,Expense,Personal,Life Admin,102.43,0,55963.7,D
2691,369,2022-09-14,BWS,Expense,Leisure & Lifestyle,Alcohol,195.5,0,55768.2,D
2698,369,2022-09-14,7-Eleven,Expense,Transport,Fuel,78.16,0,55690.04,D
2683,369,2022-09-15,Hobby Store,Expense,Leisure & Lifestyle,Hobbies,20.92,0,55669.12,D
2679,369,2022-09-17,Venmo,Transfer,Transfer,Transfer,148.36,0,55520.76,D
2684,369,2022-09-17,Airbnb,Expense,Leisure & Lifestyle,Holidays & Travel,119.56,0,55401.2,D
2685,369,2022-09-19,Zara,Expense,Personal,Clothing & Accessories,313.0,0,55088.2,D
2694,369,2022-09-20,Toyota Finance,Expense,Transport,Car Repayments,48.32,0,55039.88,D
2680,369,2022-09-22,Aldi,Expense,Household,Groceries,362.47,0,54677.41,D
2682,369,2022-09-24,Mortgage Lender,Expense,Household,Rent & Mortgage,297.28,0,54380.13,D
2688,369,2022-09-24,Sydney Olympic Park,Expense,Transport,Parking,99.87,0,54280.26,D
2681,369,2022-09-25,Cocktail Bar,Expense,Leisure & Lifestyle,Pubs & Bars,122.4,0,54157.86,D
2686,369,2022-09-26,Vodafone,Expense,Personal,Mobile Phone,105.65,0,54052.21,D
2690,369,2022-09-27,McDonald's,Expense,Leisure & Lifestyle,Restaurants & Cafes,370.7,0,53681.51,D
2689,369,2022-09-29,7-Eleven,Expense,Transport,Fuel,494.97,0,53186.54,D
2699,369,2022-10-01,Salary,Income,Income,Wages,0,8000,61186.54,C
2712,369,2022-10-02,Toys R Us,Expense,Personal,Children & Family,406.9,0,60779.64,D
2702,369,2022-10-05,Printing Service,Expense,Personal,Life Admin,149.61,0,60630.03,D
2707,369,2022-10-05,EnergyAustralia,Expense,Household,Utilities,214.47,0,60415.56,D
2708,369,2022-10-05,Toyota Finance,Expense,Transport,Car Repayments,355.91,0,60059.65,D
2711,369,2022-10-05,NIB,Expense,Personal,Health & Medical,382.22,0,59677.43,D
2716,369,2022-10-08,GoFundMe,Expense,Personal,Gifts & Donations,481.95,0,59195.48,D
2706,369,2022-10-11,H&M,Expense,Personal,Clothing & Accessories,499.38,0,58696.1,D
2709,369,2022-10-13,McDonald's,Expense,Leisure & Lifestyle,Restaurants & Cafes,220.46,0,58475.64,D
2700,369,2022-10-14,KFC,Expense,Leisure & Lifestyle,Restaurants & Cafes,71.71,0,58403.93,D
2703,369,2022-10-14,TransLink,Expense,Transport,Public Transport,316.85,0,58087.08,D
2705,369,2022-10-14,DoorDash,Expense,Leisure & Lifestyle,Takeaway,299.76,0,57787.32,D
2715,369,2022-10-14,Hobby Store,Expense,Leisure & Lifestyle,Hobbies,126.18,0,57661.14,D
2701,369,2022-10-16,DoorDash,Expense,Leisure & Lifestyle,Takeaway,158.44,0,57502.7,D
2704,369,2022-10-18,Gym Membership,Expense,Personal,Fitness & Wellbeing,203.04,0,57299.66,D
2713,369,2022-10-20,Deliveroo,Expense,Leisure & Lifestyle,Takeaway,431.69,0,56867.97,D
2710,369,2022-10-29,Stock Purchase,Expense,Personal,Investments,102.73,0,56765.24,D
2714,369,2022-10-29,Moshtix,Expense,Leisure & Lifestyle,Events & Gigs,299.6,0,56465.64,D
2717,369,2022-11-01,Salary,Income,Income,Wages,0,8000,64465.64,C
2719,369,2022-11-02,GoCatch,Expense,Transport,Taxies & Share Cars,320.77,0,64144.87,D
2720,369,2022-11-03,Steam,Expense,Leisure & Lifestyle,"Apps, Games & Software",46.59,0,64098.28,D
2723,369,2022-11-05,Crown Casino,Expense,Leisure & Lifestyle,Lottery & Gambling,255.94,0,63842.34,D
2722,369,2022-11-07,City of Melbourne,Expense,Transport,Parking,65.04,0,63777.3,D
2721,369,2022-11-12,Steam,Expense,Leisure & Lifestyle,"Apps, Games & Software",381.77,0,63395.53,D
2718,369,2022-11-13,RACV,Expense,Transport,"Car Insurance, Rego & Maintenance",303.55,0,63091.98,D
2726,369,2022-11-15,Stock Purchase,Income,Income,Investments,314.48,0,62777.5,D
2727,369,2022-11-15,Home Depot,Expense,Household,Maintenance & Improvements,103.96,0,62673.54,D
2725,369,2022-11-16,Allianz,Expense,Transport,"Car Insurance, Rego & Maintenance",153.4,0,62520.14,D
2724,369,2022-11-28,EastLink,Expense,Transport,Tolls,143.67,0,62376.47,D
2728,369,2022-11-28,Adobe Creative Cloud,Expense,Leisure & Lifestyle,"Apps, Games & Software",399.21,0,61977.26,D
2729,369,2022-12-01,Salary,Income,Income,Wages,0,8000,69977.26,C
2730,369,2022-12-02,The Lott,Expense,Leisure & Lifestyle,Lottery & Gambling,284.4,0,69692.86,D
2743,369,2022-12-03,Bicycle Network,Expense,Transport,Cycling,347.09,0,69345.77,D
2738,369,2022-12-06,Hungry Jack's,Expense,Leisure & Lifestyle,Restaurants & Cafes,172.49,0,69173.28,D
2740,369,2022-12-06,Local Pub,Expense,Leisure & Lifestyle,Pubs & Bars,204.71,0,68968.57,D
2736,369,2022-12-07,IGA,Expense,Household,Groceries,114.55,0,68854.02,D
2733,369,2022-12-08,Post Office,Expense,Personal,Life Admin,359.85,0,68494.17,D
2751,369,2022-12-08,IGA,Expense,Household,Groceries,70.24,0,68423.93,D
2735,369,2022-12-09,Charity Organization,Expense,Personal,Gifts & Donations,267.45,0,68156.48,D
2731,369,2022-12-11,Subway,Expense,Leisure & Lifestyle,Restaurants & Cafes,466.12,0,67690.36,D
2753,369,2022-12-11,Charity Organization,Expense,Personal,Gifts & Donations,252.35,0,67438.01,D
2742,369,2022-12-12,EnergyAustralia,Expense,Household,Utilities,134.66,0,67303.35,D
2734,369,2022-12-15,Venmo,Transfer,Transfer,Transfer,460.14,0,66843.21,D
2750,369,2022-12-16,Tatts,Expense,Leisure & Lifestyle,Lottery & Gambling,155.28,0,66687.93,D
2741,369,2022-12-17,Gym Membership,Expense,Personal,Fitness & Wellbeing,134.57,0,66553.36,D
2747,369,2022-12-18,Stock Purchase,Expense,Personal,Investments,760.32,0,65793.04,D
2737,369,2022-12-19,Real Estate Agency,Expense,Household,Rent & Mortgage,330.28,0,65462.76,D
2749,369,2022-12-19,Allianz,Expense,Transport,"Car Insurance, Rego & Maintenance",458.98,0,65003.78,D
2732,369,2022-12-21,Stock Purchase,Expense,Personal,Investments,738.65,0,64265.13,D
2745,369,2022-12-21,Spotify,Expense,Leisure & Lifestyle,"Tv, Music & Streaming",499.75,0,63765.38,D
2748,369,2022-12-23,Linkt,Expense,Transport,Tolls,40.98,0,63724.4,D
2744,369,2022-12-24,Boost Mobile,Expense,Personal,Mobile Phone,132.99,0,63591.41,D
2754,369,2022-12-24,RSPCA,Expense,Household,Pets,477.87,0,63113.54,D
2746,369,2022-12-26,Car Dealership,Expense,Transport,Car Repayments,80.61,0,63032.93,D
2739,369,2022-12-27,Stock Purchase,Income,Income,Investments,392.85,0,62640.08,D
2752,369,2022-12-27,Eventbrite,Expense,Leisure & Lifestyle,Events & Gigs,422.97,0,62217.11,D
2755,369,2023-01-01,Salary,Income,Income,Wages,0,8000,70217.11,C
2756,369,2023-01-08,Sports Equipment Store,Expense,Leisure & Lifestyle,Hobbies,92.61,0,70124.5,D
2759,369,2023-01-08,Optus,Expense,Household,Internet,132.55,0,69991.95,D
2757,369,2023-01-12,Shell,Expense,Transport,Fuel,490.06,0,69501.89,D
2758,369,2023-01-14,Cotton On,Expense,Personal,Clothing & Accessories,334.76,0,69167.13,D
2761,369,2023-01-24,Lawyer,Expense,Personal,Life Admin,375.31,0,68791.82,D
2763,369,2023-01-25,UberEats,Expense,Leisure & Lifestyle,Takeaway,363.38,0,68428.44,D
2765,369,2023-01-25,Landlord,Expense,Household,Rent & Mortgage,327.28,0,68101.16,D
2762,369,2023-01-27,PayPal,Transfer,Transfer,Transfer,227.74,0,67873.42,D
2764,369,2023-01-27,Home Depot,Expense,Household,Maintenance & Improvements,371.95,0,67501.47,D
2760,369,2023-01-28,Domino's Pizza,Expense,Leisure & Lifestyle,Restaurants & Cafes,306.86,0,67194.61,D
2766,369,2023-02-01,Salary,Income,Income,Wages,0,8000,75194.61,C
2773,369,2023-02-04,Telstra,Expense,Household,Internet,16.16,0,75178.45,D
2769,369,2023-02-07,Deliveroo,Expense,Leisure & Lifestyle,Takeaway,315.74,0,74862.71,D
2777,369,2023-02-12,QBE,Expense,Transport,"Car Insurance, Rego & Maintenance",356.94,0,74505.77,D
2779,369,2023-02-15,Car Dealership,Expense,Transport,Car Repayments,345.51,0,74160.26,D
2770,369,2023-02-17,Childcare Center,Expense,Personal,Children & Family,291.11,0,73869.15,D
2771,369,2023-02-18,Domino's Online,Expense,Leisure & Lifestyle,Takeaway,84.54,0,73784.61,D
2767,369,2023-02-21,Hair Salon,Expense,Personal,Hair & Beauty,244.72,0,73539.89,D
2776,369,2023-02-21,University,Expense,Personal,Education,475.68,0,73064.21,D
2768,369,2023-02-22,Uniqlo,Expense,Personal,Clothing & Accessories,69.39,0,72994.82,D
2775,369,2023-02-22,Cigarettes,Expense,Leisure & Lifestyle,Tobacco & Vaping,177.36,0,72817.46,D
2774,369,2023-02-25,AGL,Expense,Household,Utilities,181.24,0,72636.22,D
2778,369,2023-02-26,DiDi,Expense,Transport,Taxies & Share Cars,279.1,0,72357.12,D
2772,369,2023-02-27,PayPal,Transfer,Transfer,Transfer,400.84,0,71956.28,D
2780,369,2023-03-01,Salary,Income,Income,Wages,0,8000,79956.28,C
2783,369,2023-03-03,Stock Purchase,Income,Income,Investments,258.53,0,79697.75,D
2790,369,2023-03-03,TAB,Expense,Leisure & Lifestyle,Lottery & Gambling,240.08,0,79457.67,D
2804,369,2023-03-03,Car Loan Provider,Expense,Transport,Car Repayments,327.61,0,79130.06,D
2800,369,2023-03-05,Stock Purchase,Income,Income,Investments,445.21,0,78684.85,D
2796,369,2023-03-06,City of Melbourne,Expense,Transport,Parking,311.43,0,78373.42,D
2801,369,2023-03-09,13cabs,Expense,Transport,Taxies & Share Cars,466.34,0,77907.08,D
2798,369,2023-03-10,Medibank,Expense,Personal,Health & Medical,32.95,0,77874.13,D
2802,369,2023-03-10,Rooftop Bar,Expense,Leisure & Lifestyle,Pubs & Bars,159.95,0,77714.18,D
2785,369,2023-03-11,Toyota Finance,Expense,Transport,Car Repayments,173.83,0,77540.35,D
2806,369,2023-03-11,Steam,Expense,Leisure & Lifestyle,"Apps, Games & Software",254.42,0,77285.93,D
2782,369,2023-03-13,Bicycle Network,Expense,Transport,Cycling,235.63,0,77050.3,D
2799,369,2023-03-14,Allianz,Expense,Transport,"Car Insurance, Rego & Maintenance",409.65,0,76640.65,D
2784,369,2023-03-17,Moshtix,Expense,Leisure & Lifestyle,Events & Gigs,148.87,0,76491.78,D
2789,369,2023-03-18,Cotton On,Expense,Personal,Clothing & Accessories,14.13,0,76477.65,D
2786,369,2023-03-20,Sports Bar,Expense,Leisure & Lifestyle,Pubs & Bars,374.9,0,76102.75,D
2795,369,2023-03-20,Bupa,Expense,Personal,Health & Medical,386.13,0,75716.62,D
2803,369,2023-03-20,Aldi,Expense,Household,Groceries,130.26,0,75586.36,D
2793,369,2023-03-21,Venmo,Transfer,Transfer,Transfer,293.69,0,75292.67,D
2797,369,2023-03-23,Myki,Expense,Transport,Public Transport,390.2,0,74902.47,D
2794,369,2023-03-24,KFC,Expense,Leisure & Lifestyle,Restaurants & Cafes,396.92,0,74505.55,D
2792,369,2023-03-25,Ticketek,Expense,Leisure & Lifestyle,Events & Gigs,469.04,0,74036.51,D
2787,369,2023-03-27,Mecca,Expense,Personal,Hair & Beauty,141.67,0,73894.84,D
2788,369,2023-03-27,Toyota Finance,Expense,Transport,Car Repayments,463.61,0,73431.23,D
2805,369,2023-03-28,Telstra,Expense,Personal,Mobile Phone,196.08,0,73235.15,D
2781,369,2023-03-29,Stock Purchase,Income,Income,Investments,221.59,0,73013.56,D
2791,369,2023-03-29,Domino's Pizza,Expense,Leisure & Lifestyle,Restaurants & Cafes,254.88,0,72758.68,D
2807,369,2023-04-01,Salary,Income,Income,Wages,0,8000,80758.68,C
2818,369,2023-04-02,Bike Shop,Expense,Transport,Cycling,196.41,0,80562.27,D
2809,369,2023-04-03,Mortgage Lender,Expense,Household,Rent & Mortgage,93.31,0,80468.96,D
2812,369,2023-04-08,Cocktail Bar,Expense,Leisure & Lifestyle,Pubs & Bars,104.35,0,80364.61,D
2819,369,2023-04-13,Myki,Expense,Transport,Public Transport,76.73,0,80287.88,D
2810,369,2023-04-14,Bike Shop,Expense,Transport,Cycling,419.69,0,79868.19,D
2816,369,2023-04-14,AGL,Expense,Household,Utilities,232.89,0,79635.3,D
2808,369,2023-04-15,Printing Service,Expense,Personal,Life Admin,72.78,0,79562.52,D
2814,369,2023-04-16,Shell,Expense,Transport,Fuel,165.8,0,79396.72,D
2815,369,2023-04-16,Gym Membership,Expense,Personal,Fitness & Wellbeing,406.72,0,78990.0,D
2811,369,2023-04-24,Stock Purchase,Income,Income,Investments,487.97,0,78502.03,D
2817,369,2023-04-24,Opal Card,Expense,Transport,Public Transport,464.27,0,78037.76,D
2813,369,2023-04-29,Apple Music,Expense,Leisure & Lifestyle,"Tv, Music & Streaming",459.77,0,77577.99,D
2820,369,2023-05-01,Salary,Income,Income,Wages,0,8000,85577.99,C
2823,369,2023-05-03,Myki,Expense,Transport,Public Transport,399.74,0,85178.25,D
2847,369,2023-05-05,Sydney Olympic Park,Expense,Transport,Parking,479.11,0,84699.14,D
2828,369,2023-05-06,University,Expense,Personal,Education,472.04,0,84227.1,D
2842,369,2023-05-08,Qantas,Expense,Leisure & Lifestyle,Holidays & Travel,266.54,0,83960.56,D
2829,369,2023-05-09,Stock Purchase,Income,Income,Investments,581.47,0,83379.09,D
2822,369,2023-05-10,Liquorland,Expense,Leisure & Lifestyle,Alcohol,150.01,0,83229.08,D
2826,369,2023-05-10,BP,Expense,Transport,Fuel,85.86,0,83143.22,D
2835,369,2023-05-11,H&M,Expense,Personal,Clothing & Accessories,447.29,0,82695.93,D
2843,369,2023-05-11,Boost Mobile,Expense,Personal,Mobile Phone,29.64,0,82666.29,D
2821,369,2023-05-13,Mecca,Expense,Personal,Hair & Beauty,204.22,0,82462.07,D
2824,369,2023-05-14,Uber,Expense,Transport,Taxies & Share Cars,418.58,0,82043.49,D
2825,369,2023-05-14,Bunnings Warehouse,Expense,Household,Maintenance & Improvements,241.43,0,81802.06,D
2845,369,2023-05-18,7-Eleven,Expense,Transport,Fuel,56.36,0,81745.7,D
2830,369,2023-05-19,Caltex,Expense,Transport,Fuel,59.85,0,81685.85,D
2831,369,2023-05-19,Online Course Provider,Expense,Personal,Education,131.31,0,81554.54,D
2846,369,2023-05-19,E-Toll,Expense,Transport,Tolls,492.22,0,81062.32,D
2834,369,2023-05-20,IGA,Expense,Household,Groceries,297.56,0,80764.76,D
2836,369,2023-05-20,QBE,Expense,Transport,"Car Insurance, Rego & Maintenance",142.84,0,80621.92,D
2833,369,2023-05-21,Venmo,Transfer,Transfer,Transfer,208.13,0,80413.79,D
2839,369,2023-05-21,Spotify,Expense,Leisure & Lifestyle,"Tv, Music & Streaming",93.05,0,80320.74,D
2827,369,2023-05-24,Linkt,Expense,Transport,Tolls,81.94,0,80238.8,D
2841,369,2023-05-24,Dan Murphy's,Expense,Leisure & Lifestyle,Alcohol,340.03,0,79898.77,D
2848,369,2023-05-24,Amaysim,Expense,Personal,Mobile Phone,32.58,0,79866.19,D
2837,369,2023-05-27,Suncorp,Expense,Household,Rates & Insurance,349.95,0,79516.24,D
2840,369,2023-05-27,Landlord,Expense,Household,Rent & Mortgage,263.36,0,79252.88,D
2832,369,2023-05-29,Home Depot,Expense,Household,Maintenance & Improvements,421.68,0,78831.2,D
2838,369,2023-05-29,Hobby Store,Expense,Leisure & Lifestyle,Hobbies,124.81,0,78706.39,D
2844,369,2023-05-29,Tutoring Service,Expense,Personal,Education,24.06,0,78682.33,D
2849,369,2023-06-01,Salary,Income,Income,Wages,0,8000,86682.33,C
2852,369,2023-06-06,IGA,Expense,Household,Groceries,336.01,0,86346.32,D
2862,369,2023-06-08,Printing Service,Expense,Personal,Life Admin,42.32,0,86304.0,D
2861,369,2023-06-10,Music Store,Expense,Leisure & Lifestyle,Hobbies,277.22,0,86026.78,D
2864,369,2023-06-12,GoFundMe,Expense,Personal,Gifts & Donations,272.79,0,85753.99,D
2853,369,2023-06-14,Tutoring Service,Expense,Personal,Education,222.62,0,85531.37,D
2856,369,2023-06-14,Bike Shop,Expense,Transport,Cycling,175.8,0,85355.57,D
2854,369,2023-06-15,KFC,Expense,Leisure & Lifestyle,Restaurants & Cafes,441.52,0,84914.05,D
2860,369,2023-06-17,Allianz,Expense,Transport,"Car Insurance, Rego & Maintenance",120.05,0,84794.0,D
2858,369,2023-06-19,Landlord,Expense,Household,Rent & Mortgage,268.32,0,84525.68,D
2859,369,2023-06-19,Deliveroo,Expense,Leisure & Lifestyle,Takeaway,17.46,0,84508.22,D
2863,369,2023-06-19,Landlord,Expense,Household,Rent & Mortgage,79.64,0,84428.58,D
2855,369,2023-06-20,Adobe Creative Cloud,Expense,Leisure & Lifestyle,"Apps, Games & Software",76.66,0,84351.92,D
2865,369,2023-06-20,KFC,Expense,Leisure & Lifestyle,Restaurants & Cafes,467.76,0,83884.16,D
2851,369,2023-06-22,Apple Music,Expense,Leisure & Lifestyle,"Tv, Music & Streaming",61.83,0,83822.33,D
2857,369,2023-06-22,Cigarettes,Expense,Leisure & Lifestyle,Tobacco & Vaping,88.15,0,83734.18,D
2850,369,2023-06-24,Crown Casino,Expense,Leisure & Lifestyle,Lottery & Gambling,149.58,0,83584.6,D
2866,369,2023-06-26,Car Loan Provider,Expense,Transport,Car Repayments,40.36,0,83544.24,D
2867,369,2023-07-01,Salary,Income,Income,Wages,0,8000,91544.24,C
2873,369,2023-07-02,QBE,Expense,Transport,"Car Insurance, Rego & Maintenance",137.43,0,91406.81,D
2868,369,2023-07-03,Zara,Expense,Personal,Clothing & Accessories,152.34,0,91254.47,D
2877,369,2023-07-03,Myki,Expense,Transport,Public Transport,17.51,0,91236.96,D
2875,369,2023-07-04,Landlord,Expense,Household,Rent & Mortgage,364.06,0,90872.9,D
2869,369,2023-07-06,Spotify,Expense,Leisure & Lifestyle,"Tv, Music & Streaming",316.02,0,90556.88,D
2883,369,2023-07-09,TPG,Expense,Household,Internet,224.37,0,90332.51,D
2872,369,2023-07-10,Cocktail Bar,Expense,Leisure & Lifestyle,Pubs & Bars,12.16,0,90320.35,D
2881,369,2023-07-10,Optus,Expense,Household,Internet,261.35,0,90059.0,D
2880,369,2023-07-11,Dan Murphy's,Expense,Leisure & Lifestyle,Alcohol,315.82,0,89743.18,D
2879,369,2023-07-12,Zara,Expense,Personal,Clothing & Accessories,133.75,0,89609.43,D
2878,369,2023-07-15,Greencross Vets,Expense,Household,Pets,294.72,0,89314.71,D
2874,369,2023-07-18,Lowe's,Expense,Household,Maintenance & Improvements,404.67,0,88910.04,D
2871,369,2023-07-19,Stock Purchase,Expense,Personal,Investments,360.23,0,88549.81,D
2876,369,2023-07-20,Venmo,Transfer,Transfer,Transfer,107.71,0,88442.1,D
2870,369,2023-07-21,PayPal,Transfer,Transfer,Transfer,344.6,0,88097.5,D
2882,369,2023-07-26,Petbarn,Expense,Household,Pets,476.31,0,87621.19,D
2884,369,2023-08-01,Salary,Income,Income,Wages,0,8000,95621.19,C
2887,369,2023-08-03,IKEA,Expense,Household,Maintenance & Improvements,103.85,0,95517.34,D
2895,369,2023-08-06,Uniqlo,Expense,Personal,Clothing & Accessories,352.21,0,95165.13,D
2894,369,2023-08-07,UberEats,Expense,Leisure & Lifestyle,Takeaway,363.8,0,94801.33,D
2893,369,2023-08-10,Ticketmaster,Expense,Leisure & Lifestyle,Events & Gigs,309.3,0,94492.03,D
2890,369,2023-08-11,NRMA,Expense,Household,Rates & Insurance,177.67,0,94314.36,D
2885,369,2023-08-21,Home Depot,Expense,Household,Maintenance & Improvements,475.1,0,93839.26,D
2896,369,2023-08-21,Music Store,Expense,Leisure & Lifestyle,Hobbies,290.39,0,93548.87,D
2897,369,2023-08-22,Flight Centre,Expense,Leisure & Lifestyle,Holidays & Travel,241.12,0,93307.75,D
2886,369,2023-08-23,BP,Expense,Transport,Fuel,221.64,0,93086.11,D
2889,369,2023-08-23,Stock Purchase,Income,Income,Investments,650.91,0,92435.2,D
2891,369,2023-08-24,Online Course Provider,Expense,Personal,Education,304.25,0,92130.95,D
2892,369,2023-08-26,Ticketek,Expense,Leisure & Lifestyle,Events & Gigs,285.23,0,91845.72,D
2888,369,2023-08-28,Online Course Provider,Expense,Personal,Education,119.59,0,91726.13,D
2898,369,2023-09-01,Salary,Income,Income,Wages,0,8000,99726.13,C
2907,369,2023-09-02,DiDi,Expense,Transport,Taxies & Share Cars,215.21,0,99510.92,D
2906,369,2023-09-04,Stan,Expense,Leisure & Lifestyle,"Tv, Music & Streaming",27.62,0,99483.3,D
2905,369,2023-09-05,Tatts,Expense,Leisure & Lifestyle,Lottery & Gambling,363.26,0,99120.04,D
2903,369,2023-09-08,Woolworths,Expense,Household,Groceries,121.86,0,98998.18,D
2914,369,2023-09-08,Petbarn,Expense,Household,Pets,256.77,0,98741.41,D
2915,369,2023-09-13,Deliveroo,Expense,Leisure & Lifestyle,Takeaway,68.76,0,98672.65,D
2900,369,2023-09-14,Boost Mobile,Expense,Personal,Mobile Phone,332.68,0,98339.97,D
2901,369,2023-09-14,Post Office,Expense,Personal,Life Admin,151.27,0,98188.7,D
2902,369,2023-09-14,RSPCA,Expense,Household,Pets,408.89,0,97779.81,D
2910,369,2023-09-14,RACV,Expense,Transport,"Car Insurance, Rego & Maintenance",430.09,0,97349.72,D
2913,369,2023-09-16,Vodafone,Expense,Personal,Mobile Phone,308.84,0,97040.88,D
2909,369,2023-09-17,Google Play Store,Expense,Leisure & Lifestyle,"Apps, Games & Software",160.88,0,96880.0,D
2904,369,2023-09-18,Adelaide Metro,Expense,Transport,Public Transport,108.55,0,96771.45,D
2908,369,2023-09-19,PetSmart,Expense,Household,Pets,417.04,0,96354.41,D
2916,369,2023-09-19,H&M,Expense,Personal,Clothing & Accessories,480.55,0,95873.86,D
2899,369,2023-09-22,Moshtix,Expense,Leisure & Lifestyle,Events & Gigs,166.94,0,95706.92,D
2911,369,2023-09-24,Rooftop Bar,Expense,Leisure & Lifestyle,Pubs & Bars,485.34,0,95221.58,D
2912,369,2023-09-25,Lowe's,Expense,Household,Maintenance & Improvements,112.26,0,95109.32,D
2917,369,2023-10-01,Salary,Income,Income,Wages,0,8000,103109.32,C
2923,369,2023-10-06,CityLink,Expense,Transport,Tolls,46.72,0,103062.6,D
2924,369,2023-10-07,Venmo,Transfer,Transfer,Transfer,320.37,0,102742.23,D
2919,369,2023-10-08,The Iconic,Expense,Personal,Clothing & Accessories,207.05,0,102535.18,D
2926,369,2023-10-09,Secure Parking,Expense,Transport,Parking,282.65,0,102252.53,D
2927,369,2023-10-11,Telstra,Expense,Household,Internet,298.24,0,101954.29,D
2925,369,2023-10-19,QBE,Expense,Household,Rates & Insurance,423.86,0,101530.43,D
2921,369,2023-10-23,KFC,Expense,Leisure & Lifestyle,Restaurants & Cafes,144.62,0,101385.81,D
2918,369,2023-10-24,DoorDash,Expense,Leisure & Lifestyle,Takeaway,235.82,0,101149.99,D
2922,369,2023-10-24,Art Supply Store,Expense,Leisure & Lifestyle,Hobbies,481.53,0,100668.46,D
2928,369,2023-10-25,University,Expense,Personal,Education,454.46,0,100214.0,D
2920,369,2023-10-26,Sydney Water,Expense,Household,Utilities,305.73,0,99908.27,D
2929,369,2023-11-01,Salary,Income,Income,Wages,0,8000,107908.27,C
2930,369,2023-11-02,Stock Purchase,Expense,Personal,Investments,862.52,0,107045.75,D
2948,369,2023-11-02,Ticketek,Expense,Leisure & Lifestyle,Events & Gigs,313.95,0,106731.8,D
2933,369,2023-11-03,Cigars,Expense,Leisure & Lifestyle,Tobacco & Vaping,145.03,0,106586.77,D
2935,369,2023-11-03,NRMA,Expense,Transport,"Car Insurance, Rego & Maintenance",301.01,0,106285.76,D
2940,369,2023-11-04,Gym Membership,Expense,Personal,Fitness & Wellbeing,150.22,0,106135.54,D
2932,369,2023-11-07,Sports Bar,Expense,Leisure & Lifestyle,Pubs & Bars,18.52,0,106117.02,D
2938,369,2023-11-09,TransLink,Expense,Transport,Public Transport,488.92,0,105628.1,D
2941,369,2023-11-11,Sports Bar,Expense,Leisure & Lifestyle,Pubs & Bars,187.82,0,105440.28,D
2937,369,2023-11-12,Stock Purchase,Income,Income,Investments,648.4,0,104791.88,D
2943,369,2023-11-12,Tobacco Store,Expense,Leisure & Lifestyle,Tobacco & Vaping,31.26,0,104760.62,D
2931,369,2023-11-13,Ola,Expense,Transport,Taxies & Share Cars,169.96,0,104590.66,D
2944,369,2023-11-15,Uber,Expense,Transport,Taxies & Share Cars,49.63,0,104541.03,D
2946,369,2023-11-16,Caltex,Expense,Transport,Fuel,414.33,0,104126.7,D
2945,369,2023-11-18,Myki,Expense,Transport,Public Transport,118.77,0,104007.93,D
2936,369,2023-11-19,Baby Bunting,Expense,Personal,Children & Family,174.54,0,103833.39,D
2942,369,2023-11-21,Childcare Center,Expense,Personal,Children & Family,200.08,0,103633.31,D
2949,369,2023-11-21,Linkt,Expense,Transport,Tolls,304.81,0,103328.5,D
2951,369,2023-11-22,Hungry Jack's,Expense,Leisure & Lifestyle,Restaurants & Cafes,366.41,0,102962.09,D
2939,369,2023-11-23,PayPal,Transfer,Transfer,Transfer,444.46,0,102517.63,D
2947,369,2023-11-23,Sports Bar,Expense,Leisure & Lifestyle,Pubs & Bars,245.15,0,102272.48,D
2950,369,2023-11-27,Greencross Vets,Expense,Household,Pets,304.2,0,101968.28,D
2934,369,2023-11-28,Bunnings Warehouse,Expense,Household,Maintenance & Improvements,184.89,0,101783.39,D
2952,369,2023-11-28,H&M,Expense,Personal,Clothing & Accessories,232.43,0,101550.96,D
2953,369,2023-12-01,Salary,Income,Income,Wages,0,8000,109550.96,C
2959,369,2023-12-02,Coles,Expense,Household,Groceries,287.83,0,109263.13,D
2964,369,2023-12-04,Menulog,Expense,Leisure & Lifestyle,Takeaway,384.66,0,108878.47,D
2955,369,2023-12-06,Telstra,Expense,Personal,Mobile Phone,113.73,0,108764.74,D
2962,369,2023-12-06,Stock Purchase,Expense,Personal,Investments,624.88,0,108139.86,D
2956,369,2023-12-07,Stock Purchase,Expense,Personal,Investments,909.99,0,107229.87,D
2960,369,2023-12-14,Allianz,Expense,Transport,"Car Insurance, Rego & Maintenance",217.8,0,107012.07,D
2957,369,2023-12-17,Real Estate Agency,Expense,Household,Rent & Mortgage,466.31,0,106545.76,D
2961,369,2023-12-17,Toys R Us,Expense,Personal,Children & Family,465.73,0,106080.03,D
2958,369,2023-12-19,UberEats,Expense,Leisure & Lifestyle,Takeaway,482.47,0,105597.56,D
2963,369,2023-12-19,Suncorp,Expense,Transport,"Car Insurance, Rego & Maintenance",165.57,0,105431.99,D
2954,369,2023-12-29,PayPal,Transfer,Transfer,Transfer,192.12,0,105239.87,D
2965,369,2023-12-29,Costco,Expense,Household,Groceries,45.04,0,105194.83,D
